ano;cod_ibge;nome_mun;populacao;homens;mulheres;razao_sexo;id_media;dens_demog
2000;3500105;Adamantina;33484;16318;17166;105,2;33,7;81,3
2000;3500204;Adolfo;3680;1868;1812;97;32,2;17,4
2000;3500303;Aguaí;28145;14109;14036;99,5;30,3;59,3
2000;3500402;Águas da Prata;7127;3591;3536;98,5;33,9;50
2000;3500501;Águas de Lindóia;16145;8000;8145;101,8;31,9;268,5
2000;3500550;Águas de Santa Bárbara;5210;2631;2579;98;31,1;12,9
2000;3500600;Águas de São Pedro;1881;867;1014;117;37,8;520,7
2000;3500709;Agudos;32459;16135;16324;101,2;29,1;33,6
2000;3500758;Alambari;3647;1878;1769;94,2;29,3;22,9
2000;3500808;Alfredo Marcondes;3695;1881;1814;96,4;34;31,1
2000;3500907;Altair;3527;1880;1647;87,6;29,1;11,3
2000;3501004;Altinópolis;15463;7814;7649;97,9;31,2;16,6
2000;3501103;Alto Alegre;4266;2221;2045;92,1;34,7;13,4
2000;3501152;Alumínio;15237;7691;7546;98,1;27,7;182,2
2000;3501202;Álvares Florence;4322;2260;2062;91,2;35,2;11,9
2000;3501301;Álvares Machado;22622;11379;11243;98,8;30,2;65,1
2000;3501400;Álvaro de Carvalho;4099;2460;1639;66,6;29,7;26,7
2000;3501509;Alvinlândia;2834;1431;1403;98;30,1;33,4
2000;3501608;Americana;182300;90191;92109;102,1;31,8;1361,3
2000;3501707;Américo Brasiliense;28196;14356;13840;96,4;27,4;229,3
2000;3501806;Américo de Campos;5594;2804;2790;99,5;33,8;22,1
2000;3501905;Amparo;60305;30073;30232;100,5;32,1;135,4
2000;3502002;Analândia;3576;1852;1724;93,1;30,8;11
2000;3502101;Andradina;55134;27187;27947;102,8;32,4;57,2
2000;3502200;Angatuba;19276;9921;9355;94,3;30,3;18,8
2000;3502309;Anhembi;4524;2331;2193;94,1;30,3;6,1
2000;3502408;Anhumas;3409;1742;1667;95,7;30,9;10,6
2000;3502507;Aparecida;34888;17117;17771;103,8;30,3;288,6
2000;3502606;Aparecida d'Oeste;4936;2454;2482;101,1;33,8;27,6
2000;3502705;Apiaí;27153;13702;13451;98,2;26,7;27,9
2000;3502754;Araçariguama;11104;5706;5398;94,6;27;76,5
2000;3502804;Araçatuba;169087;81903;87184;106,4;32,2;144,9
2000;3502903;Araçoiaba da Serra;19758;9960;9798;98,4;30,5;77,4
2000;3503000;Aramina;4756;2423;2333;96,3;31,8;23,4
2000;3503109;Arandu;6060;3085;2975;96,4;28,5;21,2
2000;3503158;Arapeí;2615;1305;1310;100,4;31,2;16,7
2000;3503208;Araraquara;182240;88630;93610;105,6;32,4;181,6
2000;3503307;Araras;104024;51993;52031;100,1;30,9;161,3
2000;3503356;Arco-Íris;2167;1143;1024;89,6;32,7;8,2
2000;3503406;Arealva;7240;3725;3515;94,4;33,8;14,3
2000;3503505;Areias;3597;1818;1779;97,9;29,1;11,8
2000;3503604;Areiópolis;10293;5295;4998;94,4;26,8;119,8
2000;3503703;Ariranha;7460;3809;3651;95,9;32,4;56,2
2000;3503802;Artur Nogueira;32965;16535;16430;99,4;28,6;185,2
2000;3503901;Arujá;58933;29388;29545;100,5;27,2;612,8
2000;3503950;Aspásia;1864;967;897;92,8;33,4;26,9
2000;3504008;Assis;87135;42383;44752;105,6;32,3;189,2
2000;3504107;Atibaia;111033;55201;55832;101,1;30,2;232
2000;3504206;Auriflama;13506;6814;6692;98,2;32,1;31,1
2000;3504305;Avaí;4597;2392;2205;92,2;30,5;8,5
2000;3504404;Avanhandava;8820;4399;4421;100,5;29,4;26,1
2000;3504503;Avaré;76312;38102;38210;100,3;30,6;62,9
2000;3504602;Bady Bassitt;11475;5789;5686;98,2;30,6;104
2000;3504701;Balbinos;1312;676;636;94,1;32,5;14,3
2000;3504800;Bálsamo;7334;3659;3675;100,4;33,6;48,9
2000;3504909;Bananal;9707;4819;4888;101,4;31,2;15,7
2000;3505005;Barão de Antonina;2796;1429;1367;95,7;31,7;18,3
2000;3505104;Barbosa;5833;2939;2894;98,5;30,1;28,4
2000;3505203;Bariri;28187;14113;14074;99,7;33,1;63,4
2000;3505302;Barra Bonita;35439;17708;17731;100,1;31,5;236,1
2000;3505351;Barra do Chapéu;4846;2610;2236;85,7;27,6;11,9
2000;3505401;Barra do Turvo;8098;4248;3850;90,6;27,5;8
2000;3505500;Barretos;103829;50627;53202;105,1;31,8;66,3
2000;3505609;Barrinha;24150;12253;11897;97,1;26,7;165,4
2000;3505708;Barueri;207372;102435;104937;102,4;26,5;3156,3
2000;3505807;Bastos;20573;10239;10334;100,9;30;120,4
2000;3505906;Batatais;51041;25327;25714;101,5;31,7;60,1
2000;3506003;Bauru;315493;154156;161337;104,7;31,3;472,5
2000;3506102;Bebedouro;74743;36864;37879;102,8;31;109,4
2000;3506201;Bento de Abreu;2394;1224;1170;95,6;31,3;7,9
2000;3506300;Bernardino de Campos;10713;5315;5398;101,6;33,1;43,9
2000;3506359;Bertioga;29771;15373;14398;93,7;26,8;60,6
2000;3506409;Bilac;6082;2995;3087;103,1;33,8;38,5
2000;3506508;Birigui;94098;46351;47747;103;31,2;177,5
2000;3506607;Biritiba Mirim;24579;12463;12116;97,2;28,1;77,4
2000;3506706;Boa Esperança do Sul;12551;6381;6170;96,7;28,8;18,2
2000;3506805;Bocaina;9419;4700;4719;100,4;31,6;25,9
2000;3506904;Bofete;7338;3849;3489;90,6;30;11,2
2000;3507001;Boituva;34240;17335;16905;97,5;29,3;137,5
2000;3507100;Bom Jesus dos Perdões;13275;6671;6604;99;29;122,5
2000;3507159;Bom Sucesso de Itararé;3221;1665;1556;93,5;25,1;24,1
2000;3507209;Borá;795;407;388;95,3;31,1;6,7
2000;3507308;Boracéia;3736;1926;1810;94;30,8;30,6
2000;3507407;Borborema;13183;6691;6492;97;32,7;23,9
2000;3507456;Borebi;1927;1001;926;92,5;28,9;5,5
2000;3507506;Botucatu;108124;52788;55336;104,8;31,5;72,9
2000;3507605;Bragança Paulista;124766;61772;62994;102;30,7;243,4
2000;3507704;Braúna;4382;2236;2146;96;33,6;22,5
2000;3507753;Brejo Alegre;2306;1194;1112;93,1;30,5;21,8
2000;3507803;Brodowski;17104;8599;8505;98,9;30,9;61,4
2000;3507902;Brotas;18838;9499;9339;98,3;31,2;17,1
2000;3508009;Buri;17595;9253;8342;90,2;27,5;14,7
2000;3508108;Buritama;13843;6885;6958;101,1;31,9;42,3
2000;3508207;Buritizal;3675;1870;1805;96,5;32,2;13,8
2000;3508306;Cabrália Paulista;4648;2332;2316;99,3;28,9;19,4
2000;3508405;Cabreúva;32926;16858;16068;95,3;27;126,5
2000;3508504;Caçapava;76027;37747;38280;101,4;29,6;206
2000;3508603;Cachoeira Paulista;27164;13482;13682;101,5;30,6;94,3
2000;3508702;Caconde;18367;9311;9056;97,3;30,3;39,2
2000;3508801;Cafelândia;15789;7808;7981;102,2;32,1;17,2
2000;3508900;Caiabu;4075;2086;1989;95,3;31,6;16,1
2000;3509007;Caieiras;70825;35155;35670;101,5;27,7;725,4
2000;3509106;Caiuá;4183;2184;1999;91,5;30,6;7,6
2000;3509205;Cajamar;50568;25488;25080;98,4;26,7;384,9
2000;3509254;Cajati;29176;15075;14101;93,5;26,7;64,2
2000;3509304;Cajobi;9170;4733;4437;93,7;31,3;51,8
2000;3509403;Cajuru;20755;10523;10232;97,2;30;31,4
2000;3509452;Campina do Monte Alegre;5195;2668;2527;94,7;29,8;28,2
2000;3509502;Campinas;968160;471574;496586;105,3;31,2;1218,5
2000;3509601;Campo Limpo Paulista;63520;31658;31862;100,6;28,4;800
2000;3509700;Campos do Jordão;44178;21941;22237;101,3;27,8;152,3
2000;3509809;Campos Novos Paulista;4179;2165;2014;93;31,5;8,6
2000;3509908;Cananéia;12267;6201;6066;97,8;28,3;9,9
2000;3509957;Canas;3605;1865;1740;93,3;28,8;67,7
2000;3510005;Cândido Mota;29241;14619;14622;100;31,2;49,1
2000;3510104;Cândido Rodrigues;2610;1287;1323;102,8;35,3;36,8
2000;3510153;Canitar;3469;1767;1702;96,3;27,8;60,4
2000;3510203;Capão Bonito;46729;23482;23247;99;28,1;28,5
2000;3510302;Capela do Alto;14210;7294;6916;94,8;28,1;83,6
2000;3510401;Capivari;41393;20585;20808;101,1;29,7;128,2
2000;3510500;Caraguatatuba;78628;39576;39052;98,7;28,8;162,1
2000;3510609;Carapicuíba;343962;168540;175422;104,1;27,2;9956,7
2000;3510708;Cardoso;11611;5748;5863;102;32,9;18,2
2000;3510807;Casa Branca;26785;14121;12664;89,7;32,2;31
2000;3510906;Cássia dos Coqueiros;2870;1486;1384;93,1;31,1;15
2000;3511003;Castilho;14945;7470;7475;100,1;31;14
2000;3511102;Catanduva;105695;51793;53902;104,1;32,7;363,7
2000;3511201;Catiguá;6552;3363;3189;94,8;31,3;44,2
2000;3511300;Cedral;6690;3375;3315;98,2;34,2;33,8
2000;3511409;Cerqueira César;15121;7561;7560;100;31;29,6
2000;3511508;Cerquilho;29402;14695;14707;100,1;30,4;230,1
2000;3511607;Cesário Lange;12865;6740;6125;90,9;30,4;67,6
2000;3511706;Charqueada;13014;6551;6463;98,7;29,7;74
2000;3511904;Clementina;5399;2797;2602;93;30,4;32
2000;3512001;Colina;16656;8355;8301;99,4;30,8;39,4
2000;3512100;Colômbia;5947;3088;2859;92,6;28,4;8,2
2000;3512209;Conchal;22641;11400;11241;98,6;28,2;123,9
2000;3512308;Conchas;14873;7602;7271;95,6;32,1;31,9
2000;3512407;Cordeirópolis;17546;8772;8774;100;30,2;127,5
2000;3512506;Coroados;4411;2217;2194;99;30,8;17,9
2000;3512605;Coronel Macedo;5591;2874;2717;94,5;29,2;18,4
2000;3512704;Corumbataí;3788;1985;1803;90,8;30,4;13,6
2000;3512803;Cosmópolis;44250;22164;22086;99,6;29,5;286,1
2000;3512902;Cosmorama;7376;3730;3646;97,7;34,7;16,7
2000;3513009;Cotia;148519;73415;75104;102,3;27,7;458,4
2000;3513108;Cravinhos;28349;14433;13916;96,4;29,7;91
2000;3513207;Cristais Paulista;6570;3398;3172;93,3;29,2;17,1
2000;3513306;Cruzália;2611;1310;1301;99,3;31,4;17,5
2000;3513405;Cruzeiro;73444;36009;37435;104;30,4;240,2
2000;3513504;Cubatão;108135;54437;53698;98,6;27,8;756,8
2000;3513603;Cunha;23093;11974;11119;92,9;29,3;16,4
2000;3513702;Descalvado;28889;14405;14484;100,5;31,3;38,3
2000;3513801;Diadema;356535;174849;181686;103,9;27,4;11601,4
2000;3513850;Dirce Reis;1625;838;787;93,9;33,7;18,4
2000;3513900;Divinolândia;12014;6136;5878;95,8;31,7;53,7
2000;3514007;Dobrada;7006;3690;3316;89,9;28,4;46,8
2000;3514106;Dois Córregos;22484;11281;11203;99,3;31,8;35,5
2000;3514205;Dolcinópolis;2151;1121;1030;91,9;33,7;27,6
2000;3514304;Dourado;8598;4403;4195;95,3;32,7;41,8
2000;3514403;Dracena;40491;19711;20780;105,4;33,8;83
2000;3514502;Duartina;12470;6117;6353;103,9;33;47,1
2000;3514601;Dumont;6293;3212;3081;95,9;30;56,5
2000;3514700;Echaporã;6822;3409;3413;100,1;30,3;13,2
2000;3514809;Eldorado;14124;7333;6791;92,6;27,2;8,5
2000;3514908;Elias Fausto;13865;7134;6731;94,4;28,3;68,5
2000;3514924;Elisiário;2577;1350;1227;90,9;32,9;27,4
2000;3514957;Embaúba;2477;1285;1192;92,8;32,4;29,8
2000;3515004;Embu das Artes;207103;101915;105188;103,2;26,1;2941,9
2000;3515103;Embu-Guaçu;56671;28431;28240;99,3;27,8;364,1
2000;3515129;Emilianópolis;2893;1471;1422;96,7;32,8;12,8
2000;3515152;Engenheiro Coelho;10000;5186;4814;92,8;27,4;91
2000;3515186;Espírito Santo do Pinhal;40448;20026;20422;102;32;103,9
2000;3515194;Espírito Santo do Turvo;3670;1900;1770;93,2;27,9;19
2000;3515202;Estrela d'Oeste;8258;4196;4062;96,8;32,6;27,9
2000;3515301;Estrela do Norte;2626;1361;1265;92,9;30,1;9,9
2000;3515350;Euclides da Cunha Paulista;10207;5166;5041;97,6;27,6;17,8
2000;3515400;Fartura;15004;7506;7498;99,9;31,1;35
2000;3515509;Fernandópolis;61593;30317;31276;103,2;32,7;112
2000;3515608;Fernando Prestes;5431;2688;2743;102;34,4;31,9
2000;3515657;Fernão;1434;738;696;94,3;31,9;14,3
2000;3515707;Ferraz de Vasconcelos;141852;69941;71911;102,8;26,3;4800,8
2000;3515806;Flora Rica;2179;1092;1087;99,5;32,8;9,7
2000;3515905;Floreal;3226;1606;1620;100,9;35,6;15,8
2000;3516002;Flórida Paulista;11118;5564;5554;99,8;32,5;21,2
2000;3516101;Florínea;3126;1516;1610;106,2;31;13,8
2000;3516200;Franca;287162;141874;145288;102,4;29,7;474,1
2000;3516309;Francisco Morato;133143;66404;66739;100,5;25,2;2717,1
2000;3516408;Franco da Rocha;107883;55851;52032;93,2;27,6;812,5
2000;3516507;Gabriel Monteiro;2724;1408;1316;93,5;33,7;19,6
2000;3516606;Gália;7862;3994;3868;96,8;31,6;22,1
2000;3516705;Garça;43145;21215;21930;103,4;31,8;77,6
2000;3516804;Gastão Vidigal;3588;1794;1794;100;32,2;19,9
2000;3516853;Gavião Peixoto;4123;2205;1918;87;28,7;16,9
2000;3516903;General Salgado;10819;5504;5315;96,6;32,3;21,9
2000;3517000;Getulina;10368;5579;4789;85,8;31,7;15,3
2000;3517109;Glicério;4426;2241;2185;97,5;31,6;16,2
2000;3517208;Guaiçara;9179;4569;4610;100,9;29,5;33,1
2000;3517307;Guaimbê;5206;2602;2604;100,1;30,3;23,9
2000;3517406;Guaíra;34574;17393;17181;98,8;30,5;27,5
2000;3517505;Guapiaçu;14049;7145;6904;96,6;31,3;43,2
2000;3517604;Guapiara;19712;10139;9573;94,4;27,4;48,3
2000;3517703;Guará;18890;9470;9420;99,5;29,2;52,2
2000;3517802;Guaraçaí;8888;4489;4399;98;32,7;15,6
2000;3517901;Guaraci;8836;4494;4342;96,6;30,8;13,8
2000;3518008;Guarani d'Oeste;2005;1039;966;93;33,4;23,4
2000;3518107;Guarantã;6315;3218;3097;96,2;29,1;13,7
2000;3518206;Guararapes;28822;14298;14524;101,6;32;30,2
2000;3518305;Guararema;21864;11090;10774;97,2;29,4;80,7
2000;3518404;Guaratinguetá;104101;50837;53264;104,8;30,8;138,3
2000;3518503;Guareí;10179;5345;4834;90,4;29,8;17,9
2000;3518602;Guariba;31061;15706;15355;97,8;28,2;114,9
2000;3518701;Guarujá;264235;130590;133645;102,3;27,9;1824,9
2000;3518800;Guarulhos;1069609;525958;543651;103,4;27,6;3356,4
2000;3518859;Guatapará;6365;3284;3081;93,8;29,4;15,4
2000;3518909;Guzolândia;4301;2240;2061;92;30,8;17
2000;3519006;Herculândia;7983;4048;3935;97,2;30,6;21,9
2000;3519055;Holambra;7195;3680;3515;95,5;28,7;109,7
2000;3519071;Hortolândia;151697;75878;75819;99,9;27,1;2430,4
2000;3519105;Iacanga;8275;4187;4088;97,6;32,4;15,1
2000;3519204;Iacri;6786;3411;3375;98,9;31,6;21,1
2000;3519253;Iaras;3044;1663;1381;83;27,4;7,6
2000;3519303;Ibaté;26378;13389;12989;97;28;90,7
2000;3519402;Ibirá;9440;4646;4794;103,2;33,6;34,7
2000;3519501;Ibirarema;5699;2882;2817;97,7;31,7;25
2000;3519600;Ibitinga;46534;23016;23518;102,2;31,5;67,5
2000;3519709;Ibiúna;64220;33050;31170;94,3;28,1;60,7
2000;3519808;Icém;6766;3423;3343;97,7;30,8;18,7
2000;3519907;Iepê;7258;3611;3647;101;32,3;12,2
2000;3520004;Igaraçu do Tietê;22596;11365;11231;98,8;28,8;231,2
2000;3520103;Igarapava;25888;12745;13143;103,1;31,6;55,3
2000;3520202;Igaratá;8271;4288;3983;92,9;29,3;28,2
2000;3520301;Iguape;27410;13987;13423;96;30;13,9
2000;3520400;Ilhabela;20752;10811;9941;92;27,7;59,9
2000;3520426;Ilha Comprida;6653;3374;3279;97,2;30,9;33,8
2000;3520442;Ilha Solteira;23976;11837;12139;102,6;30,9;36,7
2000;3520509;Indaiatuba;146530;73175;73355;100,2;29,8;470,3
2000;3520608;Indiana;4929;2501;2428;97,1;31,7;38,1
2000;3520707;Indiaporã;4064;2028;2036;100,4;33,9;14,5
2000;3520806;Inúbia Paulista;3318;1699;1619;95,3;32,2;38,1
2000;3520905;Ipaussu;12542;6271;6271;100;30,9;59,9
2000;3521002;Iperó;18289;9793;8496;86,8;28,3;107,4
2000;3521101;Ipeúna;4321;2243;2078;92,6;29,8;22,7
2000;3521150;Ipiguá;3461;1782;1679;94,2;31,4;25,4
2000;3521200;Iporanga;4563;2370;2193;92,5;27,1;4
2000;3521309;Ipuã;11855;6048;5807;96;29,4;25,4
2000;3521408;Iracemápolis;15517;7830;7687;98,2;30,4;134,8
2000;3521507;Irapuã;6653;3426;3227;94,2;31,9;25,8
2000;3521606;Irapuru;7464;3762;3702;98,4;34,5;34,8
2000;3521705;Itaberá;18901;9593;9308;97;28,9;17,2
2000;3521804;Itaí;21006;10784;10222;94,8;28,8;19,2
2000;3521903;Itajobi;14220;7176;7044;98,2;33,6;28,3
2000;3522000;Itaju;2635;1369;1266;92,5;33,6;11,4
2000;3522109;Itanhaém;71694;35656;36038;101,1;29,8;119,2
2000;3522158;Itaoca;3232;1659;1573;94,8;29,4;17,7
2000;3522208;Itapecerica da Serra;129180;63851;65329;102,3;26,2;857
2000;3522307;Itapetininga;125314;62761;62553;99,7;29,6;70
2000;3522406;Itapeva;82773;40966;41807;102,1;28;45,3
2000;3522505;Itapevi;161810;80093;81717;102;25,6;1957,6
2000;3522604;Itapira;63309;31714;31595;99,6;32,3;122,1
2000;3522653;Itapirapuã Paulista;3574;1881;1693;90;27,4;8,8
2000;3522703;Itápolis;37703;18816;18887;100,4;32,3;37,8
2000;3522802;Itaporanga;14355;7241;7114;98,2;30,1;28,3
2000;3522901;Itapuí;10358;5315;5043;94,9;31,3;74
2000;3523008;Itapura;3837;2005;1832;91,4;30,4;12,7
2000;3523107;Itaquaquecetuba;271649;135566;136083;100,4;25,3;3287,9
2000;3523206;Itararé;46508;23036;23472;101,9;28,8;46,3
2000;3523305;Itariri;13592;6956;6636;95,4;27,6;49,7
2000;3523404;Itatiba;80987;40349;40638;100,7;30,4;251,3
2000;3523503;Itatinga;15429;7903;7526;95,2;27,9;15,7
2000;3523602;Itirapina;12805;7131;5674;79,6;30,2;22,7
2000;3523701;Itirapuã;5409;2821;2588;91,7;29,8;33,6
2000;3523800;Itobi;7459;3877;3582;92,4;30,4;53,7
2000;3523909;Itu;135069;67319;67750;100,6;29,5;210,8
2000;3524006;Itupeva;26075;13363;12712;95,1;28,2;129,8
2000;3524105;Ituverava;36236;17930;18306;102,1;31,6;51,4
2000;3524204;Jaborandi;6423;3303;3120;94,5;31,1;23,5
2000;3524303;Jaboticabal;67325;33023;34302;103,9;31,5;95,3
2000;3524402;Jacareí;191011;94495;96516;102,1;29,6;411,4
2000;3524501;Jaci;4108;2134;1974;92,5;30,6;28,3
2000;3524600;Jacupiranga;17019;8699;8320;95,6;28,3;24,2
2000;3524709;Jaguariúna;29533;14907;14626;98,1;29,9;208,9
2000;3524808;Jales;46137;22844;23293;102;32,4;125,2
2000;3524907;Jambeiro;3985;2082;1903;91,4;30,3;21,6
2000;3525003;Jandira;91478;45386;46092;101,6;26,1;5242,6
2000;3525102;Jardinópolis;30660;15457;15203;98,4;29,9;61,1
2000;3525201;Jarinu;16970;8789;8181;93,1;28,6;81,8
2000;3525300;Jaú;111921;55308;56613;102,4;32;162,9
2000;3525409;Jeriquara;3280;1742;1538;88,3;28,6;23,1
2000;3525508;Joanópolis;10386;5294;5092;96,2;31,7;27,7
2000;3525607;João Ramalho;3834;1933;1901;98,3;28,9;9,2
2000;3525706;José Bonifácio;28662;14353;14309;99,7;31;33,3
2000;3525805;Júlio Mesquita;4163;2050;2113;103,1;30,3;32,5
2000;3525854;Jumirim;2190;1157;1033;89,3;31,2;38,6
2000;3525904;Jundiaí;323056;158425;164631;103,9;32;749,2
2000;3526001;Junqueirópolis;17012;8907;8105;91;34;29,2
2000;3526100;Juquiá;20480;10499;9981;95,1;28,2;25,2
2000;3526209;Juquitiba;26388;13273;13115;98,8;27;50,5
2000;3526308;Lagoinha;4954;2585;2369;91,6;31,9;19,4
2000;3526407;Laranjal Paulista;22114;11047;11067;100,2;31,9;57,5
2000;3526506;Lavínia;5134;2574;2560;99,5;32,3;9,5
2000;3526605;Lavrinhas;5994;3058;2936;96;27,6;35,9
2000;3526704;Leme;80628;40766;39862;97,8;29,3;200,1
2000;3526803;Lençóis Paulista;54936;27516;27420;99,7;29,3;67,9
2000;3526902;Limeira;248618;123395;125223;101,5;30,3;428,1
2000;3527009;Lindóia;5318;2683;2635;98,2;32,1;109,1
2000;3527108;Lins;65886;31958;33928;106,2;32,5;115,6
2000;3527207;Lorena;77914;37967;39947;105,2;30,3;188,1
2000;3527256;Lourdes;2004;1039;965;92,9;32,4;17,6
2000;3527306;Louveira;23817;12074;11743;97,3;28,7;427,3
2000;3527405;Lucélia;18311;9472;8839;93,3;32,3;58,2
2000;3527504;Lucianópolis;2156;1114;1042;93,5;31,2;11,4
2000;3527603;Luís Antônio;7146;3653;3493;95,6;27,1;11,9
2000;3527702;Luiziânia;4273;2142;2131;99,5;32,1;25,7
2000;3527801;Lupércio;4228;2130;2098;98,5;29,5;27,2
2000;3527900;Lutécia;2895;1473;1422;96,5;31,8;6,1
2000;3528007;Macatuba;15729;7905;7824;99;28,9;70,1
2000;3528106;Macaubal;7385;3752;3633;96,8;34,3;29,8
2000;3528205;Macedônia;3763;1907;1856;97,3;33;11,5
2000;3528304;Magda;3423;1764;1659;94;33,3;11
2000;3528403;Mairinque;39860;19947;19913;99,8;28,1;189,7
2000;3528502;Mairiporã;59883;30099;29784;99;28,8;186,7
2000;3528601;Manduri;8261;4227;4034;95,4;31,4;36,1
2000;3528700;Marabá Paulista;3697;1915;1782;93,1;30,3;4
2000;3528809;Maracaí;12998;6626;6372;96,2;30,4;24,4
2000;3528858;Marapoama;2234;1130;1104;97,7;32,4;20,1
2000;3528908;Mariápolis;3858;1986;1872;94,3;33,2;20,7
2000;3529005;Marília;196965;96318;100647;104,5;31,2;168,3
2000;3529104;Marinópolis;2194;1130;1064;94,2;31;28,2
2000;3529203;Martinópolis;22320;11437;10883;95,2;31,6;17,8
2000;3529302;Matão;71669;35838;35831;100;30;136,5
2000;3529401;Mauá;362676;178485;184191;103,2;27,6;5855,5
2000;3529500;Mendonça;3756;1933;1823;94,3;34,6;19,2
2000;3529609;Meridiano;4023;2056;1967;95,7;32,6;17,6
2000;3529658;Mesópolis;1931;989;942;95,2;32,3;13
2000;3529708;Miguelópolis;19003;9552;9451;98,9;29,6;23,2
2000;3529807;Mineiros do Tietê;11390;5729;5661;98,8;30,3;53,4
2000;3529906;Miracatu;22349;11540;10809;93,7;27,2;22,3
2000;3530003;Mira Estrela;2597;1351;1246;92,2;32,8;12
2000;3530102;Mirandópolis;25921;13801;12120;87,8;32,9;28,2
2000;3530201;Mirante do Paranapanema;16203;8270;7933;95,9;31,5;13,1
2000;3530300;Mirassol;48233;23804;24429;102,6;32;198,3
2000;3530409;Mirassolândia;3734;1919;1815;94,6;31,8;22,5
2000;3530508;Mococa;65503;33042;32461;98,2;31,2;76,6
2000;3530607;Mogi das Cruzes;329653;162346;167307;103,1;28,9;462,6
2000;3530706;Mogi Guaçu;123984;62287;61697;99,1;30,1;152,5
2000;3530805;Mogi Mirim;81293;40619;40674;100,1;31,3;163,3
2000;3530904;Mombuca;3102;1588;1514;95,3;28,6;23,2
2000;3531001;Monções;2056;1042;1014;97,3;34,3;19,7
2000;3531100;Mongaguá;34897;17892;17005;95;30;244,5
2000;3531209;Monte Alegre do Sul;6312;3218;3094;96,1;33,1;57,2
2000;3531308;Monte Alto;43574;21829;21745;99,6;32,2;125,6
2000;3531407;Monte Aprazível;18404;9128;9276;101,6;34,4;37,1
2000;3531506;Monte Azul Paulista;19534;9861;9673;98,1;30,6;74,1
2000;3531605;Monte Castelo;4095;2069;2026;97,9;33,7;17,5
2000;3531704;Monteiro Lobato;3613;1863;1750;93,9;30,4;10,9
2000;3531803;Monte Mor;37207;18701;18506;99;27,9;154,7
2000;3531902;Morro Agudo;25386;12961;12425;95,9;28,3;18,3
2000;3532009;Morungaba;9893;5005;4888;97,7;29,5;67,4
2000;3532058;Motuca;3866;1991;1875;94,2;29;16,9
2000;3532108;Murutinga do Sul;3969;2019;1950;96,6;35,2;15,8
2000;3532157;Nantes;2272;1160;1112;95,9;28,6;7,9
2000;3532207;Narandiba;3737;1888;1849;97,9;29,5;10,5
2000;3532306;Natividade da Serra;6947;3681;3266;88,7;31,6;8,3
2000;3532405;Nazaré Paulista;14381;7413;6968;94;30,2;44,1
2000;3532504;Neves Paulista;8901;4484;4417;98,5;34,4;40,6
2000;3532603;Nhandeara;10196;5020;5176;103,1;35,2;23,4
2000;3532702;Nipoã;3262;1668;1594;95,6;32,1;23,7
2000;3532801;Nova Aliança;4762;2369;2393;101;34,1;21,9
2000;3532827;Nova Campina;7272;3792;3480;91,8;25,1;18,9
2000;3532843;Nova Canaã Paulista;2485;1291;1194;92,5;35,4;20
2000;3532868;Nova Castilho;990;517;473;91,5;32,3;5,4
2000;3532900;Nova Europa;7286;3698;3588;97;29,9;45,5
2000;3533007;Nova Granada;16998;8534;8464;99,2;31,6;32
2000;3533106;Nova Guataporanga;2087;1072;1015;94,7;34,3;61,1
2000;3533205;Nova Independência;2062;1054;1008;95,6;32,5;7,8
2000;3533254;Novais;3224;1681;1543;91,8;30,6;27,4
2000;3533304;Nova Luzitânia;2748;1439;1309;91;31,4;37,2
2000;3533403;Nova Odessa;41987;20825;21162;101,6;30,1;569
2000;3533502;Novo Horizonte;32413;16102;16311;101,3;32,5;34,8
2000;3533601;Nuporanga;6304;3200;3104;97;31,6;18,1
2000;3533700;Ocauçu;4165;2172;1993;91,8;31,1;13,8
2000;3533809;Óleo;2992;1533;1459;95,2;32,4;15
2000;3533908;Olímpia;45981;22769;23212;101,9;32,2;57,3
2000;3534005;Onda Verde;3407;1732;1675;96,7;30,1;14
2000;3534104;Oriente;5892;2926;2966;101,4;32,6;26,9
2000;3534203;Orindiúva;4149;2139;2010;94;28,6;16,8
2000;3534302;Orlândia;35956;17842;18114;101,5;30,4;123,2
2000;3534401;Osasco;651736;317155;334581;105,5;28,8;10033,8
2000;3534500;Oscar Bressane;2552;1250;1302;104,2;33,9;11,5
2000;3534609;Osvaldo Cruz;29641;14610;15031;102,9;33,7;119,5
2000;3534708;Ourinhos;93693;46006;47687;103,7;30,8;316,7
2000;3534757;Ouroeste;6276;3153;3123;99;31,8;21,7
2000;3534807;Ouro Verde;7147;3586;3561;99,3;30,8;26,8
2000;3534906;Pacaembu;12517;6652;5865;88,2;33,6;36,9
2000;3535002;Palestina;9099;4525;4574;101,1;34,7;13
2000;3535101;Palmares Paulista;8425;4293;4132;96,2;27,8;102,6
2000;3535200;Palmeira d'Oeste;10327;5247;5080;96,8;33,7;32,4
2000;3535309;Palmital;20681;10241;10440;101,9;33;37,7
2000;3535408;Panorama;13636;6952;6684;96,1;29,2;38,3
2000;3535507;Paraguaçu Paulista;39559;19611;19948;101,7;30,3;39,5
2000;3535606;Paraibuna;16988;8692;8296;95,4;29,5;21
2000;3535705;Paraíso;5422;2822;2600;92,1;31,5;34,9
2000;3535804;Paranapanema;15482;8047;7435;92,4;28,3;15,2
2000;3535903;Paranapuã;3633;1849;1784;96,5;32,5;25,9
2000;3536000;Parapuã;11107;5643;5464;96,8;33,1;30,3
2000;3536109;Pardinho;4718;2447;2271;92,8;28,9;22,5
2000;3536208;Pariquera-Açu;17601;8867;8734;98,5;28,6;49
2000;3536257;Parisi;1944;1016;928;91,3;33,4;22,9
2000;3536307;Patrocínio Paulista;11399;5837;5562;95,3;29,9;18,9
2000;3536406;Paulicéia;5290;2749;2541;92,4;28,8;14,1
2000;3536505;Paulínia;51163;25606;25557;99,8;29;368,7
2000;3536570;Paulistânia;1778;941;837;88,9;30,2;6,9
2000;3536604;Paulo de Faria;8470;4222;4248;100,6;31,1;11,5
2000;3536703;Pederneiras;36567;18461;18106;98,1;29,8;50,3
2000;3536802;Pedra Bela;5604;2959;2645;89,4;31,6;35,3
2000;3536901;Pedranópolis;2737;1401;1336;95,4;34,5;10,5
2000;3537008;Pedregulho;14982;7653;7329;95,8;29,5;21
2000;3537107;Pedreira;35141;17420;17721;101,7;30,8;322,9
2000;3537156;Pedrinhas Paulista;2858;1447;1411;97,5;30,7;18,8
2000;3537206;Pedro de Toledo;9173;4687;4486;95,7;28,8;13,7
2000;3537305;Penápolis;54570;26661;27909;104,7;32,2;76,7
2000;3537404;Pereira Barreto;25033;12369;12664;102,4;31,3;25,7
2000;3537503;Pereiras;6207;3183;3024;95;32,4;27,8
2000;3537602;Peruíbe;51237;25522;25715;100,8;29,9;157,1
2000;3537701;Piacatu;4624;2331;2293;98,4;32,2;19,9
2000;3537800;Piedade;50065;26276;23789;90,5;29,6;67
2000;3537909;Pilar do Sul;23902;12319;11583;94;28,4;35,1
2000;3538006;Pindamonhangaba;125775;62751;63024;100,4;28,8;172
2000;3538105;Pindorama;13101;6637;6464;97,4;33,7;70,9
2000;3538204;Pinhalzinho;10959;5678;5281;93;32,1;70,9
2000;3538303;Piquerobi;3476;1765;1711;96,9;32,4;7,2
2000;3538501;Piquete;15196;7429;7767;104,5;31,6;86,3
2000;3538600;Piracaia;23303;11831;11472;97;30,3;60,4
2000;3538709;Piracicaba;328642;162179;166463;102,6;30,9;238,5
2000;3538808;Piraju;27879;13659;14220;104,1;31,8;55,3
2000;3538907;Pirajuí;20083;10708;9375;87,6;32,2;24,4
2000;3539004;Pirangi;10036;5150;4886;94,9;33,3;46,5
2000;3539103;Pirapora do Bom Jesus;12344;6185;6159;99,6;26;113,8
2000;3539202;Pirapozinho;22093;10813;11280;104,3;30,6;46,3
2000;3539301;Pirassununga;64782;31931;32851;102,9;31,9;89,1
2000;3539400;Piratininga;10575;5348;5227;97,7;31,9;26,3
2000;3539509;Pitangueiras;31112;15938;15174;95,2;28,2;72,2
2000;3539608;Planalto;3668;1869;1799;96,3;31;12,7
2000;3539707;Platina;2867;1501;1366;91;30,4;8,8
2000;3539806;Poá;95597;46855;48742;104;27,9;5537,5
2000;3539905;Poloni;4771;2334;2437;104,4;35,9;35,3
2000;3540002;Pompéia;18162;8993;9169;102;31,4;23,1
2000;3540101;Pongaí;3692;1916;1776;92,7;33,8;20,1
2000;3540200;Pontal;29608;15012;14596;97,2;27,5;83,1
2000;3540259;Pontalinda;3536;1845;1691;91,7;30,1;16,9
2000;3540309;Pontes Gestal;2543;1264;1279;101,2;33,2;11,7
2000;3540408;Populina;4452;2302;2150;93,4;33;14,1
2000;3540507;Porangaba;6642;3525;3117;88,4;31,9;25
2000;3540606;Porto Feliz;45424;22783;22641;99,4;29,9;81,6
2000;3540705;Porto Ferreira;47343;23594;23749;100,7;30,7;193,3
2000;3540754;Potim;13562;6889;6673;96,9;26,9;303,8
2000;3540804;Potirendaba;13631;6999;6632;94,8;34,2;39,8
2000;3540853;Pracinha;1432;733;699;95,4;32,6;22,7
2000;3540903;Pradópolis;12880;6544;6336;96,8;29,3;77
2000;3541000;Praia Grande;192769;94123;98646;104,8;29,8;1288,1
2000;3541059;Pratânia;3941;2060;1881;91,3;28,5;22,5
2000;3541109;Presidente Alves;4319;2184;2135;97,8;31,3;15,1
2000;3541208;Presidente Bernardes;14650;7622;7028;92,2;32,9;19,6
2000;3541307;Presidente Epitácio;39254;19542;19712;100,9;29,9;31,1
2000;3541406;Presidente Prudente;188949;91682;97267;106,1;31,4;337
2000;3541505;Presidente Venceslau;37335;18698;18637;99,7;32,2;49,4
2000;3541604;Promissão;31073;15701;15372;97,9;31,1;39,9
2000;3541653;Quadra;2643;1389;1254;90,3;31,5;12,9
2000;3541703;Quatá;11652;5793;5859;101,1;30,4;17,9
2000;3541802;Queiroz;2169;1115;1054;94,5;30;9,2
2000;3541901;Queluz;9098;4517;4581;101,4;28,9;36,5
2000;3542008;Quintana;5440;2743;2697;98,3;31,4;17,1
2000;3542107;Rafard;8362;4188;4174;99,7;30,6;68,7
2000;3542206;Rancharia;28754;14260;14494;101,6;31;18,1
2000;3542305;Redenção da Serra;4047;2172;1875;86,3;31,6;13,1
2000;3542404;Regente Feijó;16977;8494;8483;99,9;31,3;64,5
2000;3542503;Reginópolis;4742;2399;2343;97,7;32,9;11,6
2000;3542602;Registro;53704;26813;26891;100,3;28,2;74,4
2000;3542701;Restinga;5572;2842;2730;96,1;27,6;22,7
2000;3542800;Ribeira;3512;1840;1672;90,9;30,5;10,5
2000;3542909;Ribeirão Bonito;11237;5692;5545;97,4;30,2;23,8
2000;3543006;Ribeirão Branco;21211;11085;10126;91,3;24,9;30,4
2000;3543105;Ribeirão Corrente;3874;2061;1813;88;28,9;26,1
2000;3543204;Ribeirão do Sul;4488;2287;2201;96,2;31,8;22,1
2000;3543238;Ribeirão dos Índios;2221;1144;1077;94,1;33,6;11,3
2000;3543253;Ribeirão Grande;7377;3809;3568;93,7;28,1;22,1
2000;3543303;Ribeirão Pires;104305;51533;52772;102,4;29,5;1053,9
2000;3543402;Ribeirão Preto;504162;242667;261495;107,8;31,4;774,5
2000;3543501;Riversul;7210;3686;3524;95,6;30,7;18,7
2000;3543600;Rifaina;3321;1700;1621;95,4;31,6;20,4
2000;3543709;Rincão;10330;5226;5104;97,7;29,3;32,6
2000;3543808;Rinópolis;10263;5271;4992;94,7;34,2;28,6
2000;3543907;Rio Claro;167902;82077;85825;104,6;31,9;336,9
2000;3544004;Rio das Pedras;23448;11945;11503;96,3;29;103,5
2000;3544103;Rio Grande da Serra;37015;18430;18585;100,8;26,7;1018,6
2000;3544202;Riolândia;8552;4772;3780;79,2;30,8;13,5
2000;3544251;Rosana;24192;12272;11920;97,1;26,7;32,5
2000;3544301;Roseira;8551;4354;4197;96,4;28,3;65,9
2000;3544400;Rubiácea;2340;1192;1148;96,3;30,8;9,9
2000;3544509;Rubinéia;2611;1291;1320;102,2;33,9;10,8
2000;3544608;Sabino;4947;2472;2475;100,1;32,8;16,2
2000;3544707;Sagres;2441;1243;1198;96,4;31,4;16,5
2000;3544806;Sales;4555;2319;2236;96,4;31,7;14,8
2000;3544905;Sales Oliveira;9308;4673;4635;99,2;31,1;30,4
2000;3545001;Salesópolis;14326;7249;7077;97,6;29,6;33,7
2000;3545100;Salmourão;4402;2241;2161;96,4;32;25,5
2000;3545159;Saltinho;5792;2923;2869;98,2;32,2;58,1
2000;3545209;Salto;92933;46479;46454;99,9;29,2;698,4
2000;3545308;Salto de Pirapora;34965;17538;17427;99,4;28,9;124,7
2000;3545407;Salto Grande;8437;4243;4194;98,8;31,6;44,8
2000;3545506;Sandovalina;3082;1530;1552;101,4;28,1;6,8
2000;3545605;Santa Adélia;13441;6792;6649;97,9;31,9;40,7
2000;3545704;Santa Albertina;5589;2810;2779;98,9;35,2;20,5
2000;3545803;Santa Bárbara d'Oeste;169818;84813;85005;100,2;29,8;626,6
2000;3546009;Santa Branca;12982;6563;6419;97,8;30,3;47,7
2000;3546108;Santa Clara d'Oeste;2126;1067;1059;99,3;33,4;11,6
2000;3546207;Santa Cruz da Conceição;3525;1806;1719;95,2;32;23,5
2000;3546256;Santa Cruz da Esperança;1795;919;876;95,3;30,1;12,1
2000;3546306;Santa Cruz das Palmeiras;25517;12887;12630;98;29,9;86,4
2000;3546405;Santa Cruz do Rio Pardo;40876;20253;20623;101,8;31,5;36,7
2000;3546504;Santa Ernestina;5739;3119;2620;84;28,3;42,7
2000;3546603;Santa Fé do Sul;26478;12883;13595;105,5;33,1;128,2
2000;3546702;Santa Gertrudes;15845;8071;7774;96,3;29;161,2
2000;3546801;Santa Isabel;43682;22061;21621;98;28,7;120,2
2000;3546900;Santa Lúcia;7837;4050;3787;93,5;28,1;50,9
2000;3547007;Santa Maria da Serra;4669;2440;2229;91,4;29,2;18,5
2000;3547106;Santa Mercedes;2805;1420;1385;97,5;32,2;16,8
2000;3547205;Santana da Ponte Pensa;1898;981;917;93,5;35,6;14,6
2000;3547304;Santana de Parnaíba;74343;37049;37294;100,7;26,9;413,1
2000;3547403;Santa Rita d'Oeste;2701;1359;1342;98,7;35,8;12,9
2000;3547502;Santa Rita do Passa Quatro;26118;12734;13384;105,1;34,4;34,6
2000;3547601;Santa Rosa de Viterbo;21413;10674;10739;100,6;31,1;74,2
2000;3547650;Santa Salete;1379;725;654;90,2;35,8;17,4
2000;3547700;Santo Anastácio;20741;10139;10602;104,6;32,2;37,5
2000;3547809;Santo André;649000;313654;335346;106,9;31,9;3692,1
2000;3547908;Santo Antônio da Alegria;5757;2997;2760;92,1;31,5;18,6
2000;3548005;Santo Antônio de Posse;18074;9107;8967;98,5;29,9;117,3
2000;3548054;Santo Antônio do Aracanguá;6930;3606;3324;92,2;29,9;5,3
2000;3548104;Santo Antônio do Jardim;6150;3217;2933;91,2;31,8;55,9
2000;3548203;Santo Antônio do Pinhal;6318;3245;3073;94,7;29;47,5
2000;3548302;Santo Expedito;2523;1302;1221;93,8;32,8;26,7
2000;3548401;Santópolis do Aguapeí;3816;1943;1873;96,4;30,2;29,8
2000;3548500;Santos;417975;193222;224753;116,3;35,5;1487,3
2000;3548609;São Bento do Sapucaí;10339;5238;5101;97,4;31,7;40,9
2000;3548708;São Bernardo do Campo;701756;341415;360341;105,5;29,5;1713,6
2000;3548807;São Caetano do Sul;140241;65556;74685;113,9;36,4;9147,7
2000;3548906;São Carlos;192639;95410;97229;101,9;31,6;169,4
2000;3549003;São Francisco;2860;1443;1417;98,2;33,4;37,8
2000;3549102;São João da Boa Vista;77304;38006;39298;103,4;32,5;149,7
2000;3549201;São João das Duas Pontes;2661;1358;1303;95,9;31,7;20,6
2000;3549250;São João de Iracema;1671;856;815;95,2;31,9;9,4
2000;3549300;São João do Pau d'Alho;2185;1108;1077;97,2;34,9;18,6
2000;3549409;São Joaquim da Barra;41530;20493;21037;102,7;30,9;101,1
2000;3549508;São José da Bela Vista;8066;4123;3943;95,6;28,6;29,1
2000;3549607;São José do Barreiro;4141;2158;1983;91,9;30,4;7,3
2000;3549706;São José do Rio Pardo;50022;24794;25228;101,8;31,4;119,2
2000;3549805;São José do Rio Preto;357705;173080;184625;106,7;32,2;828,1
2000;3549904;São José dos Campos;538298;265968;272330;102,4;28,8;489,6
2000;3549953;São Lourenço da Serra;12145;6156;5989;97,3;27,7;65,1
2000;3550001;São Luiz do Paraitinga;10424;5406;5018;92,8;31,5;16,9
2000;3550100;São Manuel;36502;18103;18399;101,6;30,5;56,1
2000;3550209;São Miguel Arcanjo;30743;15732;15011;95,4;27,9;33
2000;3550308;São Paulo;10426384;4968927;5457457;109,8;30,7;6854
2000;3550407;São Pedro;27811;13706;14105;102,9;31,7;45,5
2000;3550506;São Pedro do Turvo;6889;3486;3403;97,6;30,5;9,4
2000;3550605;São Roque;66537;33124;33413;100,9;30,4;216,8
2000;3550704;São Sebastião;57745;29256;28489;97,4;27,6;143,5
2000;3550803;São Sebastião da Grama;12448;6330;6118;96,7;30,8;49,3
2000;3550902;São Simão;13658;6811;6847;100,5;31,4;22,1
2000;3551009;São Vicente;303199;147038;156161;106,2;29,7;2046,6
2000;3551108;Sarapuí;7792;4059;3733;92;29,7;22,1
2000;3551207;Sarutaiá;3732;1880;1852;98,5;30,8;26,4
2000;3551306;Sebastianópolis do Sul;2546;1301;1245;95,7;34,2;15,2
2000;3551405;Serra Azul;7433;3778;3655;96,7;28,3;26,3
2000;3551504;Serrana;32499;16363;16136;98,6;27,4;257,8
2000;3551603;Serra Negra;23829;11756;12073;102,7;33,2;117
2000;3551702;Sertãozinho;94499;47445;47054;99,2;29,5;234,4
2000;3551801;Sete Barras;13702;7162;6540;91,3;28,1;12,9
2000;3551900;Severínia;13570;7053;6517;92,4;28,5;96,6
2000;3552007;Silveiras;5373;2762;2611;94,5;30;13
2000;3552106;Socorro;32684;16325;16359;100,2;33,4;72,8
2000;3552205;Sorocaba;492245;242183;250062;103,3;29,9;1094,2
2000;3552304;Sud Mennucci;7363;3752;3611;96,2;29,8;12,4
2000;3552403;Sumaré;196099;98405;97694;99,3;28;1277,8
2000;3552502;Suzano;227917;112870;115047;101,9;27,3;1105,1
2000;3552551;Suzanápolis;2786;1434;1352;94,3;32;8,4
2000;3552601;Tabapuã;10488;5303;5185;97,8;33,2;30,3
2000;3552700;Tabatinga;12967;6580;6387;97,1;30,5;35,2
2000;3552809;Taboão da Serra;197247;95165;102082;107,3;27,5;9674,8
2000;3552908;Taciba;5216;2654;2562;96,5;30,3;8,6
2000;3553005;Taguaí;7458;3776;3682;97,5;30;51,3
2000;3553104;Taiaçu;5613;2848;2765;97,1;30,9;52,4
2000;3553203;Taiúva;5503;2760;2743;99,4;33;41,5
2000;3553302;Tambaú;22234;11242;10992;97,8;30,8;39,6
2000;3553401;Tanabi;22577;11187;11390;101,8;33,4;30,2
2000;3553500;Tapiraí;8538;4394;4144;94,3;27,8;11,3
2000;3553609;Tapiratiba;12931;6423;6508;101,3;30;58,3
2000;3553658;Taquaral;2721;1404;1317;93,8;30,5;50,5
2000;3553708;Taquaritinga;52013;26331;25682;97,5;31,1;87,5
2000;3553807;Taquarituba;21947;11042;10905;98,8;29,7;48,9
2000;3553856;Taquarivaí;4457;2274;2183;96;25,6;19,2
2000;3553906;Tarabai;5775;2927;2848;97,3;29,5;28,7
2000;3553955;Tarumã;10731;5501;5230;95,1;28,5;35,4
2000;3554003;Tatuí;93235;46439;46796;100,8;29,9;178
2000;3554102;Taubaté;243783;120119;123664;103;30,1;390,1
2000;3554201;Tejupá;5330;2803;2527;90,2;27,9;18
2000;3554300;Teodoro Sampaio;19991;10020;9971;99,5;28,3;12,8
2000;3554409;Terra Roxa;7741;3950;3791;96;30,9;34,9
2000;3554508;Tietê;31638;15712;15926;101,4;31,5;78,2
2000;3554607;Timburi;2732;1407;1325;94,2;32,8;13,9
2000;3554656;Torre de Pedra;2133;1084;1049;96,8;33,1;29,9
2000;3554706;Torrinha;8824;4473;4351;97,3;32,8;28
2000;3554755;Trabiju;1380;718;662;92,2;29,8;21,8
2000;3554805;Tremembé;34746;18084;16662;92,1;29,3;181,8
2000;3554904;Três Fronteiras;5158;2595;2563;98,8;33,9;34
2000;3554953;Tuiuti;4947;2554;2393;93,7;32,9;39
2000;3555000;Tupã;63288;30827;32461;105,3;33,4;100,8
2000;3555109;Tupi Paulista;13293;6565;6728;102,5;35,4;54,3
2000;3555208;Turiúba;1897;972;925;95,2;35,3;12,4
2000;3555307;Turmalina;2369;1184;1185;100,1;34,9;16
2000;3555356;Ubarana;4204;2199;2005;91,2;28,5;20
2000;3555406;Ubatuba;66644;33780;32864;97,3;27,3;94,1
2000;3555505;Ubirajara;4156;2136;2020;94,6;31;14,7
2000;3555604;Uchoa;9028;4536;4492;99;33,7;35,8
2000;3555703;União Paulista;1354;703;651;92,6;33,5;17,1
2000;3555802;Urânia;8822;4414;4408;99,9;33,5;42,2
2000;3555901;Uru;1404;731;673;92,1;33,6;9,6
2000;3556008;Urupês;11825;5968;5857;98,1;34;36,5
2000;3556107;Valentim Gentil;8575;4366;4209;96,4;31,2;57,3
2000;3556206;Valinhos;82817;41281;41536;100,6;31,4;557,5
2000;3556305;Valparaíso;18554;9734;8820;90,6;30,3;21,6
2000;3556354;Vargem;6953;3578;3375;94,3;31,6;48,8
2000;3556404;Vargem Grande do Sul;36247;18072;18175;100,6;31,1;135,7
2000;3556453;Vargem Grande Paulista;32464;16261;16203;99,6;27,2;764
2000;3556503;Várzea Paulista;92537;46461;46076;99,2;27,4;2634,9
2000;3556602;Vera Cruz;11085;5520;5565;100,8;32,1;44,7
2000;3556701;Vinhedo;47065;23416;23649;101;30,9;581,4
2000;3556800;Viradouro;15933;8061;7872;97,7;30,1;73,2
2000;3556909;Vista Alegre do Alto;4742;2383;2359;99;31,7;49,7
2000;3556958;Vitória Brasil;1673;860;813;94,5;31,3;33,6
2000;3557006;Votorantim;95767;47793;47974;100,4;28,5;519,9
2000;3557105;Votuporanga;75528;37060;38468;103,8;32,7;179,5
2000;3557154;Zacarias;1947;1007;940;93,3;32,5;6,1
2000;3557204;Chavantes;12189;6082;6107;100,4;30,3;64,6
2000;3557303;Estiva Gerbi;8832;4562;4270;93,6;28,8;119,1
2001;3500105;Adamantina;33577;16360;17217;105,2;34,1;81,5
2001;3500204;Adolfo;3685;1871;1814;97;32,6;17,5
2001;3500303;Aguaí;28586;14337;14249;99,4;30,6;60,2
2001;3500402;Águas da Prata;7178;3610;3568;98,8;34,3;50,3
2001;3500501;Águas de Lindóia;16264;8048;8216;102,1;32,2;270,5
2001;3500550;Águas de Santa Bárbara;5252;2648;2604;98,3;31,5;13
2001;3500600;Águas de São Pedro;1968;905;1063;117,5;38,3;544,8
2001;3500709;Agudos;32740;16269;16471;101,2;29,4;33,9
2001;3500758;Alambari;3771;1939;1832;94,5;29,5;23,6
2001;3500808;Alfredo Marcondes;3725;1894;1831;96,7;34,4;31,3
2001;3500907;Altair;3555;1898;1657;87,3;29,4;11,4
2001;3501004;Altinópolis;15529;7842;7687;98;31,5;16,7
2001;3501103;Alto Alegre;4250;2213;2037;92;35;13,3
2001;3501152;Alumínio;15424;7786;7638;98,1;28;184,5
2001;3501202;Álvares Florence;4289;2236;2053;91,8;35,7;11,8
2001;3501301;Álvares Machado;22757;11429;11328;99,1;30,6;65,5
2001;3501400;Álvaro de Carvalho;4156;2505;1651;65,9;30;27
2001;3501509;Alvinlândia;2859;1442;1417;98,3;30,3;33,7
2001;3501608;Americana;185311;91590;93721;102,3;32,2;1383,8
2001;3501707;Américo Brasiliense;28817;14656;14161;96,6;27,7;234,4
2001;3501806;Américo de Campos;5618;2816;2802;99,5;34,1;22,2
2001;3501905;Amparo;60958;30368;30590;100,7;32,4;136,9
2001;3502002;Analândia;3638;1885;1753;93;31,1;11,2
2001;3502101;Andradina;55251;27239;28012;102,8;32,7;57,3
2001;3502200;Angatuba;19599;10072;9527;94,6;30,6;19,1
2001;3502309;Anhembi;4628;2388;2240;93,8;30,5;6,3
2001;3502408;Anhumas;3452;1759;1693;96,2;31,2;10,8
2001;3502507;Aparecida;34893;17095;17798;104,1;30,7;288,6
2001;3502606;Aparecida d'Oeste;4904;2437;2467;101,2;34,2;27,4
2001;3502705;Apiaí;27085;13654;13431;98,4;27,2;27,8
2001;3502754;Araçariguama;11662;5991;5671;94,7;27,3;80,3
2001;3502804;Araçatuba;170607;82579;88028;106,6;32,6;146,2
2001;3502903;Araçoiaba da Serra;20539;10343;10196;98,6;30,8;80,4
2001;3503000;Aramina;4805;2445;2360;96,5;32,2;23,7
2001;3503109;Arandu;6096;3100;2996;96,6;28,9;21,3
2001;3503158;Arapeí;2620;1309;1311;100,2;31,4;16,7
2001;3503208;Araraquara;184957;89893;95064;105,8;32,7;184,3
2001;3503307;Araras;105512;52682;52830;100,3;31,2;163,6
2001;3503356;Arco-Íris;2149;1132;1017;89,8;33;8,1
2001;3503406;Arealva;7305;3754;3551;94,6;34,2;14,4
2001;3503505;Areias;3609;1822;1787;98,1;29,4;11,8
2001;3503604;Areiópolis;10349;5326;5023;94,3;27,2;120,5
2001;3503703;Ariranha;7573;3867;3706;95,8;32,6;57,1
2001;3503802;Artur Nogueira;34153;17127;17026;99,4;28,9;191,8
2001;3503901;Arujá;60632;30214;30418;100,7;27,6;630,5
2001;3503950;Aspásia;1863;966;897;92,9;33,7;26,9
2001;3504008;Assis;88036;42827;45209;105,6;32,6;191,1
2001;3504107;Atibaia;112779;56020;56759;101,3;30,6;235,7
2001;3504206;Auriflama;13597;6853;6744;98,4;32,5;31,3
2001;3504305;Avaí;4636;2409;2227;92,4;30,7;8,6
2001;3504404;Avanhandava;9082;4570;4512;98,7;29,7;26,8
2001;3504503;Avaré;77062;38460;38602;100,4;30,9;63,5
2001;3504602;Bady Bassitt;11816;5951;5865;98,6;31;107,1
2001;3504701;Balbinos;1550;834;716;85,9;32,9;16,9
2001;3504800;Bálsamo;7429;3700;3729;100,8;34;49,6
2001;3504909;Bananal;9782;4854;4928;101,5;31,5;15,9
2001;3505005;Barão de Antonina;2832;1449;1383;95,4;31,9;18,5
2001;3505104;Barbosa;5913;2980;2933;98,4;30,4;28,8
2001;3505203;Bariri;28601;14324;14277;99,7;33,3;64,4
2001;3505302;Barra Bonita;35480;17697;17783;100,5;31,9;236,3
2001;3505351;Barra do Chapéu;4897;2635;2262;85,8;28;12,1
2001;3505401;Barra do Turvo;8079;4241;3838;90,5;27,9;8
2001;3505500;Barretos;104703;51011;53692;105,3;32,1;66,9
2001;3505609;Barrinha;24601;12470;12131;97,3;27;168,5
2001;3505708;Barueri;211109;104150;106959;102,7;26,9;3213,2
2001;3505807;Bastos;20601;10239;10362;101,2;30,4;120,5
2001;3505906;Batatais;51652;25604;26048;101,7;32;60,8
2001;3506003;Bauru;318803;155669;163134;104,8;31,6;477,5
2001;3506102;Bebedouro;74942;36918;38024;103;31,4;109,7
2001;3506201;Bento de Abreu;2417;1237;1180;95,4;31,5;8
2001;3506300;Bernardino de Campos;10729;5309;5420;102,1;33,4;43,9
2001;3506359;Bertioga;31416;16176;15240;94,2;27,1;63,9
2001;3506409;Bilac;6191;3055;3136;102,7;34,1;39,2
2001;3506508;Birigui;95652;47079;48573;103,2;31,6;180,5
2001;3506607;Biritiba Mirim;25030;12688;12342;97,3;28,5;78,9
2001;3506706;Boa Esperança do Sul;12693;6448;6245;96,9;29,1;18,4
2001;3506805;Bocaina;9564;4771;4793;100,5;31,8;26,3
2001;3506904;Bofete;7573;3960;3613;91,2;30,4;11,6
2001;3507001;Boituva;35619;18025;17594;97,6;29,5;143,1
2001;3507100;Bom Jesus dos Perdões;13907;6989;6918;99;29,3;128,3
2001;3507159;Bom Sucesso de Itararé;3245;1675;1570;93,7;25,5;24,3
2001;3507209;Borá;801;414;387;93,5;31,1;6,7
2001;3507308;Boracéia;3786;1952;1834;94;31;31
2001;3507407;Borborema;13333;6762;6571;97,2;33;24,1
2001;3507456;Borebi;1963;1018;945;92,8;29,1;5,6
2001;3507506;Botucatu;110108;53726;56382;104,9;31,8;74,3
2001;3507605;Bragança Paulista;127156;62915;64241;102,1;31,1;248,1
2001;3507704;Braúna;4440;2267;2173;95,9;33,8;22,7
2001;3507753;Brejo Alegre;2338;1213;1125;92,7;30,8;22,1
2001;3507803;Brodowski;17531;8801;8730;99,2;31,2;63
2001;3507902;Brotas;19115;9625;9490;98,6;31,5;17,4
2001;3508009;Buri;17678;9272;8406;90,7;27,8;14,8
2001;3508108;Buritama;14017;6979;7038;100,8;32,3;42,9
2001;3508207;Buritizal;3711;1891;1820;96,2;32,5;13,9
2001;3508306;Cabrália Paulista;4636;2333;2303;98,7;29,2;19,3
2001;3508405;Cabreúva;33842;17316;16526;95,4;27,3;130
2001;3508504;Caçapava;77050;38252;38798;101,4;29,9;208,8
2001;3508603;Cachoeira Paulista;27534;13650;13884;101,7;30,9;95,6
2001;3508702;Caconde;18458;9348;9110;97,5;30,7;39,4
2001;3508801;Cafelândia;15915;7870;8045;102,2;32,4;17,3
2001;3508900;Caiabu;4082;2090;1992;95,3;31,9;16,1
2001;3509007;Caieiras;72444;35910;36534;101,7;28;741,9
2001;3509106;Caiuá;4273;2233;2040;91,4;31;7,8
2001;3509205;Cajamar;51951;26167;25784;98,5;27;395,4
2001;3509254;Cajati;29203;15058;14145;93,9;27,1;64,3
2001;3509304;Cajobi;9233;4767;4466;93,7;31,7;52,2
2001;3509403;Cajuru;21063;10668;10395;97,4;30,3;31,9
2001;3509452;Campina do Monte Alegre;5241;2693;2548;94,6;30,1;28,4
2001;3509502;Campinas;980449;477168;503281;105,5;31,6;1233,9
2001;3509601;Campo Limpo Paulista;64666;32194;32472;100,9;28,8;814,4
2001;3509700;Campos do Jordão;44658;22152;22506;101,6;28,2;154
2001;3509809;Campos Novos Paulista;4209;2180;2029;93,1;31,7;8,7
2001;3509908;Cananéia;12296;6211;6085;98;28,7;9,9
2001;3509957;Canas;3677;1902;1775;93,3;28,9;69
2001;3510005;Cândido Mota;29376;14662;14714;100,4;31,5;49,3
2001;3510104;Cândido Rodrigues;2620;1292;1328;102,8;35,6;37
2001;3510153;Canitar;3574;1822;1752;96,2;28;62,2
2001;3510203;Capão Bonito;46881;23546;23335;99,1;28,5;28,6
2001;3510302;Capela do Alto;14570;7482;7088;94,7;28,5;85,8
2001;3510401;Capivari;42136;20973;21163;100,9;30;130,5
2001;3510500;Caraguatatuba;80934;40681;40253;98,9;29,2;166,9
2001;3510609;Carapicuíba;346764;169799;176965;104,2;27,6;10037,8
2001;3510708;Cardoso;11669;5774;5895;102,1;33,3;18,3
2001;3510807;Casa Branca;26924;14202;12722;89,6;32,5;31,2
2001;3510906;Cássia dos Coqueiros;2873;1487;1386;93,2;31,5;15
2001;3511003;Castilho;15252;7621;7631;100,1;31,3;14,3
2001;3511102;Catanduva;106512;52149;54363;104,2;33,1;366,5
2001;3511201;Catiguá;6617;3394;3223;95;31,6;44,6
2001;3511300;Cedral;6822;3438;3384;98,4;34,4;34,5
2001;3511409;Cerqueira César;15388;7686;7702;100,2;31,3;30,1
2001;3511508;Cerquilho;30474;15221;15253;100,2;30,8;238,4
2001;3511607;Cesário Lange;13135;6873;6262;91,1;30,6;69
2001;3511706;Charqueada;13241;6673;6568;98,4;30;75,3
2001;3511904;Clementina;5561;2880;2681;93,1;30,6;33
2001;3512001;Colina;16738;8385;8353;99,6;31,2;39,6
2001;3512100;Colômbia;5949;3087;2862;92,7;28,7;8,2
2001;3512209;Conchal;22960;11567;11393;98,5;28,5;125,6
2001;3512308;Conchas;14989;7647;7342;96;32,4;32,2
2001;3512407;Cordeirópolis;17914;8959;8955;100;30,5;130,2
2001;3512506;Coroados;4503;2264;2239;98,9;31,1;18,2
2001;3512605;Coronel Macedo;5547;2853;2694;94,4;29,6;18,3
2001;3512704;Corumbataí;3809;1990;1819;91,4;30,7;13,7
2001;3512803;Cosmópolis;45715;22896;22819;99,7;29,7;295,6
2001;3512902;Cosmorama;7357;3724;3633;97,6;35;16,7
2001;3513009;Cotia;153980;76066;77914;102,4;28;475,3
2001;3513108;Cravinhos;28714;14596;14118;96,7;30;92,2
2001;3513207;Cristais Paulista;6679;3452;3227;93,5;29,6;17,3
2001;3513306;Cruzália;2586;1296;1290;99,5;31,9;17,3
2001;3513405;Cruzeiro;73917;36214;37703;104,1;30,7;241,8
2001;3513504;Cubatão;109475;55071;54404;98,8;28,1;766,2
2001;3513603;Cunha;23042;11931;11111;93,1;29,8;16,4
2001;3513702;Descalvado;29137;14514;14623;100,8;31,7;38,7
2001;3513801;Diadema;360392;176553;183839;104,1;27,7;11726,9
2001;3513850;Dirce Reis;1636;845;791;93,6;33,9;18,6
2001;3513900;Divinolândia;11969;6100;5869;96,2;32,2;53,5
2001;3514007;Dobrada;7098;3734;3364;90,1;28,5;47,4
2001;3514106;Dois Córregos;22699;11389;11310;99,3;32;35,9
2001;3514205;Dolcinópolis;2146;1122;1024;91,3;34;27,5
2001;3514304;Dourado;8612;4408;4204;95,4;33;41,8
2001;3514403;Dracena;40821;19905;20916;105,1;34,1;83,7
2001;3514502;Duartina;12473;6116;6357;103,9;33,4;47,1
2001;3514601;Dumont;6493;3311;3182;96,1;30,2;58,3
2001;3514700;Echaporã;6808;3399;3409;100,3;30,7;13,2
2001;3514809;Eldorado;14236;7379;6857;92,9;27,6;8,6
2001;3514908;Elias Fausto;14066;7243;6823;94,2;28,6;69,5
2001;3514924;Elisiário;2635;1383;1252;90,5;33;28
2001;3514957;Embaúba;2473;1288;1185;92;32,6;29,7
2001;3515004;Embu das Artes;210552;103516;107036;103,4;26,5;2990,9
2001;3515103;Embu-Guaçu;57412;28779;28633;99,5;28,1;368,9
2001;3515129;Emilianópolis;2909;1483;1426;96,2;33,1;12,9
2001;3515152;Engenheiro Coelho;10548;5474;5074;92,7;27,6;95,9
2001;3515186;Espírito Santo do Pinhal;40741;20152;20589;102,2;32,4;104,7
2001;3515194;Espírito Santo do Turvo;3730;1926;1804;93,7;28,2;19,3
2001;3515202;Estrela d'Oeste;8254;4191;4063;96,9;32,9;27,9
2001;3515301;Estrela do Norte;2640;1366;1274;93,3;30,4;10
2001;3515350;Euclides da Cunha Paulista;10161;5143;5018;97,6;28;17,7
2001;3515400;Fartura;15058;7508;7550;100,6;31,5;35,1
2001;3515509;Fernandópolis;62013;30493;31520;103,4;33,1;112,8
2001;3515608;Fernando Prestes;5442;2698;2744;101,7;34,7;32
2001;3515657;Fernão;1443;743;700;94,2;32,2;14,4
2001;3515707;Ferraz de Vasconcelos;144791;71337;73454;103;26,6;4900,3
2001;3515806;Flora Rica;2137;1074;1063;99;33,2;9,5
2001;3515905;Floreal;3212;1599;1613;100,9;36,1;15,7
2001;3516002;Flórida Paulista;11294;5699;5595;98,2;32,8;21,5
2001;3516101;Florínea;3106;1508;1598;106;31,4;13,8
2001;3516200;Franca;290882;143539;147343;102,7;30,1;480,3
2001;3516309;Francisco Morato;135332;67475;67857;100,6;25,5;2761,8
2001;3516408;Franco da Rocha;110344;57080;53264;93,3;27,8;831,1
2001;3516507;Gabriel Monteiro;2727;1409;1318;93,5;34;19,7
2001;3516606;Gália;7801;3957;3844;97,1;32,1;21,9
2001;3516705;Garça;43274;21258;22016;103,6;32,2;77,9
2001;3516804;Gastão Vidigal;3647;1835;1812;98,7;32,4;20,2
2001;3516853;Gavião Peixoto;4148;2216;1932;87,2;28,9;17
2001;3516903;General Salgado;10820;5498;5322;96,8;32,7;21,9
2001;3517000;Getulina;10417;5610;4807;85,7;32;15,4
2001;3517109;Glicério;4437;2246;2191;97,6;31,8;16,3
2001;3517208;Guaiçara;9354;4664;4690;100,6;29,9;33,8
2001;3517307;Guaimbê;5249;2623;2626;100,1;30,6;24,1
2001;3517406;Guaíra;34864;17512;17352;99,1;30,8;27,7
2001;3517505;Guapiaçu;14416;7326;7090;96,8;31,7;44,3
2001;3517604;Guapiara;19615;10082;9533;94,6;27,9;48
2001;3517703;Guará;19008;9522;9486;99,6;29,5;52,5
2001;3517802;Guaraçaí;8870;4473;4397;98,3;33,1;15,6
2001;3517901;Guaraci;8942;4549;4393;96,6;31;13,9
2001;3518008;Guarani d'Oeste;2004;1038;966;93,1;33,6;23,4
2001;3518107;Guarantã;6344;3229;3115;96,5;29,4;13,7
2001;3518206;Guararapes;29067;14414;14653;101,7;32,3;30,4
2001;3518305;Guararema;22307;11309;10998;97,2;29,7;82,4
2001;3518404;Guaratinguetá;105146;51280;53866;105;31,2;139,7
2001;3518503;Guareí;10639;5663;4976;87,9;30,1;18,7
2001;3518602;Guariba;31530;15942;15588;97,8;28,5;116,7
2001;3518701;Guarujá;267419;132002;135417;102,6;28,3;1846,9
2001;3518800;Guarulhos;1086538;533899;552639;103,5;27,9;3409,6
2001;3518859;Guatapará;6437;3323;3114;93,7;29,7;15,6
2001;3518909;Guzolândia;4348;2265;2083;92;31;17,2
2001;3519006;Herculândia;8069;4088;3981;97,4;30,9;22,2
2001;3519055;Holambra;7609;3893;3716;95,5;29,1;116
2001;3519071;Hortolândia;156041;78154;77887;99,7;27,5;2500
2001;3519105;Iacanga;8447;4281;4166;97,3;32,6;15,4
2001;3519204;Iacri;6753;3398;3355;98,7;32;21
2001;3519253;Iaras;3376;1878;1498;79,8;27,9;8,4
2001;3519303;Ibaté;26850;13652;13198;96,7;28,3;92,3
2001;3519402;Ibirá;9580;4715;4865;103,2;33,9;35,2
2001;3519501;Ibirarema;5794;2935;2859;97,4;31,9;25,4
2001;3519600;Ibitinga;47222;23350;23872;102,2;31,8;68,5
2001;3519709;Ibiúna;65079;33463;31616;94,5;28,5;61,5
2001;3519808;Icém;6837;3458;3379;97,7;31;18,9
2001;3519907;Iepê;7309;3635;3674;101,1;32,6;12,3
2001;3520004;Igaraçu do Tietê;22697;11407;11290;99;29,2;232,2
2001;3520103;Igarapava;26074;12842;13232;103;31,9;55,7
2001;3520202;Igaratá;8361;4331;4030;93,1;29,7;28,5
2001;3520301;Iguape;27664;14088;13576;96,4;30,4;14
2001;3520400;Ilhabela;21502;11177;10325;92,4;28;62,1
2001;3520426;Ilha Comprida;6883;3483;3400;97,6;31,4;35
2001;3520442;Ilha Solteira;24134;11904;12230;102,7;31,4;37
2001;3520509;Indaiatuba;152040;75899;76141;100,3;30,1;488
2001;3520608;Indiana;4924;2496;2428;97,3;32;38,1
2001;3520707;Indiaporã;4060;2022;2038;100,8;34,4;14,5
2001;3520806;Inúbia Paulista;3347;1714;1633;95,3;32,5;38,4
2001;3520905;Ipaussu;12687;6349;6338;99,8;31,1;60,5
2001;3521002;Iperó;19276;10325;8951;86,7;28,5;113,2
2001;3521101;Ipeúna;4492;2331;2161;92,7;30;23,6
2001;3521150;Ipiguá;3566;1834;1732;94,4;31,8;26,2
2001;3521200;Iporanga;4544;2353;2191;93,1;27,5;3,9
2001;3521309;Ipuã;12070;6156;5914;96,1;29,7;25,9
2001;3521408;Iracemápolis;15939;8040;7899;98,2;30,6;138,5
2001;3521507;Irapuã;6719;3466;3253;93,9;32,1;26,1
2001;3521606;Irapuru;7499;3826;3673;96;34,8;35
2001;3521705;Itaberá;18844;9563;9281;97,1;29,3;17,1
2001;3521804;Itaí;21305;10970;10335;94,2;29,2;19,5
2001;3521903;Itajobi;14259;7199;7060;98,1;34;28,4
2001;3522000;Itaju;2694;1403;1291;92;33,5;11,7
2001;3522109;Itanhaém;73313;36374;36939;101,6;30,2;121,8
2001;3522158;Itaoca;3249;1670;1579;94,6;30;17,8
2001;3522208;Itapecerica da Serra;132225;65445;66780;102;26,6;877,2
2001;3522307;Itapetininga;127547;63871;63676;99,7;29,9;71,3
2001;3522406;Itapeva;83638;41380;42258;102,1;28,3;45,8
2001;3522505;Itapevi;165752;82012;83740;102,1;25,9;2005,3
2001;3522604;Itapira;63928;31994;31934;99,8;32,7;123,3
2001;3522653;Itapirapuã Paulista;3625;1904;1721;90,4;27,7;8,9
2001;3522703;Itápolis;37997;18949;19048;100,5;32,7;38,1
2001;3522802;Itaporanga;14392;7250;7142;98,5;30,5;28,3
2001;3522901;Itapuí;10531;5395;5136;95,2;31,5;75,2
2001;3523008;Itapura;3888;2034;1854;91,2;30,7;12,9
2001;3523107;Itaquaquecetuba;277321;138251;139070;100,6;25,6;3356,5
2001;3523206;Itararé;46771;23145;23626;102,1;29,2;46,6
2001;3523305;Itariri;13778;7041;6737;95,7;27,9;50,3
2001;3523404;Itatiba;83132;41385;41747;100,9;30,8;258
2001;3523503;Itatinga;15696;8038;7658;95,3;28,1;16
2001;3523602;Itirapina;13105;7343;5762;78,5;30,4;23,2
2001;3523701;Itirapuã;5476;2851;2625;92,1;30;34
2001;3523800;Itobi;7483;3890;3593;92,4;30,8;53,8
2001;3523909;Itu;137169;68326;68843;100,8;29,8;214,1
2001;3524006;Itupeva;27838;14258;13580;95,2;28,5;138,6
2001;3524105;Ituverava;36523;18046;18477;102,4;31,9;51,8
2001;3524204;Jaborandi;6435;3306;3129;94,6;31,4;23,5
2001;3524303;Jaboticabal;67879;33262;34617;104,1;31,8;96,1
2001;3524402;Jacareí;193323;95529;97794;102,4;29,9;416,4
2001;3524501;Jaci;4262;2211;2051;92,8;30,9;29,4
2001;3524600;Jacupiranga;17061;8721;8340;95,6;28,6;24,2
2001;3524709;Jaguariúna;30972;15608;15364;98,4;30,2;219,1
2001;3524808;Jales;46287;22892;23395;102,2;32,8;125,6
2001;3524907;Jambeiro;4129;2157;1972;91,4;30,6;22,4
2001;3525003;Jandira;93467;46326;47141;101,8;26,5;5356,5
2001;3525102;Jardinópolis;31371;15815;15556;98,4;30,2;62,5
2001;3525201;Jarinu;17661;9120;8541;93,7;29;85,1
2001;3525300;Jaú;113939;56267;57672;102,5;32,3;165,8
2001;3525409;Jeriquara;3275;1732;1543;89,1;28,8;23,1
2001;3525508;Joanópolis;10536;5365;5171;96,4;32;28,1
2001;3525607;João Ramalho;3866;1952;1914;98,1;29,2;9,3
2001;3525706;José Bonifácio;29138;14589;14549;99,7;31,4;33,9
2001;3525805;Júlio Mesquita;4210;2075;2135;102,9;30,6;32,8
2001;3525854;Jumirim;2245;1185;1060;89,5;31,3;39,6
2001;3525904;Jundiaí;327992;160737;167255;104,1;32,3;760,6
2001;3526001;Junqueirópolis;17187;9009;8178;90,8;34,3;29,5
2001;3526100;Juquiá;20464;10479;9985;95,3;28,7;25,2
2001;3526209;Juquitiba;26759;13471;13288;98,6;27,4;51,2
2001;3526308;Lagoinha;4954;2578;2376;92,2;32,4;19,4
2001;3526407;Laranjal Paulista;22433;11193;11240;100,4;32,2;58,4
2001;3526506;Lavínia;5511;2850;2661;93,4;32,7;10,2
2001;3526605;Lavrinhas;6063;3094;2969;96;27,9;36,3
2001;3526704;Leme;81836;41347;40489;97,9;29,6;203,1
2001;3526803;Lençóis Paulista;55727;27891;27836;99,8;29,7;68,8
2001;3526902;Limeira;251686;124819;126867;101,6;30,7;433,4
2001;3527009;Lindóia;5453;2747;2706;98,5;32,3;111,8
2001;3527108;Lins;66583;32301;34282;106,1;32,8;116,8
2001;3527207;Lorena;78452;38194;40258;105,4;30,6;189,4
2001;3527256;Lourdes;2014;1045;969;92,7;32,8;17,7
2001;3527306;Louveira;25049;12697;12352;97,3;28,9;449,4
2001;3527405;Lucélia;18508;9598;8910;92,8;32,7;58,8
2001;3527504;Lucianópolis;2165;1119;1046;93,5;31,4;11,4
2001;3527603;Luís Antônio;7550;3862;3688;95,5;27,4;12,6
2001;3527702;Luiziânia;4346;2187;2159;98,7;32,2;26,1
2001;3527801;Lupércio;4245;2132;2113;99,1;29,8;27,4
2001;3527900;Lutécia;2873;1462;1411;96,5;32;6
2001;3528007;Macatuba;15820;7951;7869;99;29,3;70,5
2001;3528106;Macaubal;7411;3770;3641;96,6;34,6;29,9
2001;3528205;Macedônia;3762;1904;1858;97,6;33,4;11,5
2001;3528304;Magda;3406;1756;1650;94;33,8;10,9
2001;3528403;Mairinque;40277;20150;20127;99,9;28,5;191,7
2001;3528502;Mairiporã;62083;31227;30856;98,8;29,2;193,6
2001;3528601;Manduri;8331;4259;4072;95,6;31,7;36,4
2001;3528700;Marabá Paulista;3824;2015;1809;89,8;30,7;4,2
2001;3528809;Maracaí;13032;6633;6399;96,5;30,8;24,4
2001;3528858;Marapoama;2275;1153;1122;97,3;32,7;20,4
2001;3528908;Mariápolis;3862;1991;1871;94;33,3;20,7
2001;3529005;Marília;199268;97346;101922;104,7;31,6;170,2
2001;3529104;Marinópolis;2194;1127;1067;94,7;31,3;28,2
2001;3529203;Martinópolis;22541;11568;10973;94,9;31,9;18
2001;3529302;Matão;72313;36132;36181;100,1;30,4;137,8
2001;3529401;Mauá;369102;181590;187512;103,3;28;5959,3
2001;3529500;Mendonça;3844;1973;1871;94,8;34,8;19,7
2001;3529609;Meridiano;4017;2046;1971;96,3;33;17,6
2001;3529658;Mesópolis;1939;993;946;95,3;32,6;13
2001;3529708;Miguelópolis;19182;9634;9548;99,1;29,9;23,4
2001;3529807;Mineiros do Tietê;11483;5771;5712;99;30,6;53,8
2001;3529906;Miracatu;22244;11464;10780;94;27,6;22,2
2001;3530003;Mira Estrela;2626;1359;1267;93,2;33,2;12,1
2001;3530102;Mirandópolis;26102;13935;12167;87,3;33,3;28,4
2001;3530201;Mirante do Paranapanema;16294;8314;7980;96;31,8;13,2
2001;3530300;Mirassol;48815;24080;24735;102,7;32,3;200,7
2001;3530409;Mirassolândia;3783;1944;1839;94,6;32,1;22,8
2001;3530508;Mococa;65773;33144;32629;98,4;31,5;76,9
2001;3530607;Mogi das Cruzes;335957;165290;170667;103,3;29,2;471,5
2001;3530706;Mogi Guaçu;125550;63011;62539;99,3;30,4;154,5
2001;3530805;Mogi Mirim;81848;40846;41002;100,4;31,6;164,4
2001;3530904;Mombuca;3121;1600;1521;95,1;28,9;23,3
2001;3531001;Monções;2072;1052;1020;97;34,6;19,9
2001;3531100;Mongaguá;36151;18494;17657;95,5;30,4;253,2
2001;3531209;Monte Alegre do Sul;6394;3253;3141;96,6;33,4;58
2001;3531308;Monte Alto;43967;21990;21977;99,9;32,6;126,7
2001;3531407;Monte Aprazível;18738;9295;9443;101,6;34,6;37,8
2001;3531506;Monte Azul Paulista;19565;9872;9693;98,2;31,1;74,3
2001;3531605;Monte Castelo;4091;2069;2022;97,7;34,1;17,5
2001;3531704;Monteiro Lobato;3670;1894;1776;93,8;30,7;11
2001;3531803;Monte Mor;38422;19307;19115;99;28,2;159,7
2001;3531902;Morro Agudo;25749;13150;12599;95,8;28,5;18,5
2001;3532009;Morungaba;10099;5106;4993;97,8;29,8;68,8
2001;3532058;Motuca;3905;2011;1894;94,2;29,3;17,1
2001;3532108;Murutinga do Sul;3999;2034;1965;96,6;35,5;15,9
2001;3532157;Nantes;2320;1182;1138;96,3;28,8;8,1
2001;3532207;Narandiba;3798;1920;1878;97,8;29,7;10,6
2001;3532306;Natividade da Serra;6944;3671;3273;89,2;32,1;8,3
2001;3532405;Nazaré Paulista;14637;7546;7091;94;30,6;44,9
2001;3532504;Neves Paulista;8908;4481;4427;98,8;34,9;40,7
2001;3532603;Nhandeara;10274;5057;5217;103,2;35,5;23,6
2001;3532702;Nipoã;3358;1726;1632;94,6;32,2;24,4
2001;3532801;Nova Aliança;4879;2427;2452;101;34,3;22,4
2001;3532827;Nova Campina;7419;3863;3556;92,1;25,5;19,3
2001;3532843;Nova Canaã Paulista;2461;1275;1186;93;35,9;19,8
2001;3532868;Nova Castilho;1004;523;481;92;32,5;5,5
2001;3532900;Nova Europa;7464;3787;3677;97,1;30,1;46,6
2001;3533007;Nova Granada;17241;8659;8582;99,1;31,9;32,4
2001;3533106;Nova Guataporanga;2106;1082;1024;94,6;34,5;61,7
2001;3533205;Nova Independência;2160;1099;1061;96,5;32,4;8,2
2001;3533254;Novais;3338;1747;1591;91,1;30,6;28,3
2001;3533304;Nova Luzitânia;2820;1477;1343;90,9;31,5;38,2
2001;3533403;Nova Odessa;43007;21326;21681;101,7;30,5;582,8
2001;3533502;Novo Horizonte;32891;16345;16546;101,2;32,8;35,3
2001;3533601;Nuporanga;6361;3224;3137;97,3;31,8;18,3
2001;3533700;Ocauçu;4192;2183;2009;92;31,5;13,9
2001;3533809;Óleo;2964;1519;1445;95,1;32,7;14,9
2001;3533908;Olímpia;46401;22972;23429;102;32,5;57,8
2001;3534005;Onda Verde;3463;1762;1701;96,5;30,3;14,3
2001;3534104;Oriente;5919;2933;2986;101,8;32,9;27,1
2001;3534203;Orindiúva;4293;2211;2082;94,2;28,8;17,4
2001;3534302;Orlândia;36370;18027;18343;101,8;30,7;124,7
2001;3534401;Osasco;654745;318299;336446;105,7;29,2;10080,1
2001;3534500;Oscar Bressane;2549;1248;1301;104,2;34,3;11,5
2001;3534609;Osvaldo Cruz;29849;14743;15106;102,5;34,1;120,3
2001;3534708;Ourinhos;94744;46470;48274;103,9;31,1;320,3
2001;3534757;Ouroeste;6498;3261;3237;99,3;32,1;22,5
2001;3534807;Ouro Verde;7220;3618;3602;99,6;31,1;27,1
2001;3534906;Pacaembu;12613;6765;5848;86,4;33,9;37,2
2001;3535002;Palestina;9280;4622;4658;100,8;34,9;13,3
2001;3535101;Palmares Paulista;8675;4441;4234;95,3;28;105,6
2001;3535200;Palmeira d'Oeste;10277;5215;5062;97,1;34,2;32,2
2001;3535309;Palmital;20751;10261;10490;102,2;33,3;37,8
2001;3535408;Panorama;13756;7004;6752;96,4;29,5;38,6
2001;3535507;Paraguaçu Paulista;39942;19825;20117;101,5;30,7;39,9
2001;3535606;Paraibuna;17065;8725;8340;95,6;29,9;21,1
2001;3535705;Paraíso;5479;2847;2632;92,4;31,8;35,3
2001;3535804;Paranapanema;15755;8175;7580;92,7;28,7;15,5
2001;3535903;Paranapuã;3661;1862;1799;96,6;32,9;26,1
2001;3536000;Parapuã;11104;5642;5462;96,8;33,5;30,3
2001;3536109;Pardinho;4810;2494;2316;92,9;29,3;22,9
2001;3536208;Pariquera-Açu;17700;8902;8798;98,8;29;49,2
2001;3536257;Parisi;1947;1016;931;91,6;33,8;23
2001;3536307;Patrocínio Paulista;11550;5909;5641;95,5;30,2;19,2
2001;3536406;Paulicéia;5413;2814;2599;92,4;29,2;14,5
2001;3536505;Paulínia;54150;27079;27071;100;29,3;390,2
2001;3536570;Paulistânia;1780;946;834;88,2;30,5;6,9
2001;3536604;Paulo de Faria;8510;4243;4267;100,6;31,4;11,5
2001;3536703;Pederneiras;37086;18715;18371;98,2;30,1;51
2001;3536802;Pedra Bela;5637;2973;2664;89,6;31,9;35,5
2001;3536901;Pedranópolis;2726;1395;1331;95,4;34,8;10,5
2001;3537008;Pedregulho;15086;7704;7382;95,8;29,8;21,2
2001;3537107;Pedreira;35832;17764;18068;101,7;31,2;329,3
2001;3537156;Pedrinhas Paulista;2887;1459;1428;97,9;31,1;19
2001;3537206;Pedro de Toledo;9291;4741;4550;96;29,2;13,9
2001;3537305;Penápolis;55054;26898;28156;104,7;32,5;77,4
2001;3537404;Pereira Barreto;25087;12387;12700;102,5;31,7;25,8
2001;3537503;Pereiras;6331;3242;3089;95,3;32,6;28,4
2001;3537602;Peruíbe;52224;25965;26259;101,1;30,3;160,1
2001;3537701;Piacatu;4695;2366;2329;98,4;32,5;20,2
2001;3537800;Piedade;50477;26416;24061;91,1;30;67,6
2001;3537909;Pilar do Sul;24205;12461;11744;94,2;28,8;35,5
2001;3538006;Pindamonhangaba;128230;63894;64336;100,7;29,1;175,3
2001;3538105;Pindorama;13284;6739;6545;97,1;33,9;71,9
2001;3538204;Pinhalzinho;11186;5779;5407;93,6;32,4;72,4
2001;3538303;Piquerobi;3476;1763;1713;97,2;32,7;7,2
2001;3538501;Piquete;15096;7371;7725;104,8;32;85,8
2001;3538600;Piracaia;23526;11922;11604;97,3;30,7;61
2001;3538709;Piracicaba;332652;164030;168622;102,8;31,3;241,4
2001;3538808;Piraju;28023;13719;14304;104,3;32,1;55,5
2001;3538907;Pirajuí;20373;10904;9469;86,8;32,5;24,7
2001;3539004;Pirangi;10106;5179;4927;95,1;33,7;46,8
2001;3539103;Pirapora do Bom Jesus;12710;6362;6348;99,8;26,3;117,2
2001;3539202;Pirapozinho;22435;10982;11453;104,3;30,9;47
2001;3539301;Pirassununga;65406;32222;33184;103;32,2;90
2001;3539400;Piratininga;10742;5424;5318;98;32,3;26,7
2001;3539509;Pitangueiras;31621;16193;15428;95,3;28,5;73,4
2001;3539608;Planalto;3749;1914;1835;95,9;31,1;12,9
2001;3539707;Platina;2900;1521;1379;90,7;30,6;8,9
2001;3539806;Poá;96716;47355;49361;104,2;28,2;5602,3
2001;3539905;Poloni;4830;2368;2462;104;36;35,7
2001;3540002;Pompéia;18402;9110;9292;102;31,8;23,5
2001;3540101;Pongaí;3670;1909;1761;92,2;34,2;20
2001;3540200;Pontal;30642;15591;15051;96,5;27,7;86
2001;3540259;Pontalinda;3594;1878;1716;91,4;30,4;17,2
2001;3540309;Pontes Gestal;2545;1269;1276;100,6;33,3;11,7
2001;3540408;Populina;4442;2292;2150;93,8;33,4;14,1
2001;3540507;Porangaba;6822;3606;3216;89,2;32,3;25,7
2001;3540606;Porto Feliz;45861;23007;22854;99,3;30,3;82,4
2001;3540705;Porto Ferreira;47769;23799;23970;100,7;31,1;195,1
2001;3540754;Potim;14144;7252;6892;95;27,3;316,8
2001;3540804;Potirendaba;13803;7080;6723;95;34,4;40,3
2001;3540853;Pracinha;1574;831;743;89,4;32,8;25
2001;3540903;Pradópolis;13301;6759;6542;96,8;29,5;79,5
2001;3541000;Praia Grande;199716;97389;102327;105,1;30,2;1334,5
2001;3541059;Pratânia;4018;2099;1919;91,4;28,8;22,9
2001;3541109;Presidente Alves;4298;2173;2125;97,8;31,6;15
2001;3541208;Presidente Bernardes;14574;7546;7028;93,1;33,3;19,5
2001;3541307;Presidente Epitácio;39512;19642;19870;101,2;30,2;31,4
2001;3541406;Presidente Prudente;191176;92711;98465;106,2;31,8;341
2001;3541505;Presidente Venceslau;37497;18775;18722;99,7;32,6;49,7
2001;3541604;Promissão;31557;15920;15637;98,2;31,4;40,5
2001;3541653;Quadra;2702;1423;1279;89,9;31,8;13,1
2001;3541703;Quatá;11754;5851;5903;100,9;30,6;18
2001;3541802;Queiroz;2245;1152;1093;94,9;30,1;9,6
2001;3541901;Queluz;9338;4645;4693;101;29,2;37,4
2001;3542008;Quintana;5495;2772;2723;98,2;31,7;17,2
2001;3542107;Rafard;8399;4203;4196;99,8;30,9;69
2001;3542206;Rancharia;28829;14287;14542;101,8;31,3;18,2
2001;3542305;Redenção da Serra;4032;2161;1871;86,6;31,8;13
2001;3542404;Regente Feijó;17157;8580;8577;100;31,6;65,2
2001;3542503;Reginópolis;5005;2582;2423;93,8;33;12,2
2001;3542602;Registro;53931;26888;27043;100,6;28,7;74,7
2001;3542701;Restinga;5661;2887;2774;96,1;27,9;23
2001;3542800;Ribeira;3496;1833;1663;90,7;30,8;10,4
2001;3542909;Ribeirão Bonito;11346;5745;5601;97,5;30,5;24,1
2001;3543006;Ribeirão Branco;21053;10986;10067;91,6;25,4;30,2
2001;3543105;Ribeirão Corrente;3916;2078;1838;88,5;29,1;26,4
2001;3543204;Ribeirão do Sul;4482;2284;2198;96,2;32,1;22,1
2001;3543238;Ribeirão dos Índios;2221;1144;1077;94,1;33,9;11,3
2001;3543253;Ribeirão Grande;7403;3821;3582;93,7;28,5;22,2
2001;3543303;Ribeirão Pires;105406;52037;53369;102,6;29,9;1065
2001;3543402;Ribeirão Preto;514481;247565;266916;107,8;31,7;790,4
2001;3543501;Riversul;7122;3631;3491;96,1;31,1;18,5
2001;3543600;Rifaina;3328;1705;1623;95,2;31,9;20,5
2001;3543709;Rincão;10357;5236;5121;97,8;29,7;32,7
2001;3543808;Rinópolis;10221;5245;4976;94,9;34,4;28,5
2001;3543907;Rio Claro;169908;83028;86880;104,6;32,2;340,9
2001;3544004;Rio das Pedras;24031;12230;11801;96,5;29,2;106
2001;3544103;Rio Grande da Serra;37750;18791;18959;100,9;27,1;1038,8
2001;3544202;Riolândia;8735;4888;3847;78,7;30,9;13,8
2001;3544251;Rosana;23861;12091;11770;97,3;27,2;32,1
2001;3544301;Roseira;8660;4410;4250;96,4;28,7;66,7
2001;3544400;Rubiácea;2373;1210;1163;96,1;31;10
2001;3544509;Rubinéia;2642;1305;1337;102,5;34,3;10,9
2001;3544608;Sabino;4960;2477;2483;100,2;33,1;16,2
2001;3544707;Sagres;2437;1243;1194;96,1;31,7;16,5
2001;3544806;Sales;4648;2367;2281;96,4;32,1;15,1
2001;3544905;Sales Oliveira;9427;4725;4702;99,5;31,5;30,8
2001;3545001;Salesópolis;14501;7337;7164;97,6;30;34,1
2001;3545100;Salmourão;4448;2272;2176;95,8;32,2;25,7
2001;3545159;Saltinho;5904;2980;2924;98,1;32,4;59,2
2001;3545209;Salto;94343;47138;47205;100,1;29,6;709
2001;3545308;Salto de Pirapora;35590;17838;17752;99,5;29,3;126,9
2001;3545407;Salto Grande;8476;4256;4220;99,2;31,9;45
2001;3545506;Sandovalina;3150;1570;1580;100,6;28,4;6,9
2001;3545605;Santa Adélia;13561;6844;6717;98,1;32,2;41,1
2001;3545704;Santa Albertina;5622;2828;2794;98,8;35,5;20,6
2001;3545803;Santa Bárbara d'Oeste;170990;85369;85621;100,3;30,2;630,9
2001;3546009;Santa Branca;13071;6600;6471;98;30,7;48
2001;3546108;Santa Clara d'Oeste;2132;1071;1061;99,1;33,8;11,6
2001;3546207;Santa Cruz da Conceição;3576;1825;1751;95,9;32,4;23,8
2001;3546256;Santa Cruz da Esperança;1816;931;885;95,1;30,4;12,3
2001;3546306;Santa Cruz das Palmeiras;25951;13117;12834;97,8;30,2;87,9
2001;3546405;Santa Cruz do Rio Pardo;41261;20420;20841;102,1;31,8;37
2001;3546504;Santa Ernestina;5727;3096;2631;85;28,5;42,6
2001;3546603;Santa Fé do Sul;26800;13029;13771;105,7;33,5;129,8
2001;3546702;Santa Gertrudes;16404;8355;8049;96,3;29,2;166,9
2001;3546801;Santa Isabel;44510;22461;22049;98,2;29;122,5
2001;3546900;Santa Lúcia;7879;4059;3820;94,1;28,4;51,2
2001;3547007;Santa Maria da Serra;4744;2470;2274;92,1;29,4;18,8
2001;3547106;Santa Mercedes;2812;1427;1385;97,1;32,4;16,9
2001;3547205;Santana da Ponte Pensa;1878;965;913;94,6;36,1;14,5
2001;3547304;Santana de Parnaíba;77702;38698;39004;100,8;27,2;431,8
2001;3547403;Santa Rita d'Oeste;2696;1354;1342;99,1;36,3;12,9
2001;3547502;Santa Rita do Passa Quatro;26206;12769;13437;105,2;34,8;34,7
2001;3547601;Santa Rosa de Viterbo;21680;10801;10879;100,7;31,5;75,1
2001;3547650;Santa Salete;1387;730;657;90;36;17,5
2001;3547700;Santo Anastácio;20771;10155;10616;104,5;32,6;37,6
2001;3547809;Santo André;652940;315377;337563;107;32,2;3714,5
2001;3547908;Santo Antônio da Alegria;5825;3033;2792;92,1;31,9;18,8
2001;3548005;Santo Antônio de Posse;18357;9248;9109;98,5;30,2;119,1
2001;3548054;Santo Antônio do Aracanguá;7009;3643;3366;92,4;30,3;5,4
2001;3548104;Santo Antônio do Jardim;6139;3207;2932;91,4;32,1;55,8
2001;3548203;Santo Antônio do Pinhal;6349;3254;3095;95,1;29,4;47,7
2001;3548302;Santo Expedito;2552;1319;1233;93,5;33;27
2001;3548401;Santópolis do Aguapeí;3861;1963;1898;96,7;30,4;30,2
2001;3548500;Santos;418587;193349;225238;116,5;35,8;1489,5
2001;3548609;São Bento do Sapucaí;10372;5249;5123;97,6;32,1;41,1
2001;3548708;São Bernardo do Campo;709057;344797;364260;105,6;29,9;1731,4
2001;3548807;São Caetano do Sul;141166;65919;75247;114,2;36,6;9208
2001;3548906;São Carlos;195643;96821;98822;102,1;31,9;172,1
2001;3549003;São Francisco;2863;1443;1420;98,4;33,8;37,9
2001;3549102;São João da Boa Vista;78025;38316;39709;103,6;32,8;151,1
2001;3549201;São João das Duas Pontes;2665;1358;1307;96,2;32,1;20,6
2001;3549250;São João de Iracema;1686;866;820;94,7;32,2;9,5
2001;3549300;São João do Pau d'Alho;2180;1109;1071;96,6;35,2;18,5
2001;3549409;São Joaquim da Barra;42043;20732;21311;102,8;31,2;102,3
2001;3549508;São José da Bela Vista;8104;4144;3960;95,6;28,9;29,3
2001;3549607;São José do Barreiro;4126;2143;1983;92,5;30,7;7,2
2001;3549706;São José do Rio Pardo;50349;24941;25408;101,9;31,8;120
2001;3549805;São José do Rio Preto;363056;175552;187504;106,8;32,5;840,5
2001;3549904;São José dos Campos;548091;270638;277453;102,5;29,2;498,5
2001;3549953;São Lourenço da Serra;12369;6270;6099;97,3;28,1;66,3
2001;3550001;São Luiz do Paraitinga;10460;5419;5041;93;31,9;16,9
2001;3550100;São Manuel;36823;18245;18578;101,8;30,8;56,6
2001;3550209;São Miguel Arcanjo;30902;15804;15098;95,5;28,3;33,2
2001;3550308;São Paulo;10525367;5013764;5511603;109,9;31;6919,1
2001;3550407;São Pedro;28285;13927;14358;103,1;32;46,3
2001;3550506;São Pedro do Turvo;6928;3509;3419;97,4;30,8;9,5
2001;3550605;São Roque;67963;33801;34162;101,1;30,8;221,4
2001;3550704;São Sebastião;59409;30062;29347;97,6;27,9;147,6
2001;3550803;São Sebastião da Grama;12448;6335;6113;96,5;31,2;49,3
2001;3550902;São Simão;13740;6842;6898;100,8;31,7;22,3
2001;3551009;São Vicente;306387;148480;157907;106,3;30;2068,1
2001;3551108;Sarapuí;7939;4128;3811;92,3;30;22,5
2001;3551207;Sarutaiá;3723;1879;1844;98,1;31;26,3
2001;3551306;Sebastianópolis do Sul;2594;1327;1267;95,5;34,4;15,5
2001;3551405;Serra Azul;7833;4049;3784;93,5;28,7;27,7
2001;3551504;Serrana;33150;16684;16466;98,7;27,7;263
2001;3551603;Serra Negra;24116;11886;12230;102,9;33,6;118,4
2001;3551702;Sertãozinho;96136;48221;47915;99,4;29,8;238,5
2001;3551801;Sete Barras;13662;7130;6532;91,6;28,5;12,9
2001;3551900;Severínia;13790;7167;6623;92,4;28,9;98,2
2001;3552007;Silveiras;5419;2780;2639;94,9;30,3;13,1
2001;3552106;Socorro;33141;16546;16595;100,3;33,7;73,8
2001;3552205;Sorocaba;502343;247036;255307;103,3;30,3;1116,6
2001;3552304;Sud Mennucci;7368;3749;3619;96,5;30,2;12,4
2001;3552403;Sumaré;200591;100575;100016;99,4;28,3;1307,1
2001;3552502;Suzano;231777;114690;117087;102,1;27,7;1123,8
2001;3552551;Suzanápolis;2845;1469;1376;93,7;32,2;8,6
2001;3552601;Tabapuã;10590;5355;5235;97,8;33,5;30,6
2001;3552700;Tabatinga;13172;6694;6478;96,8;30,7;35,7
2001;3552809;Taboão da Serra;202242;97518;104724;107,4;27,8;9919,8
2001;3552908;Taciba;5292;2685;2607;97,1;30,7;8,7
2001;3553005;Taguaí;7791;3937;3854;97,9;30,2;53,6
2001;3553104;Taiaçu;5639;2864;2775;96,9;31,2;52,7
2001;3553203;Taiúva;5513;2762;2751;99,6;33,4;41,6
2001;3553302;Tambaú;22314;11269;11045;98;31,1;39,7
2001;3553401;Tanabi;22775;11297;11478;101,6;33,7;30,5
2001;3553500;Tapiraí;8527;4382;4145;94,6;28,1;11,3
2001;3553609;Tapiratiba;12961;6439;6522;101,3;30,5;58,4
2001;3553658;Taquaral;2721;1404;1317;93,8;30,8;50,5
2001;3553708;Taquaritinga;52280;26401;25879;98;31,4;88
2001;3553807;Taquarituba;22015;11062;10953;99;30,1;49,1
2001;3553856;Taquarivaí;4536;2312;2224;96,2;25,9;19,6
2001;3553906;Tarabai;5867;2973;2894;97,3;29,8;29,1
2001;3553955;Tarumã;10960;5616;5344;95,2;28,8;36,2
2001;3554003;Tatuí;94748;47158;47590;100,9;30,2;180,9
2001;3554102;Taubaté;247562;121938;125624;103;30,5;396,1
2001;3554201;Tejupá;5299;2780;2519;90,6;28,2;17,9
2001;3554300;Teodoro Sampaio;20209;10129;10080;99,5;28,6;13
2001;3554409;Terra Roxa;7808;3987;3821;95,8;31,1;35,2
2001;3554508;Tietê;32208;15993;16215;101,4;31,8;79,6
2001;3554607;Timburi;2718;1402;1316;93,9;33,1;13,8
2001;3554656;Torre de Pedra;2149;1102;1047;95;33,3;30,1
2001;3554706;Torrinha;8899;4508;4391;97,4;33,1;28,2
2001;3554755;Trabiju;1401;729;672;92,2;30;22,1
2001;3554805;Tremembé;35438;18476;16962;91,8;29,6;185,4
2001;3554904;Três Fronteiras;5193;2610;2583;99;34,3;34,3
2001;3554953;Tuiuti;5044;2599;2445;94,1;33,3;39,8
2001;3555000;Tupã;63454;30895;32559;105,4;33,8;101
2001;3555109;Tupi Paulista;13423;6673;6750;101,2;35,8;54,8
2001;3555208;Turiúba;1901;978;923;94,4;35,6;12,4
2001;3555307;Turmalina;2338;1168;1170;100,2;35,4;15,8
2001;3555356;Ubarana;4339;2265;2074;91,6;28,7;20,7
2001;3555406;Ubatuba;68036;34419;33617;97,7;27,7;96,1
2001;3555505;Ubirajara;4182;2155;2027;94,1;31,3;14,8
2001;3555604;Uchoa;9074;4554;4520;99,3;34;35,9
2001;3555703;União Paulista;1379;718;661;92,1;33,4;17,4
2001;3555802;Urânia;8827;4413;4414;100;33,8;42,2
2001;3555901;Uru;1395;729;666;91,4;33,8;9,5
2001;3556008;Urupês;11941;6016;5925;98,5;34,4;36,9
2001;3556107;Valentim Gentil;8822;4484;4338;96,7;31,5;58,9
2001;3556206;Valinhos;85223;42441;42782;100,8;31,8;573,7
2001;3556305;Valparaíso;18960;9990;8970;89,8;30,6;22,1
2001;3556354;Vargem;7148;3674;3474;94,6;32;50,1
2001;3556404;Vargem Grande do Sul;36601;18244;18357;100,6;31,3;137
2001;3556453;Vargem Grande Paulista;33510;16774;16736;99,8;27,6;788,7
2001;3556503;Várzea Paulista;94100;47225;46875;99,3;27,8;2679,4
2001;3556602;Vera Cruz;11088;5518;5570;100,9;32,5;44,8
2001;3556701;Vinhedo;48742;24243;24499;101,1;31,3;602,1
2001;3556800;Viradouro;16074;8130;7944;97,7;30,4;73,8
2001;3556909;Vista Alegre do Alto;4946;2493;2453;98,4;31,8;51,8
2001;3556958;Vitória Brasil;1683;869;814;93,7;31,6;33,8
2001;3557006;Votorantim;97223;48505;48718;100,4;28,8;527,9
2001;3557105;Votuporanga;76581;37564;39017;103,9;33;182
2001;3557154;Zacarias;1986;1028;958;93,2;32,8;6,2
2001;3557204;Chavantes;12199;6085;6114;100,5;30,7;64,6
2001;3557303;Estiva Gerbi;8968;4621;4347;94,1;29,2;121
2002;3500105;Adamantina;33636;16387;17249;105,3;34,5;81,6
2002;3500204;Adolfo;3674;1863;1811;97,2;33;17,4
2002;3500303;Aguaí;28995;14552;14443;99,3;30,9;61,1
2002;3500402;Águas da Prata;7229;3626;3603;99,4;34,7;50,7
2002;3500501;Águas de Lindóia;16368;8093;8275;102,2;32,6;272,2
2002;3500550;Águas de Santa Bárbara;5308;2669;2639;98,9;31,9;13,1
2002;3500600;Águas de São Pedro;2049;948;1101;116,1;38,5;567,3
2002;3500709;Agudos;33006;16390;16616;101,4;29,8;34,1
2002;3500758;Alambari;3902;2000;1902;95,1;29,9;24,4
2002;3500808;Alfredo Marcondes;3751;1911;1840;96,3;34,9;31,5
2002;3500907;Altair;3585;1912;1673;87,5;29,6;11,5
2002;3501004;Altinópolis;15586;7862;7724;98,2;31,9;16,8
2002;3501103;Alto Alegre;4238;2199;2039;92,7;35,4;13,3
2002;3501152;Alumínio;15600;7873;7727;98,1;28,3;186,6
2002;3501202;Álvares Florence;4260;2216;2044;92,2;36,2;11,8
2002;3501301;Álvares Machado;22876;11471;11405;99,4;31;65,8
2002;3501400;Álvaro de Carvalho;4213;2554;1659;65;30,3;27,4
2002;3501509;Alvinlândia;2870;1445;1425;98,6;30,6;33,8
2002;3501608;Americana;188246;92948;95298;102,5;32,5;1405,7
2002;3501707;Américo Brasiliense;29412;14941;14471;96,9;28,1;239,2
2002;3501806;Américo de Campos;5638;2825;2813;99,6;34,5;22,3
2002;3501905;Amparo;61561;30637;30924;100,9;32,8;138,2
2002;3502002;Analândia;3705;1916;1789;93,4;31,4;11,4
2002;3502101;Andradina;55322;27266;28056;102,9;33,1;57,4
2002;3502200;Angatuba;19940;10233;9707;94,9;30,9;19,4
2002;3502309;Anhembi;4738;2441;2297;94,1;30,8;6,4
2002;3502408;Anhumas;3483;1772;1711;96,6;31,5;10,9
2002;3502507;Aparecida;34888;17068;17820;104,4;31,1;288,6
2002;3502606;Aparecida d'Oeste;4865;2412;2453;101,7;34,6;27,2
2002;3502705;Apiaí;26980;13590;13390;98,5;27,7;27,7
2002;3502754;Araçariguama;12248;6285;5963;94,9;27,5;84,4
2002;3502804;Araçatuba;172010;83198;88812;106,7;32,9;147,4
2002;3502903;Araçoiaba da Serra;21260;10691;10569;98,9;31,2;83,3
2002;3503000;Aramina;4845;2461;2384;96,9;32,5;23,9
2002;3503109;Arandu;6120;3111;3009;96,7;29,4;21,4
2002;3503158;Arapeí;2609;1304;1305;100,1;31,8;16,6
2002;3503208;Araraquara;187484;91053;96431;105,9;33,1;186,8
2002;3503307;Araras;106956;53344;53612;100,5;31,6;165,9
2002;3503356;Arco-Íris;2125;1110;1015;91,4;33,5;8
2002;3503406;Arealva;7368;3786;3582;94,6;34,5;14,6
2002;3503505;Areias;3622;1825;1797;98,5;29,7;11,9
2002;3503604;Areiópolis;10396;5349;5047;94,4;27,5;121
2002;3503703;Ariranha;7677;3922;3755;95,7;32,8;57,9
2002;3503802;Artur Nogueira;35281;17687;17594;99,5;29,2;198,2
2002;3503901;Arujá;62253;30993;31260;100,9;28;647,3
2002;3503950;Aspásia;1867;958;909;94,9;34,2;26,9
2002;3504008;Assis;88853;43232;45621;105,5;32,9;192,9
2002;3504107;Atibaia;114490;56817;57673;101,5;30,9;239,3
2002;3504206;Auriflama;13670;6884;6786;98,6;32,9;31,5
2002;3504305;Avaí;4669;2416;2253;93,3;31;8,6
2002;3504404;Avanhandava;9338;4746;4592;96,8;29,9;27,6
2002;3504503;Avaré;77727;38775;38952;100,5;31,3;64,1
2002;3504602;Bady Bassitt;12128;6100;6028;98,8;31,3;109,9
2002;3504701;Balbinos;1787;1004;783;78;33,2;19,5
2002;3504800;Bálsamo;7512;3734;3778;101,2;34,4;50,1
2002;3504909;Bananal;9854;4891;4963;101,5;31,8;16
2002;3505005;Barão de Antonina;2869;1466;1403;95,7;32,2;18,7
2002;3505104;Barbosa;5986;3017;2969;98,4;30,7;29,2
2002;3505203;Bariri;28975;14513;14462;99,6;33,6;65,2
2002;3505302;Barra Bonita;35480;17667;17813;100,8;32,3;236,3
2002;3505351;Barra do Chapéu;4939;2652;2287;86,2;28,4;12,2
2002;3505401;Barra do Turvo;8059;4231;3828;90,5;28,3;8
2002;3505500;Barretos;105548;51378;54170;105,4;32,4;67,4
2002;3505609;Barrinha;25016;12672;12344;97,4;27,3;171,3
2002;3505708;Barueri;214563;105711;108852;103;27,3;3265,8
2002;3505807;Bastos;20613;10231;10382;101,5;30,8;120,6
2002;3505906;Batatais;52206;25853;26353;101,9;32,3;61,5
2002;3506003;Bauru;321811;157032;164779;104,9;31,9;482
2002;3506102;Bebedouro;75075;36940;38135;103,2;31,8;109,9
2002;3506201;Bento de Abreu;2438;1248;1190;95,4;31,7;8,1
2002;3506300;Bernardino de Campos;10748;5310;5438;102,4;33,7;44
2002;3506359;Bertioga;33108;16998;16110;94,8;27,4;67,4
2002;3506409;Bilac;6285;3103;3182;102,5;34,5;39,8
2002;3506508;Birigui;97156;47782;49374;103,3;31,9;183,3
2002;3506607;Biritiba Mirim;25462;12900;12562;97,4;28,9;80,2
2002;3506706;Boa Esperança do Sul;12822;6508;6314;97;29,5;18,6
2002;3506805;Bocaina;9705;4837;4868;100,6;32,1;26,7
2002;3506904;Bofete;7816;4077;3739;91,7;30,8;12
2002;3507001;Boituva;36985;18710;18275;97,7;29,8;148,6
2002;3507100;Bom Jesus dos Perdões;14544;7313;7231;98,9;29,6;134,2
2002;3507159;Bom Sucesso de Itararé;3291;1697;1594;93,9;25,8;24,6
2002;3507209;Borá;802;411;391;95,1;31,4;6,7
2002;3507308;Boracéia;3837;1979;1858;93,9;31,2;31,4
2002;3507407;Borborema;13482;6837;6645;97,2;33,2;24,4
2002;3507456;Borebi;1995;1031;964;93,5;29,4;5,7
2002;3507506;Botucatu;112058;54643;57415;105,1;32,1;75,6
2002;3507605;Bragança Paulista;129462;64013;65449;102,2;31,4;252,6
2002;3507704;Braúna;4494;2292;2202;96,1;34;23
2002;3507753;Brejo Alegre;2366;1224;1142;93,3;31,2;22,4
2002;3507803;Brodowski;17946;8998;8948;99,4;31,4;64,4
2002;3507902;Brotas;19381;9746;9635;98,9;31,7;17,6
2002;3508009;Buri;17783;9303;8480;91,2;28,1;14,9
2002;3508108;Buritama;14177;7067;7110;100,6;32,6;43,4
2002;3508207;Buritizal;3748;1913;1835;95,9;32,8;14,1
2002;3508306;Cabrália Paulista;4624;2329;2295;98,5;29,7;19,3
2002;3508405;Cabreúva;34708;17746;16962;95,6;27,6;133,4
2002;3508504;Caçapava;77951;38697;39254;101,4;30,3;211,3
2002;3508603;Cachoeira Paulista;27859;13795;14064;101,9;31,3;96,7
2002;3508702;Caconde;18521;9375;9146;97,6;31,1;39,6
2002;3508801;Cafelândia;15982;7898;8084;102,4;32,8;17,4
2002;3508900;Caiabu;4081;2089;1992;95,4;32,4;16,1
2002;3509007;Caieiras;73994;36631;37363;102;28,4;757,8
2002;3509106;Caiuá;4366;2283;2083;91,2;31,5;7,9
2002;3509205;Cajamar;53303;26828;26475;98,7;27,3;405,7
2002;3509254;Cajati;29165;15004;14161;94,4;27,5;64,2
2002;3509304;Cajobi;9309;4803;4506;93,8;32,1;52,6
2002;3509403;Cajuru;21313;10780;10533;97,7;30,6;32,3
2002;3509452;Campina do Monte Alegre;5285;2714;2571;94,7;30,4;28,6
2002;3509502;Campinas;991678;482220;509458;105,6;31,9;1248,1
2002;3509601;Campo Limpo Paulista;65744;32692;33052;101,1;29,1;828
2002;3509700;Campos do Jordão;45101;22345;22756;101,8;28,6;155,5
2002;3509809;Campos Novos Paulista;4243;2194;2049;93,4;31,9;8,8
2002;3509908;Cananéia;12322;6218;6104;98,2;29,1;10
2002;3509957;Canas;3759;1938;1821;94;29,1;70,6
2002;3510005;Cândido Mota;29455;14676;14779;100,7;31,9;49,4
2002;3510104;Cândido Rodrigues;2628;1294;1334;103,1;36;37,1
2002;3510153;Canitar;3678;1872;1806;96,5;28,2;64
2002;3510203;Capão Bonito;46953;23566;23387;99,2;28,9;28,6
2002;3510302;Capela do Alto;14925;7665;7260;94,7;28,8;87,9
2002;3510401;Capivari;42852;21347;21505;100,7;30,2;132,7
2002;3510500;Caraguatatuba;83164;41743;41421;99,2;29,6;171,5
2002;3510609;Carapicuíba;349418;170969;178449;104,4;27,9;10114,6
2002;3510708;Cardoso;11708;5793;5915;102,1;33,7;18,3
2002;3510807;Casa Branca;27073;14285;12788;89,5;32,8;31,3
2002;3510906;Cássia dos Coqueiros;2865;1482;1383;93,3;31,9;14,9
2002;3511003;Castilho;15548;7769;7779;100,1;31,6;14,6
2002;3511102;Catanduva;107234;52451;54783;104,4;33,4;369
2002;3511201;Catiguá;6676;3419;3257;95,3;31,9;45
2002;3511300;Cedral;6942;3494;3448;98,7;34,8;35,1
2002;3511409;Cerqueira César;15657;7813;7844;100,4;31,5;30,6
2002;3511508;Cerquilho;31503;15724;15779;100,3;31,1;246,5
2002;3511607;Cesário Lange;13395;7003;6392;91,3;30,9;70,4
2002;3511706;Charqueada;13451;6788;6663;98,2;30,3;76,5
2002;3511904;Clementina;5718;2956;2762;93,4;30,8;33,9
2002;3512001;Colina;16811;8414;8397;99,8;31,5;39,8
2002;3512100;Colômbia;5948;3079;2869;93,2;29,2;8,2
2002;3512209;Conchal;23235;11715;11520;98,3;28,9;127,1
2002;3512308;Conchas;15115;7697;7418;96,4;32,6;32,4
2002;3512407;Cordeirópolis;18274;9147;9127;99,8;30,7;132,8
2002;3512506;Coroados;4583;2301;2282;99,2;31,5;18,6
2002;3512605;Coronel Macedo;5496;2826;2670;94,5;30,1;18,1
2002;3512704;Corumbataí;3822;1989;1833;92,2;31,1;13,7
2002;3512803;Cosmópolis;47164;23616;23548;99,7;29,9;304,9
2002;3512902;Cosmorama;7355;3719;3636;97,8;35,4;16,7
2002;3513009;Cotia;159287;78631;80656;102,6;28,3;491,6
2002;3513108;Cravinhos;29062;14752;14310;97;30,4;93,3
2002;3513207;Cristais Paulista;6785;3501;3284;93,8;30;17,6
2002;3513306;Cruzália;2558;1274;1284;100,8;32,5;17,1
2002;3513405;Cruzeiro;74308;36375;37933;104,3;31,1;243,1
2002;3513504;Cubatão;110638;55611;55027;98,9;28,4;774,3
2002;3513603;Cunha;22981;11882;11099;93,4;30,3;16,3
2002;3513702;Descalvado;29372;14621;14751;100,9;32,1;39
2002;3513801;Diadema;363782;178016;185766;104,4;28,1;11837,2
2002;3513850;Dirce Reis;1645;847;798;94,2;34,5;18,7
2002;3513900;Divinolândia;11905;6052;5853;96,7;32,7;53,2
2002;3514007;Dobrada;7190;3777;3413;90,4;28,7;48
2002;3514106;Dois Córregos;22906;11494;11412;99,3;32,2;36,2
2002;3514205;Dolcinópolis;2136;1117;1019;91,2;34,4;27,4
2002;3514304;Dourado;8607;4404;4203;95,4;33,4;41,8
2002;3514403;Dracena;41119;20082;21037;104,8;34,5;84,3
2002;3514502;Duartina;12474;6116;6358;104;33,7;47,2
2002;3514601;Dumont;6691;3408;3283;96,3;30,4;60,1
2002;3514700;Echaporã;6766;3375;3391;100,5;31,2;13,1
2002;3514809;Eldorado;14325;7415;6910;93,2;28;8,7
2002;3514908;Elias Fausto;14266;7352;6914;94;29;70,5
2002;3514924;Elisiário;2687;1410;1277;90,6;33,4;28,6
2002;3514957;Embaúba;2464;1283;1181;92;32,9;29,6
2002;3515004;Embu das Artes;213885;105051;108834;103,6;26,8;3038,2
2002;3515103;Embu-Guaçu;58072;29087;28985;99,6;28,5;373,1
2002;3515129;Emilianópolis;2926;1484;1442;97,2;33,5;13
2002;3515152;Engenheiro Coelho;11097;5766;5331;92,5;27,8;100,9
2002;3515186;Espírito Santo do Pinhal;40950;20235;20715;102,4;32,7;105,2
2002;3515194;Espírito Santo do Turvo;3789;1953;1836;94;28,5;19,6
2002;3515202;Estrela d'Oeste;8264;4194;4070;97;33,3;27,9
2002;3515301;Estrela do Norte;2641;1366;1275;93,3;30,6;10
2002;3515350;Euclides da Cunha Paulista;10110;5115;4995;97,7;28,5;17,6
2002;3515400;Fartura;15086;7498;7588;101,2;31,9;35,2
2002;3515509;Fernandópolis;62377;30642;31735;103,6;33,5;113,5
2002;3515608;Fernando Prestes;5447;2696;2751;102;35,1;32
2002;3515657;Fernão;1452;748;704;94,1;32,4;14,4
2002;3515707;Ferraz de Vasconcelos;147609;72663;74946;103,1;27;4995,7
2002;3515806;Flora Rica;2100;1056;1044;98,9;34;9,3
2002;3515905;Floreal;3197;1590;1607;101,1;36,6;15,7
2002;3516002;Flórida Paulista;11471;5838;5633;96,5;33;21,9
2002;3516101;Florínea;3079;1497;1582;105,7;31,9;13,6
2002;3516200;Franca;294336;145067;149269;102,9;30,4;486
2002;3516309;Francisco Morato;137564;68565;68999;100,6;25,9;2807,4
2002;3516408;Franco da Rocha;112807;58306;54501;93,5;28,1;849,6
2002;3516507;Gabriel Monteiro;2724;1401;1323;94,4;34,5;19,6
2002;3516606;Gália;7724;3914;3810;97,3;32,5;21,7
2002;3516705;Garça;43335;21270;22065;103,7;32,5;78
2002;3516804;Gastão Vidigal;3695;1876;1819;97;32,5;20,5
2002;3516853;Gavião Peixoto;4181;2223;1958;88,1;29,3;17,2
2002;3516903;General Salgado;10804;5483;5321;97;33,1;21,9
2002;3517000;Getulina;10459;5636;4823;85,6;32,3;15,5
2002;3517109;Glicério;4451;2249;2202;97,9;32;16,3
2002;3517208;Guaiçara;9507;4746;4761;100,3;30,2;34,3
2002;3517307;Guaimbê;5281;2638;2643;100,2;31;24,2
2002;3517406;Guaíra;35146;17625;17521;99,4;31,2;27,9
2002;3517505;Guapiaçu;14789;7508;7281;97;32;45,5
2002;3517604;Guapiara;19512;10021;9491;94,7;28,4;47,8
2002;3517703;Guará;19096;9556;9540;99,8;29,7;52,7
2002;3517802;Guaraçaí;8844;4454;4390;98,6;33,6;15,5
2002;3517901;Guaraci;9047;4604;4443;96,5;31,3;14,1
2002;3518008;Guarani d'Oeste;2001;1024;977;95,4;34;23,3
2002;3518107;Guarantã;6355;3229;3126;96,8;29,7;13,8
2002;3518206;Guararapes;29276;14511;14765;101,8;32,7;30,6
2002;3518305;Guararema;22722;11513;11209;97,4;30,1;83,9
2002;3518404;Guaratinguetá;106115;51683;54432;105,3;31,6;141
2002;3518503;Guareí;11075;5979;5096;85,2;30,5;19,5
2002;3518602;Guariba;31959;16160;15799;97,8;28,8;118,2
2002;3518701;Guarujá;270289;133253;137036;102,8;28,6;1866,7
2002;3518800;Guarulhos;1102463;541306;561157;103,7;28,3;3459,5
2002;3518859;Guatapará;6499;3355;3144;93,7;30;15,7
2002;3518909;Guzolândia;4394;2281;2113;92,6;31,4;17,4
2002;3519006;Herculândia;8144;4117;4027;97,8;31,2;22,4
2002;3519055;Holambra;8007;4094;3913;95,6;29,5;122,1
2002;3519071;Hortolândia;160221;80351;79870;99,4;27,8;2567
2002;3519105;Iacanga;8616;4373;4243;97;32,8;15,7
2002;3519204;Iacri;6721;3386;3335;98,5;32,4;20,9
2002;3519253;Iaras;3705;2101;1604;76,3;28,5;9,2
2002;3519303;Ibaté;27264;13887;13377;96,3;28,6;93,7
2002;3519402;Ibirá;9711;4783;4928;103;34,1;35,7
2002;3519501;Ibirarema;5883;2982;2901;97,3;32,1;25,8
2002;3519600;Ibitinga;47872;23664;24208;102,3;32,1;69,4
2002;3519709;Ibiúna;65923;33864;32059;94,7;28,9;62,3
2002;3519808;Icém;6905;3496;3409;97,5;31,2;19,1
2002;3519907;Iepê;7344;3652;3692;101,1;32,9;12,3
2002;3520004;Igaraçu do Tietê;22786;11443;11343;99,1;29,6;233,1
2002;3520103;Igarapava;26277;12946;13331;103;32,1;56,1
2002;3520202;Igaratá;8436;4370;4066;93;30;28,8
2002;3520301;Iguape;27871;14168;13703;96,7;30,9;14,1
2002;3520400;Ilhabela;22236;11534;10702;92,8;28,3;64,2
2002;3520426;Ilha Comprida;7118;3593;3525;98,1;31,8;36,2
2002;3520442;Ilha Solteira;24265;11952;12313;103;31,9;37,2
2002;3520509;Indaiatuba;157439;78560;78879;100,4;30,4;505,3
2002;3520608;Indiana;4920;2489;2431;97,7;32,4;38
2002;3520707;Indiaporã;4056;2019;2037;100,9;34,8;14,5
2002;3520806;Inúbia Paulista;3376;1724;1652;95,8;32,8;38,8
2002;3520905;Ipaussu;12812;6418;6394;99,6;31,3;61,1
2002;3521002;Iperó;20250;10851;9399;86,6;28,8;118,9
2002;3521101;Ipeúna;4660;2417;2243;92,8;30,1;24,5
2002;3521150;Ipiguá;3666;1879;1787;95,1;32,3;27
2002;3521200;Iporanga;4519;2333;2186;93,7;27,9;3,9
2002;3521309;Ipuã;12300;6274;6026;96;29,9;26,4
2002;3521408;Iracemápolis;16339;8235;8104;98,4;30,9;141,9
2002;3521507;Irapuã;6782;3503;3279;93,6;32,4;26,3
2002;3521606;Irapuru;7541;3902;3639;93,3;35;35,2
2002;3521705;Itaberá;18785;9533;9252;97,1;29,7;17,1
2002;3521804;Itaí;21598;11155;10443;93,6;29,6;19,8
2002;3521903;Itajobi;14289;7216;7073;98;34,4;28,5
2002;3522000;Itaju;2754;1438;1316;91,5;33,5;12
2002;3522109;Itanhaém;74913;37081;37832;102;30,6;124,5
2002;3522158;Itaoca;3256;1676;1580;94,3;30,5;17,8
2002;3522208;Itapecerica da Serra;135072;66943;68129;101,8;27;896
2002;3522307;Itapetininga;129592;64889;64703;99,7;30,2;72,4
2002;3522406;Itapeva;84365;41723;42642;102,2;28,7;46,2
2002;3522505;Itapevi;169666;83912;85754;102,2;26,2;2052,6
2002;3522604;Itapira;64477;32235;32242;100;33;124,4
2002;3522653;Itapirapuã Paulista;3664;1919;1745;90,9;28;9
2002;3522703;Itápolis;38257;19065;19192;100,7;33;38,4
2002;3522802;Itaporanga;14428;7264;7164;98,6;30,9;28,4
2002;3522901;Itapuí;10705;5478;5227;95,4;31,7;76,5
2002;3523008;Itapura;3926;2048;1878;91,7;31;13
2002;3523107;Itaquaquecetuba;282680;140768;141912;100,8;26;3421,4
2002;3523206;Itararé;47050;23265;23785;102,2;29,6;46,9
2002;3523305;Itariri;13961;7126;6835;95,9;28,2;51
2002;3523404;Itatiba;85216;42389;42827;101;31,1;264,4
2002;3523503;Itatinga;15946;8163;7783;95,3;28,4;16,3
2002;3523602;Itirapina;13404;7556;5848;77,4;30,6;23,7
2002;3523701;Itirapuã;5533;2872;2661;92,7;30,3;34,3
2002;3523800;Itobi;7517;3908;3609;92,3;31,1;54,1
2002;3523909;Itu;139174;69286;69888;100,9;30,1;217,2
2002;3524006;Itupeva;29599;15145;14454;95,4;28,7;147,3
2002;3524105;Ituverava;36827;18167;18660;102,7;32,2;52,3
2002;3524204;Jaborandi;6442;3304;3138;95;31,6;23,6
2002;3524303;Jaboticabal;68385;33478;34907;104,3;32,2;96,8
2002;3524402;Jacareí;195541;96509;99032;102,6;30,3;421,2
2002;3524501;Jaci;4416;2287;2129;93,1;31,1;30,4
2002;3524600;Jacupiranga;17096;8742;8354;95,6;29;24,3
2002;3524709;Jaguariúna;32408;16305;16103;98,8;30,5;229,2
2002;3524808;Jales;46428;22936;23492;102,4;33,2;126
2002;3524907;Jambeiro;4276;2229;2047;91,8;30,9;23,2
2002;3525003;Jandira;95252;47157;48095;102;26,8;5458,8
2002;3525102;Jardinópolis;32049;16151;15898;98,4;30,5;63,9
2002;3525201;Jarinu;18330;9439;8891;94,2;29,4;88,3
2002;3525300;Jaú;115850;57171;58679;102,6;32,5;168,6
2002;3525409;Jeriquara;3271;1725;1546;89,6;29,1;23
2002;3525508;Joanópolis;10676;5433;5243;96,5;32,4;28,5
2002;3525607;João Ramalho;3887;1964;1923;97,9;29,5;9,4
2002;3525706;José Bonifácio;29571;14800;14771;99,8;31,7;34,4
2002;3525805;Júlio Mesquita;4254;2097;2157;102,9;31;33,2
2002;3525854;Jumirim;2308;1212;1096;90,4;31,5;40,7
2002;3525904;Jundiaí;332800;162976;169824;104,2;32,6;771,8
2002;3526001;Junqueirópolis;17377;9119;8258;90,6;34,5;29,8
2002;3526100;Juquiá;20400;10432;9968;95,6;29,1;25,1
2002;3526209;Juquitiba;27079;13645;13434;98,5;27,8;51,9
2002;3526308;Lagoinha;4941;2567;2374;92,5;32,8;19,3
2002;3526407;Laranjal Paulista;22727;11324;11403;100,7;32,5;59,1
2002;3526506;Lavínia;5871;3132;2739;87,5;33;10,9
2002;3526605;Lavrinhas;6113;3118;2995;96,1;28,2;36,6
2002;3526704;Leme;82964;41887;41077;98,1;29,9;205,9
2002;3526803;Lençóis Paulista;56429;28219;28210;100;30,1;69,7
2002;3526902;Limeira;254489;126106;128383;101,8;31;438,2
2002;3527009;Lindóia;5583;2808;2775;98,8;32,6;114,5
2002;3527108;Lins;67194;32602;34592;106,1;33,1;117,9
2002;3527207;Lorena;78946;38398;40548;105,6;30,9;190,6
2002;3527256;Lourdes;2026;1053;973;92,4;33,2;17,8
2002;3527306;Louveira;26277;13319;12958;97,3;29,1;471,4
2002;3527405;Lucélia;18687;9717;8970;92,3;33;59,4
2002;3527504;Lucianópolis;2183;1123;1060;94,4;31,8;11,5
2002;3527603;Luís Antônio;7951;4075;3876;95,1;27,7;13,3
2002;3527702;Luiziânia;4413;2229;2184;98;32,5;26,5
2002;3527801;Lupércio;4264;2133;2131;99,9;30,3;27,5
2002;3527900;Lutécia;2852;1450;1402;96,7;32,3;6
2002;3528007;Macatuba;15898;7991;7907;98,9;29,7;70,8
2002;3528106;Macaubal;7424;3777;3647;96,6;34,9;29,9
2002;3528205;Macedônia;3752;1900;1852;97,5;33,8;11,5
2002;3528304;Magda;3384;1749;1635;93,5;34,2;10,8
2002;3528403;Mairinque;40624;20318;20306;99,9;28,9;193,3
2002;3528502;Mairiporã;64183;32307;31876;98,7;29,5;200,1
2002;3528601;Manduri;8402;4282;4120;96,2;32;36,7
2002;3528700;Marabá Paulista;3939;2115;1824;86,2;31;4,3
2002;3528809;Maracaí;13072;6639;6433;96,9;31,1;24,5
2002;3528858;Marapoama;2314;1177;1137;96,6;33,1;20,8
2002;3528908;Mariápolis;3872;1989;1883;94,7;33,7;20,8
2002;3529005;Marília;201401;98288;103113;104,9;32;172,1
2002;3529104;Marinópolis;2192;1126;1066;94,7;31,8;28,2
2002;3529203;Martinópolis;22749;11691;11058;94,6;32,2;18,1
2002;3529302;Matão;72897;36394;36503;100,3;30,8;138,9
2002;3529401;Mauá;374922;184381;190541;103,3;28,3;6053,3
2002;3529500;Mendonça;3939;2019;1920;95,1;35;20,2
2002;3529609;Meridiano;4012;2032;1980;97,4;33,4;17,6
2002;3529658;Mesópolis;1940;993;947;95,4;33,1;13,1
2002;3529708;Miguelópolis;19331;9704;9627;99,2;30,2;23,6
2002;3529807;Mineiros do Tietê;11552;5801;5751;99,1;30,9;54,2
2002;3529906;Miracatu;22132;11386;10746;94,4;28;22,1
2002;3530003;Mira Estrela;2655;1374;1281;93,2;33,6;12,2
2002;3530102;Mirandópolis;26243;14051;12192;86,8;33,6;28,6
2002;3530201;Mirante do Paranapanema;16404;8364;8040;96,1;32,2;13,2
2002;3530300;Mirassol;49380;24350;25030;102,8;32,7;203
2002;3530409;Mirassolândia;3835;1969;1866;94,8;32,5;23,1
2002;3530508;Mococa;65953;33197;32756;98,7;31,9;77,1
2002;3530607;Mogi das Cruzes;341888;168045;173843;103,5;29,5;479,8
2002;3530706;Mogi Guaçu;126996;63665;63331;99,5;30,8;156,3
2002;3530805;Mogi Mirim;82385;41062;41323;100,6;32;165,5
2002;3530904;Mombuca;3143;1607;1536;95,6;29,3;23,5
2002;3531001;Monções;2080;1060;1020;96,2;35,1;19,9
2002;3531100;Mongaguá;37298;19034;18264;96;30,8;261,3
2002;3531209;Monte Alegre do Sul;6466;3281;3185;97,1;33,8;58,6
2002;3531308;Monte Alto;44315;22128;22187;100,3;33;127,7
2002;3531407;Monte Aprazível;19083;9468;9615;101,6;34,8;38,5
2002;3531506;Monte Azul Paulista;19543;9856;9687;98,3;31,5;74,2
2002;3531605;Monte Castelo;4085;2059;2026;98,4;34,5;17,5
2002;3531704;Monteiro Lobato;3726;1924;1802;93,7;31,2;11,2
2002;3531803;Monte Mor;39647;19916;19731;99,1;28,5;164,8
2002;3531902;Morro Agudo;26117;13340;12777;95,8;28,8;18,8
2002;3532009;Morungaba;10300;5201;5099;98;30,2;70,2
2002;3532058;Motuca;3948;2029;1919;94,6;29,8;17,3
2002;3532108;Murutinga do Sul;4024;2038;1986;97,4;35,8;16
2002;3532157;Nantes;2369;1206;1163;96,4;29,1;8,3
2002;3532207;Narandiba;3866;1954;1912;97,9;30,1;10,8
2002;3532306;Natividade da Serra;6937;3661;3276;89,5;32,6;8,3
2002;3532405;Nazaré Paulista;14869;7668;7201;93,9;31;45,6
2002;3532504;Neves Paulista;8899;4474;4425;98,9;35,3;40,6
2002;3532603;Nhandeara;10331;5085;5246;103,2;35,8;23,7
2002;3532702;Nipoã;3449;1777;1672;94,1;32,4;25,1
2002;3532801;Nova Aliança;4988;2482;2506;101;34,6;22,9
2002;3532827;Nova Campina;7556;3927;3629;92,4;25,9;19,6
2002;3532843;Nova Canaã Paulista;2431;1261;1170;92,8;36,3;19,5
2002;3532868;Nova Castilho;1014;525;489;93,1;32,7;5,5
2002;3532900;Nova Europa;7632;3861;3771;97,7;30,3;47,6
2002;3533007;Nova Granada;17464;8773;8691;99,1;32,2;32,8
2002;3533106;Nova Guataporanga;2120;1085;1035;95,4;35;62,1
2002;3533205;Nova Independência;2261;1147;1114;97,1;32,5;8,5
2002;3533254;Novais;3461;1815;1646;90,7;30,6;29,4
2002;3533304;Nova Luzitânia;2884;1513;1371;90,6;31,7;39,1
2002;3533403;Nova Odessa;43985;21810;22175;101,7;30,8;596,1
2002;3533502;Novo Horizonte;33290;16551;16739;101,1;33,1;35,7
2002;3533601;Nuporanga;6418;3245;3173;97,8;32,2;18,4
2002;3533700;Ocauçu;4206;2186;2020;92,4;31,8;14
2002;3533809;Óleo;2933;1497;1436;95,9;33,2;14,7
2002;3533908;Olímpia;46834;23181;23653;102;32,8;58,4
2002;3534005;Onda Verde;3520;1793;1727;96,3;30,7;14,5
2002;3534104;Oriente;5956;2948;3008;102;33,3;27,2
2002;3534203;Orindiúva;4432;2281;2151;94,3;29;17,9
2002;3534302;Orlândia;36804;18217;18587;102;31,1;126,1
2002;3534401;Osasco;656671;318896;337775;105,9;29,5;10109,8
2002;3534500;Oscar Bressane;2541;1241;1300;104,8;34,7;11,4
2002;3534609;Osvaldo Cruz;30019;14855;15164;102,1;34,4;121
2002;3534708;Ourinhos;95737;46903;48834;104,1;31,5;323,6
2002;3534757;Ouroeste;6704;3363;3341;99,3;32,4;23,2
2002;3534807;Ouro Verde;7282;3646;3636;99,7;31,4;27,3
2002;3534906;Pacaembu;12691;6871;5820;84,7;34,3;37,4
2002;3535002;Palestina;9452;4714;4738;100,5;35,1;13,5
2002;3535101;Palmares Paulista;8919;4586;4333;94,5;28,3;108,6
2002;3535200;Palmeira d'Oeste;10209;5177;5032;97,2;34,6;32
2002;3535309;Palmital;20815;10281;10534;102,5;33,7;38
2002;3535408;Panorama;13866;7047;6819;96,8;29,8;38,9
2002;3535507;Paraguaçu Paulista;40274;20017;20257;101,2;31;40,2
2002;3535606;Paraibuna;17147;8764;8383;95,7;30,3;21,2
2002;3535705;Paraíso;5522;2866;2656;92,7;32,2;35,6
2002;3535804;Paranapanema;15993;8282;7711;93,1;29;15,7
2002;3535903;Paranapuã;3684;1876;1808;96,4;33,3;26,2
2002;3536000;Parapuã;11092;5643;5449;96,6;33,8;30,3
2002;3536109;Pardinho;4908;2541;2367;93,2;29,6;23,4
2002;3536208;Pariquera-Açu;17784;8932;8852;99,1;29,4;49,5
2002;3536257;Parisi;1958;1024;934;91,2;34;23,1
2002;3536307;Patrocínio Paulista;11700;5982;5718;95,6;30,5;19,4
2002;3536406;Paulicéia;5526;2873;2653;92,3;29,6;14,8
2002;3536505;Paulínia;57129;28542;28587;100,2;29,6;411,7
2002;3536570;Paulistânia;1783;942;841;89,3;31,1;7
2002;3536604;Paulo de Faria;8524;4256;4268;100,3;31,7;11,6
2002;3536703;Pederneiras;37579;18957;18622;98,2;30,5;51,7
2002;3536802;Pedra Bela;5655;2982;2673;89,6;32,3;35,7
2002;3536901;Pedranópolis;2715;1393;1322;94,9;35,1;10,4
2002;3537008;Pedregulho;15187;7754;7433;95,9;30,1;21,3
2002;3537107;Pedreira;36489;18095;18394;101,7;31,5;335,3
2002;3537156;Pedrinhas Paulista;2897;1461;1436;98,3;31,6;19
2002;3537206;Pedro de Toledo;9397;4788;4609;96,3;29,6;14
2002;3537305;Penápolis;55481;27108;28373;104,7;32,9;78
2002;3537404;Pereira Barreto;25103;12391;12712;102,6;32,1;25,8
2002;3537503;Pereiras;6443;3298;3145;95,4;32,7;28,9
2002;3537602;Peruíbe;53181;26393;26788;101,5;30,7;163
2002;3537701;Piacatu;4761;2399;2362;98,5;32,8;20,5
2002;3537800;Piedade;50783;26500;24283;91,6;30,3;68
2002;3537909;Pilar do Sul;24508;12597;11911;94,6;29,2;36
2002;3538006;Pindamonhangaba;130476;64926;65550;101;29,5;178,4
2002;3538105;Pindorama;13474;6845;6629;96,8;34,1;72,9
2002;3538204;Pinhalzinho;11396;5871;5525;94,1;32,8;73,7
2002;3538303;Piquerobi;3482;1758;1724;98,1;33;7,2
2002;3538501;Piquete;14990;7312;7678;105;32,3;85,2
2002;3538600;Piracaia;23733;12007;11726;97,7;31,1;61,6
2002;3538709;Piracicaba;336473;165781;170692;103;31,6;244,2
2002;3538808;Piraju;28161;13776;14385;104,4;32,5;55,8
2002;3538907;Pirajuí;20649;11096;9553;86,1;32,8;25,1
2002;3539004;Pirangi;10165;5200;4965;95,5;34;47,1
2002;3539103;Pirapora do Bom Jesus;13038;6524;6514;99,8;26,7;120,2
2002;3539202;Pirapozinho;22732;11125;11607;104,3;31,3;47,6
2002;3539301;Pirassununga;65947;32473;33474;103,1;32,5;90,7
2002;3539400;Piratininga;10895;5491;5404;98,4;32,6;27,1
2002;3539509;Pitangueiras;32056;16410;15646;95,3;28,8;74,4
2002;3539608;Planalto;3829;1958;1871;95,6;31,3;13,2
2002;3539707;Platina;2933;1534;1399;91,2;30,9;9
2002;3539806;Poá;97742;47804;49938;104,5;28,6;5661,7
2002;3539905;Poloni;4884;2396;2488;103,8;36,1;36,1
2002;3540002;Pompéia;18593;9198;9395;102,1;32,1;23,7
2002;3540101;Pongaí;3648;1891;1757;92,9;34,6;19,9
2002;3540200;Pontal;31652;16162;15490;95,8;27,9;88,8
2002;3540259;Pontalinda;3650;1913;1737;90,8;30,7;17,4
2002;3540309;Pontes Gestal;2543;1261;1282;101,7;33,7;11,7
2002;3540408;Populina;4421;2277;2144;94,2;33,9;14
2002;3540507;Porangaba;6986;3681;3305;89,8;32,7;26,3
2002;3540606;Porto Feliz;46282;23224;23058;99,3;30,6;83,1
2002;3540705;Porto Ferreira;48182;23999;24183;100,8;31,4;196,7
2002;3540754;Potim;14754;7641;7113;93,1;27,6;330,5
2002;3540804;Potirendaba;13985;7167;6818;95,1;34,6;40,8
2002;3540853;Pracinha;1719;939;780;83,1;32,8;27,3
2002;3540903;Pradópolis;13716;6973;6743;96,7;29,8;81,9
2002;3541000;Praia Grande;206550;100583;105967;105,4;30,5;1380,2
2002;3541059;Pratânia;4099;2136;1963;91,9;29,1;23,4
2002;3541109;Presidente Alves;4280;2155;2125;98,6;32,1;14,9
2002;3541208;Presidente Bernardes;14504;7472;7032;94,1;33,8;19,4
2002;3541307;Presidente Epitácio;39762;19733;20029;101,5;30,6;31,6
2002;3541406;Presidente Prudente;193235;93646;99589;106,3;32,2;344,7
2002;3541505;Presidente Venceslau;37614;18828;18786;99,8;33;49,8
2002;3541604;Promissão;32048;16142;15906;98,5;31,6;41,1
2002;3541653;Quadra;2755;1451;1304;89,9;32,1;13,4
2002;3541703;Quatá;11859;5900;5959;101;30,9;18,2
2002;3541802;Queiroz;2313;1185;1128;95,2;30,2;9,8
2002;3541901;Queluz;9567;4769;4798;100,6;29,6;38,4
2002;3542008;Quintana;5546;2791;2755;98,7;32,1;17,4
2002;3542107;Rafard;8430;4210;4220;100,2;31,2;69,3
2002;3542206;Rancharia;28873;14297;14576;102;31,7;18,2
2002;3542305;Redenção da Serra;4011;2142;1869;87,3;32,2;13
2002;3542404;Regente Feijó;17306;8651;8655;100;32;65,7
2002;3542503;Reginópolis;5262;2773;2489;89,8;33,1;12,8
2002;3542602;Registro;54123;26941;27182;100,9;29,1;74,9
2002;3542701;Restinga;5769;2934;2835;96,6;28,2;23,5
2002;3542800;Ribeira;3486;1821;1665;91,4;31,3;10,4
2002;3542909;Ribeirão Bonito;11436;5788;5648;97,6;30,7;24,3
2002;3543006;Ribeirão Branco;20869;10876;9993;91,9;25,8;29,9
2002;3543105;Ribeirão Corrente;3958;2091;1867;89,3;29,4;26,7
2002;3543204;Ribeirão do Sul;4479;2275;2204;96,9;32,6;22
2002;3543238;Ribeirão dos Índios;2219;1133;1086;95,9;34,4;11,3
2002;3543253;Ribeirão Grande;7412;3819;3593;94,1;29;22,2
2002;3543303;Ribeirão Pires;106451;52508;53943;102,7;30,3;1075,6
2002;3543402;Ribeirão Preto;524714;252416;272298;107,9;32;806,1
2002;3543501;Riversul;7034;3572;3462;96,9;31,5;18,2
2002;3543600;Rifaina;3347;1708;1639;96;32,3;20,6
2002;3543709;Rincão;10375;5244;5131;97,8;30;32,8
2002;3543808;Rinópolis;10183;5220;4963;95,1;34,7;28,4
2002;3543907;Rio Claro;171697;83867;87830;104,7;32,5;344,5
2002;3544004;Rio das Pedras;24606;12514;12092;96,6;29,5;108,6
2002;3544103;Rio Grande da Serra;38469;19145;19324;100,9;27,4;1058,6
2002;3544202;Riolândia;8914;4994;3920;78,5;31,1;14,1
2002;3544251;Rosana;23472;11876;11596;97,6;27,8;31,5
2002;3544301;Roseira;8764;4459;4305;96,5;29,1;67,5
2002;3544400;Rubiácea;2398;1219;1179;96,7;31,3;10,1
2002;3544509;Rubinéia;2674;1321;1353;102,4;34,8;11
2002;3544608;Sabino;4973;2483;2490;100,3;33,5;16,3
2002;3544707;Sagres;2434;1233;1201;97,4;32,1;16,5
2002;3544806;Sales;4741;2417;2324;96,2;32,5;15,4
2002;3544905;Sales Oliveira;9538;4775;4763;99,7;31,8;31,2
2002;3545001;Salesópolis;14646;7412;7234;97,6;30,3;34,5
2002;3545100;Salmourão;4495;2293;2202;96;32,6;26
2002;3545159;Saltinho;6020;3029;2991;98,7;32,8;60,4
2002;3545209;Salto;95689;47763;47926;100,3;30;719,2
2002;3545308;Salto de Pirapora;36153;18105;18048;99,7;29,7;128,9
2002;3545407;Salto Grande;8531;4278;4253;99,4;32,2;45,3
2002;3545506;Sandovalina;3214;1603;1611;100,5;28,8;7,1
2002;3545605;Santa Adélia;13660;6887;6773;98,3;32,5;41,4
2002;3545704;Santa Albertina;5643;2839;2804;98,8;35,8;20,7
2002;3545803;Santa Bárbara d'Oeste;172088;85881;86207;100,4;30,6;634,9
2002;3546009;Santa Branca;13176;6650;6526;98,1;31;48,4
2002;3546108;Santa Clara d'Oeste;2130;1074;1056;98,3;34,2;11,6
2002;3546207;Santa Cruz da Conceição;3626;1845;1781;96,5;32,8;24,2
2002;3546256;Santa Cruz da Esperança;1838;935;903;96,6;30,8;12,4
2002;3546306;Santa Cruz das Palmeiras;26368;13340;13028;97,7;30,4;89,3
2002;3546405;Santa Cruz do Rio Pardo;41606;20569;21037;102,3;32,2;37,3
2002;3546504;Santa Ernestina;5726;3078;2648;86;28,9;42,6
2002;3546603;Santa Fé do Sul;27109;13169;13940;105,9;33,8;131,3
2002;3546702;Santa Gertrudes;16964;8636;8328;96,4;29,3;172,6
2002;3546801;Santa Isabel;45246;22817;22429;98,3;29,4;124,5
2002;3546900;Santa Lúcia;7925;4069;3856;94,8;28,8;51,5
2002;3547007;Santa Maria da Serra;4809;2498;2311;92,5;29,7;19
2002;3547106;Santa Mercedes;2815;1424;1391;97,7;32,6;16,9
2002;3547205;Santana da Ponte Pensa;1852;951;901;94,7;36,6;14,3
2002;3547304;Santana de Parnaíba;81021;40318;40703;101;27,6;450,2
2002;3547403;Santa Rita d'Oeste;2690;1353;1337;98,8;36,7;12,8
2002;3547502;Santa Rita do Passa Quatro;26264;12788;13476;105,4;35,1;34,8
2002;3547601;Santa Rosa de Viterbo;21914;10906;11008;100,9;31,8;75,9
2002;3547650;Santa Salete;1400;735;665;90,5;36,4;17,7
2002;3547700;Santo Anastácio;20753;10146;10607;104,5;33;37,5
2002;3547809;Santo André;656052;316691;339361;107,2;32,6;3732,2
2002;3547908;Santo Antônio da Alegria;5905;3072;2833;92,2;32,3;19
2002;3548005;Santo Antônio de Posse;18635;9391;9244;98,4;30,4;120,9
2002;3548054;Santo Antônio do Aracanguá;7082;3669;3413;93;30,7;5,4
2002;3548104;Santo Antônio do Jardim;6122;3187;2935;92,1;32,5;55,7
2002;3548203;Santo Antônio do Pinhal;6370;3261;3109;95,3;29,8;47,9
2002;3548302;Santo Expedito;2579;1324;1255;94,8;33,5;27,3
2002;3548401;Santópolis do Aguapeí;3908;1987;1921;96,7;30,6;30,5
2002;3548500;Santos;418822;193291;225531;116,7;36,1;1490,3
2002;3548609;São Bento do Sapucaí;10398;5260;5138;97,7;32,4;41,2
2002;3548708;São Bernardo do Campo;715764;347867;367897;105,8;30,2;1747,8
2002;3548807;São Caetano do Sul;142006;66238;75768;114,4;36,9;9262,8
2002;3548906;São Carlos;198597;98205;100392;102,2;32,2;174,7
2002;3549003;São Francisco;2865;1446;1419;98,1;34,2;37,9
2002;3549102;São João da Boa Vista;78735;38618;40117;103,9;33,2;152,5
2002;3549201;São João das Duas Pontes;2664;1357;1307;96,3;32,5;20,6
2002;3549250;São João de Iracema;1699;865;834;96,4;32,7;9,5
2002;3549300;São João do Pau d'Alho;2175;1098;1077;98,1;35,9;18,5
2002;3549409;São Joaquim da Barra;42546;20966;21580;102,9;31,5;103,6
2002;3549508;São José da Bela Vista;8162;4173;3989;95,6;29,1;29,5
2002;3549607;São José do Barreiro;4126;2135;1991;93,3;31;7,2
2002;3549706;São José do Rio Pardo;50614;25057;25557;102;32,2;120,6
2002;3549805;São José do Rio Preto;368240;177936;190304;107;32,9;852,5
2002;3549904;São José dos Campos;557332;275014;282318;102,7;29,6;506,9
2002;3549953;São Lourenço da Serra;12573;6379;6194;97,1;28,5;67,4
2002;3550001;São Luiz do Paraitinga;10464;5414;5050;93,3;32,3;17
2002;3550100;São Manuel;37065;18342;18723;102,1;31,2;57
2002;3550209;São Miguel Arcanjo;31012;15853;15159;95,6;28,7;33,3
2002;3550308;São Paulo;10613691;5053300;5560391;110;31,3;6977,2
2002;3550407;São Pedro;28700;14118;14582;103,3;32,4;47
2002;3550506;São Pedro do Turvo;6973;3535;3438;97,3;31,2;9,5
2002;3550605;São Roque;69295;34424;34871;101,3;31,2;225,8
2002;3550704;São Sebastião;61052;30850;30202;97,9;28,2;151,7
2002;3550803;São Sebastião da Grama;12437;6332;6105;96,4;31,5;49,3
2002;3550902;São Simão;13818;6873;6945;101;32;22,4
2002;3551009;São Vicente;309356;149803;159553;106,5;30,4;2088,1
2002;3551108;Sarapuí;8091;4198;3893;92,7;30,3;22,9
2002;3551207;Sarutaiá;3704;1867;1837;98,4;31,4;26,2
2002;3551306;Sebastianópolis do Sul;2635;1345;1290;95,9;34,7;15,7
2002;3551405;Serra Azul;8226;4327;3899;90,1;29,1;29,1
2002;3551504;Serrana;33788;17002;16786;98,7;28;268,1
2002;3551603;Serra Negra;24380;12005;12375;103,1;34;119,7
2002;3551702;Sertãozinho;97721;48971;48750;99,5;30,1;242,4
2002;3551801;Sete Barras;13623;7100;6523;91,9;28,8;12,8
2002;3551900;Severínia;13978;7265;6713;92,4;29,2;99,5
2002;3552007;Silveiras;5466;2802;2664;95,1;30,6;13,2
2002;3552106;Socorro;33590;16758;16832;100,4;34,1;74,8
2002;3552205;Sorocaba;512083;251702;260381;103,4;30,6;1138,3
2002;3552304;Sud Mennucci;7377;3753;3624;96,6;30,6;12,4
2002;3552403;Sumaré;204994;102701;102293;99,6;28,6;1335,8
2002;3552502;Suzano;235387;116381;119006;102,3;28,1;1141,3
2002;3552551;Suzanápolis;2908;1498;1410;94,1;32,5;8,8
2002;3552601;Tabapuã;10676;5397;5279;97,8;33,8;30,9
2002;3552700;Tabatinga;13371;6805;6566;96,5;31;36,3
2002;3552809;Taboão da Serra;207100;99798;107302;107,5;28,2;10158,1
2002;3552908;Taciba;5348;2710;2638;97,3;31;8,8
2002;3553005;Taguaí;8114;4090;4024;98,4;30,3;55,8
2002;3553104;Taiaçu;5676;2878;2798;97,2;31,6;53
2002;3553203;Taiúva;5532;2771;2761;99,6;33,7;41,8
2002;3553302;Tambaú;22374;11286;11088;98,2;31,5;39,8
2002;3553401;Tanabi;22931;11387;11544;101,4;34,1;30,7
2002;3553500;Tapiraí;8496;4360;4136;94,9;28,5;11,3
2002;3553609;Tapiratiba;12957;6442;6515;101,1;30,9;58,4
2002;3553658;Taquaral;2720;1397;1323;94,7;31,2;50,5
2002;3553708;Taquaritinga;52510;26452;26058;98,5;31,8;88,4
2002;3553807;Taquarituba;22082;11084;10998;99,2;30,4;49,2
2002;3553856;Taquarivaí;4623;2353;2270;96,5;26,3;19,9
2002;3553906;Tarabai;5954;3011;2943;97,7;30,1;29,6
2002;3553955;Tarumã;11161;5718;5443;95,2;29,1;36,8
2002;3554003;Tatuí;96244;47865;48379;101,1;30,5;183,8
2002;3554102;Taubaté;251168;123669;127499;103,1;30,8;401,9
2002;3554201;Tejupá;5266;2757;2509;91;28,6;17,8
2002;3554300;Teodoro Sampaio;20387;10216;10171;99,6;29;13,1
2002;3554409;Terra Roxa;7870;4015;3855;96;31,4;35,5
2002;3554508;Tietê;32736;16249;16487;101,5;32,1;81
2002;3554607;Timburi;2710;1399;1311;93,7;33,3;13,8
2002;3554656;Torre de Pedra;2162;1111;1051;94,6;33,7;30,3
2002;3554706;Torrinha;8937;4525;4412;97,5;33,5;28,3
2002;3554755;Trabiju;1419;731;688;94,1;30,4;22,4
2002;3554805;Tremembé;36089;18847;17242;91,5;29,9;188,9
2002;3554904;Três Fronteiras;5224;2626;2598;98,9;34,7;34,5
2002;3554953;Tuiuti;5146;2649;2497;94,3;33,7;40,6
2002;3555000;Tupã;63566;30934;32632;105,5;34,2;101,2
2002;3555109;Tupi Paulista;13543;6778;6765;99,8;36,1;55,3
2002;3555208;Turiúba;1901;980;921;94;35,9;12,4
2002;3555307;Turmalina;2304;1154;1150;99,7;35,8;15,6
2002;3555356;Ubarana;4452;2316;2136;92,2;29;21,2
2002;3555406;Ubatuba;69344;35020;34324;98;28,1;97,9
2002;3555505;Ubirajara;4205;2162;2043;94,5;31,6;14,9
2002;3555604;Uchoa;9125;4576;4549;99,4;34,3;36,1
2002;3555703;União Paulista;1407;736;671;91,2;33,4;17,8
2002;3555802;Urânia;8850;4422;4428;100,1;34,2;42,3
2002;3555901;Uru;1381;718;663;92,3;34,2;9,4
2002;3556008;Urupês;12039;6058;5981;98,7;34,7;37,2
2002;3556107;Valentim Gentil;9066;4605;4461;96,9;31,8;60,5
2002;3556206;Valinhos;87580;43577;44003;101;32,1;589,6
2002;3556305;Valparaíso;19356;10239;9117;89;30,9;22,6
2002;3556354;Vargem;7340;3774;3566;94,5;32,3;51,5
2002;3556404;Vargem Grande do Sul;36914;18394;18520;100,7;31,6;138,2
2002;3556453;Vargem Grande Paulista;34519;17264;17255;99,9;28;812,4
2002;3556503;Várzea Paulista;95541;47920;47621;99,4;28,1;2720,4
2002;3556602;Vera Cruz;11074;5502;5572;101,3;32,8;44,7
2002;3556701;Vinhedo;50376;25053;25323;101,1;31,6;622,3
2002;3556800;Viradouro;16214;8203;8011;97,7;30,8;74,5
2002;3556909;Vista Alegre do Alto;5147;2599;2548;98;31,9;53,9
2002;3556958;Vitória Brasil;1690;869;821;94,5;32,1;33,9
2002;3557006;Votorantim;98600;49171;49429;100,5;29,2;535,3
2002;3557105;Votuporanga;77575;38032;39543;104;33,4;184,4
2002;3557154;Zacarias;2027;1042;985;94,5;33,2;6,4
2002;3557204;Chavantes;12205;6090;6115;100,4;31;64,7
2002;3557303;Estiva Gerbi;9097;4675;4422;94,6;29,6;122,7
2003;3500105;Adamantina;33677;16400;17277;105,3;34,9;81,7
2003;3500204;Adolfo;3666;1858;1808;97,3;33,5;17,4
2003;3500303;Aguaí;29407;14769;14638;99,1;31,1;62
2003;3500402;Águas da Prata;7269;3641;3628;99,6;35,1;50,9
2003;3500501;Águas de Lindóia;16461;8132;8329;102,4;33;273,8
2003;3500550;Águas de Santa Bárbara;5360;2692;2668;99,1;32,2;13,3
2003;3500600;Águas de São Pedro;2129;985;1144;116,1;38,8;589,4
2003;3500709;Agudos;33218;16486;16732;101,5;30,2;34,4
2003;3500758;Alambari;4024;2059;1965;95,4;30,2;25,2
2003;3500808;Alfredo Marcondes;3774;1922;1852;96,4;35,4;31,7
2003;3500907;Altair;3609;1930;1679;87;29,9;11,5
2003;3501004;Altinópolis;15625;7875;7750;98,4;32,3;16,8
2003;3501103;Alto Alegre;4219;2188;2031;92,8;35,8;13,2
2003;3501152;Alumínio;15779;7966;7813;98,1;28,6;188,7
2003;3501202;Álvares Florence;4221;2190;2031;92,7;36,6;11,6
2003;3501301;Álvares Machado;22984;11509;11475;99,7;31,4;66,1
2003;3501400;Álvaro de Carvalho;4264;2594;1670;64,4;30,6;27,7
2003;3501509;Alvinlândia;2880;1449;1431;98,8;30,9;33,9
2003;3501608;Americana;191099;94264;96835;102,7;32,8;1427
2003;3501707;Américo Brasiliense;30009;15227;14782;97,1;28,4;244,1
2003;3501806;Américo de Campos;5651;2832;2819;99,5;34,8;22,3
2003;3501905;Amparo;62141;30892;31249;101,2;33,1;139,5
2003;3502002;Analândia;3780;1953;1827;93,5;31,8;11,6
2003;3502101;Andradina;55367;27279;28088;103;33,5;57,4
2003;3502200;Angatuba;20266;10386;9880;95,1;31,2;19,7
2003;3502309;Anhembi;4849;2501;2348;93,9;31;6,6
2003;3502408;Anhumas;3512;1784;1728;96,9;31,9;10,9
2003;3502507;Aparecida;34884;17044;17840;104,7;31,4;288,6
2003;3502606;Aparecida d'Oeste;4822;2384;2438;102,3;35,1;26,9
2003;3502705;Apiaí;26842;13505;13337;98,8;28,2;27,5
2003;3502754;Araçariguama;12831;6576;6255;95,1;27,8;88,4
2003;3502804;Araçatuba;173289;83758;89531;106,9;33,3;148,5
2003;3502903;Araçoiaba da Serra;22006;11058;10948;99;31,5;86,2
2003;3503000;Aramina;4875;2474;2401;97;32,8;24
2003;3503109;Arandu;6129;3111;3018;97;29,8;21,4
2003;3503158;Arapeí;2589;1295;1294;99,9;32,1;16,5
2003;3503208;Araraquara;190004;92210;97794;106,1;33,4;189,3
2003;3503307;Araras;108388;53996;54392;100,7;31,9;168,1
2003;3503356;Arco-Íris;2104;1097;1007;91,8;34;7,9
2003;3503406;Arealva;7437;3819;3618;94,7;34,9;14,7
2003;3503505;Areias;3641;1829;1812;99,1;30,1;11,9
2003;3503604;Areiópolis;10440;5375;5065;94,2;27,9;121,5
2003;3503703;Ariranha;7789;3978;3811;95,8;33;58,7
2003;3503802;Artur Nogueira;36401;18245;18156;99,5;29,6;204,5
2003;3503901;Arujá;63826;31749;32077;101;28,3;663,7
2003;3503950;Aspásia;1865;954;911;95,5;34,6;26,9
2003;3504008;Assis;89667;43634;46033;105,5;33,2;194,7
2003;3504107;Atibaia;116165;57592;58573;101,7;31,3;242,8
2003;3504206;Auriflama;13759;6924;6835;98,7;33,3;31,7
2003;3504305;Avaí;4706;2428;2278;93,8;31,3;8,7
2003;3504404;Avanhandava;9585;4919;4666;94,9;30,2;28,3
2003;3504503;Avaré;78375;39081;39294;100,5;31,6;64,6
2003;3504602;Bady Bassitt;12435;6244;6191;99,2;31,7;112,7
2003;3504701;Balbinos;2025;1193;832;69,7;33,4;22,1
2003;3504800;Bálsamo;7587;3765;3822;101,5;34,7;50,6
2003;3504909;Bananal;9912;4918;4994;101,5;32,1;16,1
2003;3505005;Barão de Antonina;2901;1485;1416;95,4;32,5;18,9
2003;3505104;Barbosa;6070;3058;3012;98,5;31;29,6
2003;3505203;Bariri;29321;14687;14634;99,6;33,8;66
2003;3505302;Barra Bonita;35486;17631;17855;101,3;32,8;236,4
2003;3505351;Barra do Chapéu;4978;2666;2312;86,7;28,8;12,3
2003;3505401;Barra do Turvo;8029;4216;3813;90,4;28,8;8
2003;3505500;Barretos;106371;51736;54635;105,6;32,8;67,9
2003;3505609;Barrinha;25420;12865;12555;97,6;27,6;174,1
2003;3505708;Barueri;217897;107204;110693;103,3;27,6;3316,5
2003;3505807;Bastos;20634;10229;10405;101,7;31,2;120,7
2003;3505906;Batatais;52726;26080;26646;102,2;32,7;62,1
2003;3506003;Bauru;324715;158330;166385;105,1;32,3;486,3
2003;3506102;Bebedouro;75154;36938;38216;103,5;32,2;110
2003;3506201;Bento de Abreu;2458;1256;1202;95,7;32;8,1
2003;3506300;Bernardino de Campos;10773;5313;5460;102,8;34;44,1
2003;3506359;Bertioga;34875;17851;17024;95,4;27,7;70,9
2003;3506409;Bilac;6391;3160;3231;102,2;34,8;40,4
2003;3506508;Birigui;98619;48464;50155;103,5;32,3;186,1
2003;3506607;Biritiba Mirim;25866;13098;12768;97,5;29,2;81,5
2003;3506706;Boa Esperança do Sul;12929;6557;6372;97,2;29,8;18,7
2003;3506805;Bocaina;9837;4904;4933;100,6;32,3;27
2003;3506904;Bofete;8040;4182;3858;92,3;31,2;12,3
2003;3507001;Boituva;38344;19383;18961;97,8;30,1;154
2003;3507100;Bom Jesus dos Perdões;15171;7631;7540;98,8;29,9;140
2003;3507159;Bom Sucesso de Itararé;3336;1716;1620;94,4;26,2;25
2003;3507209;Borá;800;410;390;95,1;31,7;6,7
2003;3507308;Boracéia;3889;1999;1890;94,5;31,5;31,8
2003;3507407;Borborema;13622;6904;6718;97,3;33,5;24,7
2003;3507456;Borebi;2035;1043;992;95,1;29,8;5,8
2003;3507506;Botucatu;114006;55556;58450;105,2;32,4;76,9
2003;3507605;Bragança Paulista;131747;65096;66651;102,4;31,8;257
2003;3507704;Braúna;4552;2321;2231;96,1;34,1;23,3
2003;3507753;Brejo Alegre;2394;1239;1155;93,2;31,5;22,7
2003;3507803;Brodowski;18376;9201;9175;99,7;31,7;66
2003;3507902;Brotas;19652;9866;9786;99,2;32;17,8
2003;3508009;Buri;17913;9342;8571;91,7;28,5;15
2003;3508108;Buritama;14347;7159;7188;100,4;33;43,9
2003;3508207;Buritizal;3780;1930;1850;95,9;33,2;14,2
2003;3508306;Cabrália Paulista;4600;2323;2277;98;30,1;19,2
2003;3508405;Cabreúva;35554;18166;17388;95,7;27,9;136,6
2003;3508504;Caçapava;78786;39109;39677;101,5;30,7;213,5
2003;3508603;Cachoeira Paulista;28146;13921;14225;102,2;31,6;97,7
2003;3508702;Caconde;18568;9385;9183;97,8;31,5;39,7
2003;3508801;Cafelândia;16046;7927;8119;102,4;33,1;17,4
2003;3508900;Caiabu;4089;2091;1998;95,6;32,8;16,1
2003;3509007;Caieiras;75598;37373;38225;102,3;28,7;774,2
2003;3509106;Caiuá;4455;2331;2124;91,1;31,9;8,1
2003;3509205;Cajamar;54618;27466;27152;98,9;27,7;415,7
2003;3509254;Cajati;29105;14944;14161;94,8;27,9;64
2003;3509304;Cajobi;9400;4848;4552;93,9;32,4;53,1
2003;3509403;Cajuru;21565;10895;10670;97,9;30,9;32,7
2003;3509452;Campina do Monte Alegre;5328;2740;2588;94,5;30,7;28,9
2003;3509502;Campinas;1002396;486998;515398;105,8;32,2;1261,6
2003;3509601;Campo Limpo Paulista;66768;33162;33606;101,3;29,4;840,9
2003;3509700;Campos do Jordão;45531;22530;23001;102,1;29;157
2003;3509809;Campos Novos Paulista;4274;2204;2070;93,9;32,1;8,8
2003;3509908;Cananéia;12306;6204;6102;98,4;29,6;9,9
2003;3509957;Canas;3832;1974;1858;94,1;29,3;71,9
2003;3510005;Cândido Mota;29522;14679;14843;101,1;32,3;49,5
2003;3510104;Cândido Rodrigues;2636;1300;1336;102,8;36,3;37,2
2003;3510153;Canitar;3780;1925;1855;96,4;28,4;65,8
2003;3510203;Capão Bonito;47022;23586;23436;99,4;29,3;28,7
2003;3510302;Capela do Alto;15257;7839;7418;94,6;29,2;89,8
2003;3510401;Capivari;43596;21733;21863;100,6;30,5;135
2003;3510500;Caraguatatuba;85394;42802;42592;99,5;29,9;176,1
2003;3510609;Carapicuíba;352001;172091;179910;104,5;28,3;10189,4
2003;3510708;Cardoso;11731;5803;5928;102,2;34;18,4
2003;3510807;Casa Branca;27245;14384;12861;89,4;33,1;31,5
2003;3510906;Cássia dos Coqueiros;2846;1471;1375;93,5;32,3;14,8
2003;3511003;Castilho;15842;7913;7929;100,2;31,9;14,9
2003;3511102;Catanduva;107920;52744;55176;104,6;33,8;371,4
2003;3511201;Catiguá;6728;3443;3285;95,4;32,2;45,3
2003;3511300;Cedral;7063;3552;3511;98,8;35,1;35,7
2003;3511409;Cerqueira César;15929;7941;7988;100,6;31,8;31,1
2003;3511508;Cerquilho;32490;16206;16284;100,5;31,4;254,2
2003;3511607;Cesário Lange;13640;7125;6515;91,4;31,2;71,6
2003;3511706;Charqueada;13648;6896;6752;97,9;30,6;77,6
2003;3511904;Clementina;5875;3041;2834;93,2;31;34,8
2003;3512001;Colina;16894;8446;8448;100;31,9;40
2003;3512100;Colômbia;5945;3073;2872;93,5;29,6;8,2
2003;3512209;Conchal;23515;11861;11654;98,3;29,2;128,6
2003;3512308;Conchas;15244;7749;7495;96,7;32,9;32,7
2003;3512407;Cordeirópolis;18618;9327;9291;99,6;31;135,3
2003;3512506;Coroados;4664;2339;2325;99,4;31,8;18,9
2003;3512605;Coronel Macedo;5433;2792;2641;94,6;30,6;17,9
2003;3512704;Corumbataí;3821;1982;1839;92,8;31,4;13,7
2003;3512803;Cosmópolis;48608;24340;24268;99,7;30,2;314,3
2003;3512902;Cosmorama;7352;3715;3637;97,9;35,8;16,6
2003;3513009;Cotia;164622;81199;83423;102,7;28,7;508,1
2003;3513108;Cravinhos;29412;14906;14506;97,3;30,7;94,4
2003;3513207;Cristais Paulista;6889;3550;3339;94,1;30,4;17,9
2003;3513306;Cruzália;2528;1256;1272;101,3;32,9;16,9
2003;3513405;Cruzeiro;74656;36520;38136;104,4;31,4;244,2
2003;3513504;Cubatão;111712;56107;55605;99,1;28,7;781,9
2003;3513603;Cunha;22905;11826;11079;93,7;30,8;16,3
2003;3513702;Descalvado;29596;14718;14878;101,1;32,5;39,3
2003;3513801;Diadema;366944;179353;187591;104,6;28,4;11940,1
2003;3513850;Dirce Reis;1646;847;799;94,3;34,9;18,7
2003;3513900;Divinolândia;11843;6010;5833;97,1;33,1;52,9
2003;3514007;Dobrada;7281;3822;3459;90,5;28,9;48,6
2003;3514106;Dois Córregos;23118;11600;11518;99,3;32,4;36,5
2003;3514205;Dolcinópolis;2129;1115;1014;90,9;34,7;27,3
2003;3514304;Dourado;8606;4399;4207;95,6;33,8;41,8
2003;3514403;Dracena;41410;20257;21153;104,4;34,8;84,9
2003;3514502;Duartina;12465;6109;6356;104;34,1;47,1
2003;3514601;Dumont;6882;3502;3380;96,5;30,7;61,8
2003;3514700;Echaporã;6711;3340;3371;100,9;31,6;13
2003;3514809;Eldorado;14383;7435;6948;93,4;28,3;8,7
2003;3514908;Elias Fausto;14468;7461;7007;93,9;29,4;71,5
2003;3514924;Elisiário;2736;1436;1300;90,5;33,6;29,1
2003;3514957;Embaúba;2457;1274;1183;92,9;33,3;29,6
2003;3515004;Embu das Artes;217202;106564;110638;103,8;27,2;3085,3
2003;3515103;Embu-Guaçu;58698;29375;29323;99,8;28,8;377,1
2003;3515129;Emilianópolis;2942;1493;1449;97,1;33,9;13,1
2003;3515152;Engenheiro Coelho;11653;6060;5593;92,3;28;106
2003;3515186;Espírito Santo do Pinhal;41111;20295;20816;102,6;33,1;105,6
2003;3515194;Espírito Santo do Turvo;3837;1972;1865;94,6;28,8;19,8
2003;3515202;Estrela d'Oeste;8285;4204;4081;97,1;33,7;28
2003;3515301;Estrela do Norte;2635;1362;1273;93,5;30,9;9,9
2003;3515350;Euclides da Cunha Paulista;10054;5084;4970;97,8;28,9;17,5
2003;3515400;Fartura;15100;7481;7619;101,8;32,2;35,2
2003;3515509;Fernandópolis;62727;30783;31944;103,8;33,9;114,1
2003;3515608;Fernando Prestes;5448;2700;2748;101,8;35,4;32
2003;3515657;Fernão;1468;752;716;95,2;32,7;14,6
2003;3515707;Ferraz de Vasconcelos;150304;73923;76381;103,3;27,3;5086,9
2003;3515806;Flora Rica;2056;1035;1021;98,6;34,5;9,1
2003;3515905;Floreal;3175;1581;1594;100,8;37,1;15,5
2003;3516002;Flórida Paulista;11637;5972;5665;94,9;33,2;22,2
2003;3516101;Florínea;3050;1481;1569;105,9;32,3;13,5
2003;3516200;Franca;297558;146478;151080;103,1;30,7;491,3
2003;3516309;Francisco Morato;139814;69658;70156;100,7;26,3;2853,3
2003;3516408;Franco da Rocha;115219;59499;55720;93,6;28,4;867,8
2003;3516507;Gabriel Monteiro;2722;1397;1325;94,8;34,9;19,6
2003;3516606;Gália;7634;3865;3769;97,5;33;21,4
2003;3516705;Garça;43326;21244;22082;103,9;32,8;78
2003;3516804;Gastão Vidigal;3741;1915;1826;95,4;32,7;20,7
2003;3516853;Gavião Peixoto;4218;2234;1984;88,8;29,6;17,3
2003;3516903;General Salgado;10796;5475;5321;97,2;33,5;21,8
2003;3517000;Getulina;10500;5663;4837;85,4;32,5;15,5
2003;3517109;Glicério;4463;2251;2212;98,3;32,3;16,4
2003;3517208;Guaiçara;9638;4822;4816;99,9;30,5;34,8
2003;3517307;Guaimbê;5297;2646;2651;100,2;31,3;24,3
2003;3517406;Guaíra;35456;17754;17702;99,7;31,5;28,2
2003;3517505;Guapiaçu;15171;7699;7472;97,1;32,3;46,7
2003;3517604;Guapiara;19395;9946;9449;95;28,9;47,5
2003;3517703;Guará;19188;9597;9591;99,9;30;53
2003;3517802;Guaraçaí;8816;4433;4383;98,9;34;15,5
2003;3517901;Guaraci;9148;4657;4491;96,4;31,5;14,3
2003;3518008;Guarani d'Oeste;1994;1014;980;96,6;34,3;23,3
2003;3518107;Guarantã;6360;3228;3132;97;30,1;13,8
2003;3518206;Guararapes;29431;14578;14853;101,9;33;30,8
2003;3518305;Guararema;23146;11720;11426;97,5;30,4;85,5
2003;3518404;Guaratinguetá;106936;52012;54924;105,6;32;142,1
2003;3518503;Guareí;11491;6293;5198;82,6;30,8;20,2
2003;3518602;Guariba;32375;16367;16008;97,8;29,1;119,8
2003;3518701;Guarujá;272860;134344;138516;103,1;29;1884,5
2003;3518800;Guarulhos;1117933;548448;569485;103,8;28,6;3508,1
2003;3518859;Guatapará;6563;3386;3177;93,8;30,3;15,9
2003;3518909;Guzolândia;4442;2303;2139;92,9;31,7;17,6
2003;3519006;Herculândia;8209;4145;4064;98;31,6;22,5
2003;3519055;Holambra;8412;4297;4115;95,8;29,8;128,3
2003;3519071;Hortolândia;164323;82509;81814;99,2;28,2;2632,7
2003;3519105;Iacanga;8790;4471;4319;96,6;33;16,1
2003;3519204;Iacri;6676;3366;3310;98,3;32,8;20,7
2003;3519253;Iaras;4023;2323;1700;73,2;29;10
2003;3519303;Ibaté;27665;14113;13552;96;28,9;95,1
2003;3519402;Ibirá;9841;4849;4992;102,9;34,4;36,2
2003;3519501;Ibirarema;5986;3027;2959;97,8;32,4;26,2
2003;3519600;Ibitinga;48516;23970;24546;102,4;32,4;70,4
2003;3519709;Ibiúna;66741;34250;32491;94,9;29,3;63,1
2003;3519808;Icém;6974;3535;3439;97,3;31,4;19,2
2003;3519907;Iepê;7389;3672;3717;101,2;33,2;12,4
2003;3520004;Igaraçu do Tietê;22876;11481;11395;99,3;30;234
2003;3520103;Igarapava;26499;13066;13433;102,8;32,4;56,6
2003;3520202;Igaratá;8493;4395;4098;93,2;30,4;29
2003;3520301;Iguape;28053;14234;13819;97,1;31,3;14,2
2003;3520400;Ilhabela;22936;11869;11067;93,2;28,6;66,2
2003;3520426;Ilha Comprida;7354;3705;3649;98,5;32,3;37,4
2003;3520442;Ilha Solteira;24373;11994;12379;103,2;32,3;37,3
2003;3520509;Indaiatuba;162827;81213;81614;100,5;30,7;522,6
2003;3520608;Indiana;4918;2487;2431;97,7;32,8;38
2003;3520707;Indiaporã;4041;2007;2034;101,3;35,3;14,5
2003;3520806;Inúbia Paulista;3405;1732;1673;96,6;33,2;39,1
2003;3520905;Ipaussu;12928;6484;6444;99,4;31,5;61,7
2003;3521002;Iperó;21229;11379;9850;86,6;29;124,7
2003;3521101;Ipeúna;4828;2501;2327;93;30,3;25,4
2003;3521150;Ipiguá;3756;1924;1832;95,2;32,7;27,6
2003;3521200;Iporanga;4496;2313;2183;94,4;28,4;3,9
2003;3521309;Ipuã;12538;6396;6142;96;30,1;26,9
2003;3521408;Iracemápolis;16755;8442;8313;98,5;31,2;145,5
2003;3521507;Irapuã;6844;3538;3306;93,4;32,6;26,6
2003;3521606;Irapuru;7585;3980;3605;90,6;35,3;35,4
2003;3521705;Itaberá;18724;9500;9224;97,1;30,1;17
2003;3521804;Itaí;21900;11348;10552;93;29,9;20
2003;3521903;Itajobi;14341;7248;7093;97,9;34,7;28,6
2003;3522000;Itaju;2816;1465;1351;92,2;33,7;12,2
2003;3522109;Itanhaém;76517;37782;38735;102,5;31;127,2
2003;3522158;Itaoca;3253;1676;1577;94,1;31;17,8
2003;3522208;Itapecerica da Serra;137612;68288;69324;101,5;27,3;912,9
2003;3522307;Itapetininga;131542;65853;65689;99,8;30,5;73,5
2003;3522406;Itapeva;84946;41997;42949;102,3;29;46,5
2003;3522505;Itapevi;173544;85788;87756;102,3;26,6;2099,5
2003;3522604;Itapira;65027;32477;32550;100,2;33,4;125,4
2003;3522653;Itapirapuã Paulista;3689;1929;1760;91,2;28,3;9,1
2003;3522703;Itápolis;38516;19182;19334;100,8;33,3;38,6
2003;3522802;Itaporanga;14474;7279;7195;98,8;31,3;28,5
2003;3522901;Itapuí;10896;5569;5327;95,7;31,9;77,8
2003;3523008;Itapura;3964;2062;1902;92,2;31,4;13,1
2003;3523107;Itaquaquecetuba;287745;143125;144620;101;26,3;3482,7
2003;3523206;Itararé;47287;23360;23927;102,4;29,9;47,1
2003;3523305;Itariri;14156;7214;6942;96,2;28,5;51,7
2003;3523404;Itatiba;87267;43376;43891;101,2;31,4;270,8
2003;3523503;Itatinga;16201;8294;7907;95,3;28,7;16,5
2003;3523602;Itirapina;13689;7760;5929;76,4;30,9;24,2
2003;3523701;Itirapuã;5586;2891;2695;93,2;30,6;34,7
2003;3523800;Itobi;7536;3918;3618;92,3;31,5;54,2
2003;3523909;Itu;141117;70208;70909;101;30,5;220,2
2003;3524006;Itupeva;31390;16046;15344;95,6;29;156,3
2003;3524105;Ituverava;37102;18274;18828;103;32,6;52,7
2003;3524204;Jaborandi;6460;3306;3154;95,4;31,9;23,6
2003;3524303;Jaboticabal;68899;33696;35203;104,5;32,5;97,5
2003;3524402;Jacareí;197590;97396;100194;102,9;30,6;425,6
2003;3524501;Jaci;4573;2364;2209;93,4;31,4;31,5
2003;3524600;Jacupiranga;17109;8748;8361;95,6;29,4;24,3
2003;3524709;Jaguariúna;33850;17007;16843;99;30,8;239,4
2003;3524808;Jales;46541;22966;23575;102,7;33,7;126,3
2003;3524907;Jambeiro;4424;2304;2120;92;31,2;24
2003;3525003;Jandira;96960;47949;49011;102,2;27,2;5556,7
2003;3525102;Jardinópolis;32713;16485;16228;98,4;30,8;65,2
2003;3525201;Jarinu;19005;9759;9246;94,7;29,8;91,6
2003;3525300;Jaú;117718;58051;59667;102,8;32,8;171,3
2003;3525409;Jeriquara;3267;1715;1552;90,5;29,5;23
2003;3525508;Joanópolis;10816;5500;5316;96,7;32,7;28,9
2003;3525607;João Ramalho;3920;1984;1936;97,6;29,9;9,4
2003;3525706;José Bonifácio;29993;15007;14986;99,9;32;34,9
2003;3525805;Júlio Mesquita;4291;2118;2173;102,6;31,3;33,5
2003;3525854;Jumirim;2371;1244;1127;90,6;31,7;41,8
2003;3525904;Jundiaí;337548;165178;172370;104,4;32,9;782,8
2003;3526001;Junqueirópolis;17547;9217;8330;90,4;34,8;30,1
2003;3526100;Juquiá;20324;10381;9943;95,8;29,5;25
2003;3526209;Juquitiba;27346;13789;13557;98,3;28,2;52,4
2003;3526308;Lagoinha;4924;2553;2371;92,9;33,3;19,3
2003;3526407;Laranjal Paulista;23065;11478;11587;100,9;32,8;60
2003;3526506;Lavínia;6228;3434;2794;81,4;33,3;11,6
2003;3526605;Lavrinhas;6167;3142;3025;96,3;28,5;36,9
2003;3526704;Leme;84075;42415;41660;98,2;30,3;208,7
2003;3526803;Lençóis Paulista;57096;28530;28566;100,1;30,4;70,5
2003;3526902;Limeira;257211;127343;129868;102;31,4;442,9
2003;3527009;Lindóia;5721;2875;2846;99;32,9;117,3
2003;3527108;Lins;67765;32883;34882;106,1;33,4;118,9
2003;3527207;Lorena;79406;38587;40819;105,8;31,3;191,7
2003;3527256;Lourdes;2040;1062;978;92,1;33,6;17,9
2003;3527306;Louveira;27528;13951;13577;97,3;29,3;493,9
2003;3527405;Lucélia;18843;9824;9019;91,8;33,3;59,9
2003;3527504;Lucianópolis;2200;1125;1075;95,6;32,3;11,6
2003;3527603;Luís Antônio;8355;4289;4066;94,8;28;14
2003;3527702;Luiziânia;4480;2270;2210;97,4;32,7;26,9
2003;3527801;Lupércio;4278;2132;2146;100,7;30,7;27,6
2003;3527900;Lutécia;2843;1438;1405;97,7;32,6;6
2003;3528007;Macatuba;15960;8021;7939;99;30,1;71,1
2003;3528106;Macaubal;7440;3782;3658;96,7;35,3;30
2003;3528205;Macedônia;3746;1892;1854;98;34,3;11,4
2003;3528304;Magda;3358;1737;1621;93,3;34,7;10,8
2003;3528403;Mairinque;40935;20470;20465;100;29,3;194,8
2003;3528502;Mairiporã;66241;33369;32872;98,5;29,9;206,6
2003;3528601;Manduri;8481;4315;4166;96,5;32,3;37
2003;3528700;Marabá Paulista;4043;2213;1830;82,7;31,4;4,4
2003;3528809;Maracaí;13113;6648;6465;97,2;31,5;24,6
2003;3528858;Marapoama;2355;1200;1155;96,3;33,5;21,2
2003;3528908;Mariápolis;3876;1993;1883;94,5;33,9;20,8
2003;3529005;Marília;203497;99202;104295;105,1;32,3;173,9
2003;3529104;Marinópolis;2191;1118;1073;96;32,4;28,2
2003;3529203;Martinópolis;22938;11812;11126;94,2;32,5;18,3
2003;3529302;Matão;73480;36652;36828;100,5;31,2;140
2003;3529401;Mauá;380522;187057;193465;103,4;28,7;6143,7
2003;3529500;Mendonça;4031;2064;1967;95,3;35,1;20,7
2003;3529609;Meridiano;4001;2025;1976;97,6;33,7;17,5
2003;3529658;Mesópolis;1933;989;944;95,4;33,4;13
2003;3529708;Miguelópolis;19461;9762;9699;99,4;30,5;23,7
2003;3529807;Mineiros do Tietê;11627;5835;5792;99,3;31,2;54,5
2003;3529906;Miracatu;22001;11295;10706;94,8;28,4;22
2003;3530003;Mira Estrela;2681;1379;1302;94,4;34,2;12,4
2003;3530102;Mirandópolis;26389;14166;12223;86,3;34;28,8
2003;3530201;Mirante do Paranapanema;16512;8416;8096;96,2;32,5;13,3
2003;3530300;Mirassol;49955;24622;25333;102,9;33;205,4
2003;3530409;Mirassolândia;3893;1994;1899;95,2;32,9;23,4
2003;3530508;Mococa;66068;33220;32848;98,9;32,3;77,3
2003;3530607;Mogi das Cruzes;347687;170719;176968;103,7;29,9;488
2003;3530706;Mogi Guaçu;128382;64289;64093;99,7;31,2;158
2003;3530805;Mogi Mirim;82957;41289;41668;100,9;32,4;166,7
2003;3530904;Mombuca;3161;1616;1545;95,6;29,7;23,6
2003;3531001;Monções;2087;1068;1019;95,4;35,5;20
2003;3531100;Mongaguá;38379;19536;18843;96,5;31,3;268,8
2003;3531209;Monte Alegre do Sul;6547;3315;3232;97,5;34,1;59,4
2003;3531308;Monte Alto;44626;22247;22379;100,6;33,3;128,6
2003;3531407;Monte Aprazível;19402;9631;9771;101,5;35;39,2
2003;3531506;Monte Azul Paulista;19477;9820;9657;98,3;31,9;73,9
2003;3531605;Monte Castelo;4091;2056;2035;99;35;17,5
2003;3531704;Monteiro Lobato;3775;1952;1823;93,4;31,7;11,3
2003;3531803;Monte Mor;40835;20501;20334;99,2;28,9;169,7
2003;3531902;Morro Agudo;26482;13525;12957;95,8;29,1;19,1
2003;3532009;Morungaba;10489;5292;5197;98,2;30,5;71,5
2003;3532058;Motuca;3993;2049;1944;94,9;30,2;17,5
2003;3532108;Murutinga do Sul;4048;2048;2000;97,7;36,2;16,1
2003;3532157;Nantes;2419;1228;1191;97;29,4;8,4
2003;3532207;Narandiba;3921;1984;1937;97,6;30,3;11
2003;3532306;Natividade da Serra;6912;3640;3272;89,9;33,1;8,3
2003;3532405;Nazaré Paulista;15075;7777;7298;93,8;31,4;46,2
2003;3532504;Neves Paulista;8884;4458;4426;99,3;35,7;40,6
2003;3532603;Nhandeara;10389;5115;5274;103,1;36,2;23,8
2003;3532702;Nipoã;3537;1832;1705;93,1;32,5;25,7
2003;3532801;Nova Aliança;5101;2534;2567;101,3;34,8;23,5
2003;3532827;Nova Campina;7684;3984;3700;92,9;26,2;19,9
2003;3532843;Nova Canaã Paulista;2394;1239;1155;93,2;36,8;19,2
2003;3532868;Nova Castilho;1024;527;497;94,3;33;5,6
2003;3532900;Nova Europa;7813;3945;3868;98;30,6;48,8
2003;3533007;Nova Granada;17674;8882;8792;99;32,5;33,2
2003;3533106;Nova Guataporanga;2127;1088;1039;95,5;35,4;62,3
2003;3533205;Nova Independência;2358;1191;1167;98;32,5;8,9
2003;3533254;Novais;3597;1894;1703;89,9;30,6;30,5
2003;3533304;Nova Luzitânia;2941;1543;1398;90,6;32;39,8
2003;3533403;Nova Odessa;44930;22275;22655;101,7;31,1;608,9
2003;3533502;Novo Horizonte;33689;16759;16930;101;33,3;36,2
2003;3533601;Nuporanga;6470;3270;3200;97,9;32,5;18,6
2003;3533700;Ocauçu;4191;2174;2017;92,8;32,2;13,9
2003;3533809;Óleo;2896;1475;1421;96,3;33,6;14,6
2003;3533908;Olímpia;47271;23391;23880;102,1;33,1;58,9
2003;3534005;Onda Verde;3575;1823;1752;96,1;31,1;14,7
2003;3534104;Oriente;5981;2955;3026;102,4;33,6;27,4
2003;3534203;Orindiúva;4576;2349;2227;94,8;29,3;18,5
2003;3534302;Orlândia;37237;18411;18826;102,3;31,4;127,6
2003;3534401;Osasco;658322;319342;338980;106,1;29,9;10135,2
2003;3534500;Oscar Bressane;2539;1229;1310;106,6;35,3;11,4
2003;3534609;Osvaldo Cruz;30152;14953;15199;101,6;34,8;121,6
2003;3534708;Ourinhos;96737;47337;49400;104,4;31,9;327
2003;3534757;Ouroeste;6893;3457;3436;99,4;32,7;23,9
2003;3534807;Ouro Verde;7359;3678;3681;100,1;31,8;27,6
2003;3534906;Pacaembu;12768;6982;5786;82,9;34,6;37,6
2003;3535002;Palestina;9635;4813;4822;100,2;35,3;13,8
2003;3535101;Palmares Paulista;9161;4733;4428;93,6;28,5;111,5
2003;3535200;Palmeira d'Oeste;10152;5142;5010;97,4;35;31,9
2003;3535309;Palmital;20902;10314;10588;102,7;34;38,1
2003;3535408;Panorama;13963;7088;6875;97;30,1;39,2
2003;3535507;Paraguaçu Paulista;40562;20188;20374;100,9;31,4;40,5
2003;3535606;Paraibuna;17213;8794;8419;95,7;30,7;21,3
2003;3535705;Paraíso;5568;2881;2687;93,3;32,6;35,9
2003;3535804;Paranapanema;16224;8382;7842;93,6;29,3;15,9
2003;3535903;Paranapuã;3708;1885;1823;96,7;33,6;26,4
2003;3536000;Parapuã;11084;5642;5442;96,5;34,2;30,2
2003;3536109;Pardinho;4991;2578;2413;93,6;30;23,8
2003;3536208;Pariquera-Açu;17885;8971;8914;99,4;29,8;49,8
2003;3536257;Parisi;1974;1024;950;92,8;34,6;23,3
2003;3536307;Patrocínio Paulista;11850;6051;5799;95,8;30,8;19,7
2003;3536406;Paulicéia;5640;2935;2705;92,2;29,9;15,1
2003;3536505;Paulínia;60117;30006;30111;100,3;29,9;433,2
2003;3536570;Paulistânia;1788;945;843;89,2;31,5;7
2003;3536604;Paulo de Faria;8535;4266;4269;100,1;32;11,6
2003;3536703;Pederneiras;38096;19208;18888;98,3;30,8;52,4
2003;3536802;Pedra Bela;5660;2983;2677;89,7;32,6;35,7
2003;3536901;Pedranópolis;2696;1384;1312;94,8;35,4;10,4
2003;3537008;Pedregulho;15262;7789;7473;95,9;30,5;21,4
2003;3537107;Pedreira;37162;18430;18732;101,6;31,8;341,5
2003;3537156;Pedrinhas Paulista;2894;1456;1438;98,8;32;19
2003;3537206;Pedro de Toledo;9508;4836;4672;96,6;30;14,2
2003;3537305;Penápolis;55879;27302;28577;104,7;33,3;78,6
2003;3537404;Pereira Barreto;25074;12372;12702;102,7;32,4;25,7
2003;3537503;Pereiras;6551;3350;3201;95,6;32,9;29,4
2003;3537602;Peruíbe;54037;26765;27272;101,9;31,1;165,6
2003;3537701;Piacatu;4819;2428;2391;98,5;33,1;20,7
2003;3537800;Piedade;51007;26541;24466;92,2;30,7;68,3
2003;3537909;Pilar do Sul;24786;12725;12061;94,8;29,6;36,4
2003;3538006;Pindamonhangaba;132634;65911;66723;101,2;29,8;181,4
2003;3538105;Pindorama;13693;6962;6731;96,7;34,4;74,1
2003;3538204;Pinhalzinho;11611;5965;5646;94,7;33,1;75,1
2003;3538303;Piquerobi;3497;1763;1734;98,4;33,4;7,2
2003;3538501;Piquete;14902;7259;7643;105,3;32,7;84,7
2003;3538600;Piracaia;23941;12092;11849;98;31,5;62,1
2003;3538709;Piracicaba;340106;167432;172674;103,1;31,9;246,8
2003;3538808;Piraju;28286;13826;14460;104,6;32,8;56,1
2003;3538907;Pirajuí;20923;11283;9640;85,4;33,1;25,4
2003;3539004;Pirangi;10234;5234;5000;95,5;34,3;47,4
2003;3539103;Pirapora do Bom Jesus;13379;6689;6690;100;27;123,3
2003;3539202;Pirapozinho;23006;11263;11743;104,3;31,7;48,2
2003;3539301;Pirassununga;66493;32724;33769;103,2;32,9;91,4
2003;3539400;Piratininga;11051;5559;5492;98,8;33;27,5
2003;3539509;Pitangueiras;32460;16611;15849;95,4;29,1;75,4
2003;3539608;Planalto;3904;2000;1904;95,2;31,4;13,5
2003;3539707;Platina;2967;1550;1417;91,4;31,3;9,1
2003;3539806;Poá;98750;48242;50508;104,7;28,9;5720,1
2003;3539905;Poloni;4936;2419;2517;104,1;36,2;36,5
2003;3540002;Pompéia;18770;9283;9487;102,2;32,5;23,9
2003;3540101;Pongaí;3632;1881;1751;93,1;35,1;19,8
2003;3540200;Pontal;32656;16735;15921;95,1;28,1;91,6
2003;3540259;Pontalinda;3699;1941;1758;90,6;31;17,7
2003;3540309;Pontes Gestal;2531;1262;1269;100,6;33,9;11,6
2003;3540408;Populina;4387;2253;2134;94,7;34,3;13,9
2003;3540507;Porangaba;7161;3763;3398;90,3;33,1;27
2003;3540606;Porto Feliz;46669;23417;23252;99,3;31;83,8
2003;3540705;Porto Ferreira;48574;24184;24390;100,9;31,7;198,3
2003;3540754;Potim;15339;8023;7316;91,2;27,9;343,6
2003;3540804;Potirendaba;14159;7250;6909;95,3;34,8;41,3
2003;3540853;Pracinha;1861;1050;811;77,2;32,9;29,5
2003;3540903;Pradópolis;14138;7192;6946;96,6;30,1;84,5
2003;3541000;Praia Grande;213382;103764;109618;105,6;30,8;1425,9
2003;3541059;Pratânia;4161;2166;1995;92,1;29,4;23,8
2003;3541109;Presidente Alves;4256;2138;2118;99,1;32,5;14,8
2003;3541208;Presidente Bernardes;14436;7401;7035;95,1;34,2;19,3
2003;3541307;Presidente Epitácio;39995;19814;20181;101,9;31;31,7
2003;3541406;Presidente Prudente;195132;94499;100633;106,5;32,5;348,1
2003;3541505;Presidente Venceslau;37695;18864;18831;99,8;33,4;49,9
2003;3541604;Promissão;32491;16340;16151;98,8;31,9;41,7
2003;3541653;Quadra;2807;1478;1329;89,9;32,4;13,6
2003;3541703;Quatá;11971;5960;6011;100,9;31,2;18,4
2003;3541802;Queiroz;2379;1216;1163;95,6;30,5;10,1
2003;3541901;Queluz;9801;4898;4903;100,1;29,9;39,3
2003;3542008;Quintana;5599;2811;2788;99,2;32,4;17,6
2003;3542107;Rafard;8466;4225;4241;100,4;31,5;69,6
2003;3542206;Rancharia;28902;14301;14601;102,1;32,1;18,2
2003;3542305;Redenção da Serra;3983;2125;1858;87,4;32,5;12,9
2003;3542404;Regente Feijó;17456;8719;8737;100,2;32,4;66,3
2003;3542503;Reginópolis;5518;2970;2548;85,8;33,2;13,4
2003;3542602;Registro;54267;26972;27295;101,2;29,5;75,1
2003;3542701;Restinga;5890;2989;2901;97,1;28,5;24
2003;3542800;Ribeira;3484;1820;1664;91,4;31,6;10,4
2003;3542909;Ribeirão Bonito;11527;5830;5697;97,7;31;24,4
2003;3543006;Ribeirão Branco;20688;10763;9925;92,2;26,3;29,7
2003;3543105;Ribeirão Corrente;3994;2104;1890;89,8;29,6;26,9
2003;3543204;Ribeirão do Sul;4479;2274;2205;97;33;22
2003;3543238;Ribeirão dos Índios;2215;1127;1088;96,5;34,9;11,3
2003;3543253;Ribeirão Grande;7419;3818;3601;94,3;29,4;22,3
2003;3543303;Ribeirão Pires;107435;52950;54485;102,9;30,7;1085,5
2003;3543402;Ribeirão Preto;534828;257209;277619;107,9;32,3;821,7
2003;3543501;Riversul;6941;3517;3424;97,4;31,9;18
2003;3543600;Rifaina;3374;1716;1658;96,6;32,8;20,8
2003;3543709;Rincão;10393;5253;5140;97,8;30,4;32,8
2003;3543808;Rinópolis;10152;5191;4961;95,6;35;28,3
2003;3543907;Rio Claro;173455;84696;88759;104,8;32,8;348
2003;3544004;Rio das Pedras;25207;12811;12396;96,8;29,8;111,2
2003;3544103;Rio Grande da Serra;39201;19502;19699;101;27,8;1078,7
2003;3544202;Riolândia;9100;5108;3992;78,2;31,2;14,4
2003;3544251;Rosana;23065;11652;11413;97,9;28,3;31
2003;3544301;Roseira;8867;4508;4359;96,7;29,5;68,3
2003;3544400;Rubiácea;2433;1238;1195;96,5;31,6;10,3
2003;3544509;Rubinéia;2700;1333;1367;102,6;35,2;11,1
2003;3544608;Sabino;4983;2494;2489;99,8;33,8;16,3
2003;3544707;Sagres;2426;1227;1199;97,7;32,5;16,4
2003;3544806;Sales;4827;2463;2364;96;32,9;15,6
2003;3544905;Sales Oliveira;9656;4831;4825;99,9;32,2;31,6
2003;3545001;Salesópolis;14770;7476;7294;97,6;30,6;34,8
2003;3545100;Salmourão;4540;2320;2220;95,7;32,8;26,3
2003;3545159;Saltinho;6138;3086;3052;98,9;33,1;61,5
2003;3545209;Salto;96965;48346;48619;100,6;30,4;728,8
2003;3545308;Salto de Pirapora;36663;18346;18317;99,8;30,1;130,7
2003;3545407;Salto Grande;8589;4302;4287;99,7;32,5;45,6
2003;3545506;Sandovalina;3274;1639;1635;99,8;29,2;7,2
2003;3545605;Santa Adélia;13743;6920;6823;98,6;32,8;41,6
2003;3545704;Santa Albertina;5657;2850;2807;98,5;36,1;20,7
2003;3545803;Santa Bárbara d'Oeste;173155;86363;86792;100,5;31;638,9
2003;3546009;Santa Branca;13267;6688;6579;98,4;31,4;48,7
2003;3546108;Santa Clara d'Oeste;2120;1070;1050;98,1;34,5;11,6
2003;3546207;Santa Cruz da Conceição;3673;1862;1811;97,3;33,2;24,5
2003;3546256;Santa Cruz da Esperança;1859;944;915;96,9;31,3;12,6
2003;3546306;Santa Cruz das Palmeiras;26811;13572;13239;97,5;30,7;90,8
2003;3546405;Santa Cruz do Rio Pardo;41903;20692;21211;102,5;32,5;37,6
2003;3546504;Santa Ernestina;5710;3053;2657;87;29,2;42,5
2003;3546603;Santa Fé do Sul;27406;13303;14103;106;34,2;132,7
2003;3546702;Santa Gertrudes;17531;8920;8611;96,5;29,5;178,4
2003;3546801;Santa Isabel;45940;23150;22790;98,4;29,8;126,4
2003;3546900;Santa Lúcia;7962;4076;3886;95,3;29,1;51,7
2003;3547007;Santa Maria da Serra;4875;2524;2351;93,1;30;19,3
2003;3547106;Santa Mercedes;2826;1426;1400;98,2;32,9;16,9
2003;3547205;Santana da Ponte Pensa;1821;933;888;95,2;37,2;14
2003;3547304;Santana de Parnaíba;84345;41939;42406;101,1;28;468,7
2003;3547403;Santa Rita d'Oeste;2677;1346;1331;98,9;37,1;12,8
2003;3547502;Santa Rita do Passa Quatro;26306;12802;13504;105,5;35,5;34,9
2003;3547601;Santa Rosa de Viterbo;22142;11011;11131;101,1;32,2;76,7
2003;3547650;Santa Salete;1410;733;677;92,4;36,9;17,8
2003;3547700;Santo Anastácio;20735;10138;10597;104,5;33,4;37,5
2003;3547809;Santo André;658884;317856;341028;107,3;32,9;3748,3
2003;3547908;Santo Antônio da Alegria;5961;3100;2861;92,3;32,7;19,2
2003;3548005;Santo Antônio de Posse;18899;9523;9376;98,5;30,7;122,6
2003;3548054;Santo Antônio do Aracanguá;7155;3699;3456;93,4;31,1;5,5
2003;3548104;Santo Antônio do Jardim;6104;3177;2927;92,1;32,8;55,5
2003;3548203;Santo Antônio do Pinhal;6392;3266;3126;95,7;30,3;48,1
2003;3548302;Santo Expedito;2601;1332;1269;95,3;33,8;27,5
2003;3548401;Santópolis do Aguapeí;3949;2005;1944;97;30,9;30,8
2003;3548500;Santos;419037;193216;225821;116,9;36,4;1491,1
2003;3548609;São Bento do Sapucaí;10423;5271;5152;97,7;32,8;41,3
2003;3548708;São Bernardo do Campo;722153;350762;371391;105,9;30,6;1763,4
2003;3548807;São Caetano do Sul;142884;66572;76312;114,6;37,2;9320,1
2003;3548906;São Carlos;201546;99575;101971;102,4;32,5;177,3
2003;3549003;São Francisco;2865;1444;1421;98,4;34,7;37,9
2003;3549102;São João da Boa Vista;79411;38899;40512;104,1;33,6;153,8
2003;3549201;São João das Duas Pontes;2651;1347;1304;96,8;32,9;20,5
2003;3549250;São João de Iracema;1709;868;841;96,9;33;9,6
2003;3549300;São João do Pau d'Alho;2168;1095;1073;98;36,4;18,4
2003;3549409;São Joaquim da Barra;43077;21214;21863;103,1;31,8;104,8
2003;3549508;São José da Bela Vista;8214;4202;4012;95,5;29,4;29,7
2003;3549607;São José do Barreiro;4128;2128;2000;94;31,3;7,2
2003;3549706;São José do Rio Pardo;50852;25155;25697;102,2;32,6;121,2
2003;3549805;São José do Rio Preto;373298;180251;193047;107,1;33,2;864,2
2003;3549904;São José dos Campos;566375;279278;287097;102,8;29,9;515,2
2003;3549953;São Lourenço da Serra;12774;6480;6294;97,1;29;68,5
2003;3550001;São Luiz do Paraitinga;10470;5411;5059;93,5;32,7;17
2003;3550100;São Manuel;37258;18418;18840;102,3;31,5;57,3
2003;3550209;São Miguel Arcanjo;31075;15875;15200;95,7;29,1;33,4
2003;3550308;São Paulo;10698381;5090851;5607530;110,1;31,6;7032,8
2003;3550407;São Pedro;29064;14283;14781;103,5;32,8;47,5
2003;3550506;São Pedro do Turvo;7012;3556;3456;97,2;31,5;9,6
2003;3550605;São Roque;70597;35036;35561;101,5;31,6;230
2003;3550704;São Sebastião;62656;31614;31042;98,2;28,6;155,7
2003;3550803;São Sebastião da Grama;12425;6330;6095;96,3;31,9;49,2
2003;3550902;São Simão;13908;6907;7001;101,4;32,3;22,5
2003;3551009;São Vicente;312311;151111;161200;106,7;30,7;2108,1
2003;3551108;Sarapuí;8216;4251;3965;93,3;30,6;23,3
2003;3551207;Sarutaiá;3691;1860;1831;98,4;31,7;26,1
2003;3551306;Sebastianópolis do Sul;2677;1364;1313;96,3;35;15,9
2003;3551405;Serra Azul;8594;4602;3992;86,7;29,6;30,4
2003;3551504;Serrana;34436;17321;17115;98,8;28,3;273,2
2003;3551603;Serra Negra;24641;12118;12523;103,3;34,4;120,9
2003;3551702;Sertãozinho;99261;49695;49566;99,7;30,4;246,3
2003;3551801;Sete Barras;13573;7063;6510;92,2;29,2;12,8
2003;3551900;Severínia;14171;7364;6807;92,4;29,5;100,9
2003;3552007;Silveiras;5526;2825;2701;95,6;31;13,3
2003;3552106;Socorro;33980;16942;17038;100,6;34,5;75,7
2003;3552205;Sorocaba;521648;256274;265374;103,6;31;1159,5
2003;3552304;Sud Mennucci;7385;3750;3635;96,9;31;12,4
2003;3552403;Sumaré;209460;104845;104615;99,8;29;1364,9
2003;3552502;Suzano;239028;118082;120946;102,4;28,5;1159
2003;3552551;Suzanápolis;2967;1530;1437;93,9;32,9;9
2003;3552601;Tabapuã;10749;5434;5315;97,8;34,1;31,1
2003;3552700;Tabatinga;13556;6912;6644;96,1;31,3;36,8
2003;3552809;Taboão da Serra;211964;102067;109897;107,7;28,5;10396,6
2003;3552908;Taciba;5390;2727;2663;97,7;31,4;8,9
2003;3553005;Taguaí;8432;4242;4190;98,8;30,5;58
2003;3553104;Taiaçu;5719;2896;2823;97,5;32;53,4
2003;3553203;Taiúva;5539;2771;2768;99,9;34,2;41,8
2003;3553302;Tambaú;22422;11293;11129;98,5;31,9;39,9
2003;3553401;Tanabi;23077;11470;11607;101,2;34,4;30,9
2003;3553500;Tapiraí;8462;4334;4128;95,2;28,8;11,2
2003;3553609;Tapiratiba;12934;6432;6502;101,1;31,4;58,3
2003;3553658;Taquaral;2725;1398;1327;94,9;31,6;50,6
2003;3553708;Taquaritinga;52740;26503;26237;99;32,1;88,7
2003;3553807;Taquarituba;22147;11101;11046;99,5;30,8;49,4
2003;3553856;Taquarivaí;4709;2395;2314;96,6;26,7;20,3
2003;3553906;Tarabai;6035;3050;2985;97,9;30,4;30
2003;3553955;Tarumã;11357;5818;5539;95,2;29,5;37,5
2003;3554003;Tatuí;97663;48536;49127;101,2;30,8;186,5
2003;3554102;Taubaté;254685;125356;129329;103,2;31,1;407,5
2003;3554201;Tejupá;5218;2722;2496;91,7;29;17,6
2003;3554300;Teodoro Sampaio;20540;10286;10254;99,7;29,4;13,2
2003;3554409;Terra Roxa;7946;4050;3896;96,2;31,7;35,9
2003;3554508;Tietê;33239;16499;16740;101,5;32,3;82,2
2003;3554607;Timburi;2713;1395;1318;94,5;33,9;13,8
2003;3554656;Torre de Pedra;2169;1120;1049;93,7;33,9;30,4
2003;3554706;Torrinha;8976;4544;4432;97,5;33,8;28,5
2003;3554755;Trabiju;1434;734;700;95,4;30,8;22,6
2003;3554805;Tremembé;36688;19190;17498;91,2;30,3;192
2003;3554904;Três Fronteiras;5255;2639;2616;99,1;35,1;34,7
2003;3554953;Tuiuti;5237;2692;2545;94,5;34,1;41,3
2003;3555000;Tupã;63655;30962;32693;105,6;34,6;101,4
2003;3555109;Tupi Paulista;13647;6874;6773;98,5;36,5;55,8
2003;3555208;Turiúba;1901;982;919;93,6;36,3;12,4
2003;3555307;Turmalina;2262;1128;1134;100,5;36,4;15,3
2003;3555356;Ubarana;4554;2365;2189;92,6;29,3;21,7
2003;3555406;Ubatuba;70629;35600;35029;98,4;28,6;99,7
2003;3555505;Ubirajara;4222;2172;2050;94,4;31,9;15
2003;3555604;Uchoa;9170;4591;4579;99,7;34,6;36,3
2003;3555703;União Paulista;1434;745;689;92,5;33,6;18,1
2003;3555802;Urânia;8878;4433;4445;100,3;34,6;42,4
2003;3555901;Uru;1362;713;649;91;34,4;9,3
2003;3556008;Urupês;12128;6090;6038;99,1;35;37,4
2003;3556107;Valentim Gentil;9306;4718;4588;97,2;32,1;62,1
2003;3556206;Valinhos;89941;44712;45229;101,2;32,5;605,5
2003;3556305;Valparaíso;19738;10487;9251;88,2;31,1;23
2003;3556354;Vargem;7518;3864;3654;94,6;32,6;52,7
2003;3556404;Vargem Grande do Sul;37193;18528;18665;100,7;31,9;139,2
2003;3556453;Vargem Grande Paulista;35556;17772;17784;100,1;28,4;836,8
2003;3556503;Várzea Paulista;97011;48633;48378;99,5;28,5;2762,3
2003;3556602;Vera Cruz;11044;5481;5563;101,5;33,2;44,6
2003;3556701;Vinhedo;51972;25838;26134;101,1;31,9;642
2003;3556800;Viradouro;16354;8271;8083;97,7;31,2;75,1
2003;3556909;Vista Alegre do Alto;5356;2709;2647;97,7;32;56,1
2003;3556958;Vitória Brasil;1699;872;827;94,8;32,8;34,1
2003;3557006;Votorantim;99975;49839;50136;100,6;29,5;542,8
2003;3557105;Votuporanga;78481;38462;40019;104;33,7;186,5
2003;3557154;Zacarias;2068;1061;1007;94,9;33,6;6,5
2003;3557204;Chavantes;12189;6079;6110;100,5;31,4;64,6
2003;3557303;Estiva Gerbi;9214;4726;4488;95;30;124,3
2004;3500105;Adamantina;33715;16411;17304;105,4;35,3;81,8
2004;3500204;Adolfo;3655;1850;1805;97,6;33,9;17,3
2004;3500303;Aguaí;29798;14974;14824;99;31,4;62,8
2004;3500402;Águas da Prata;7297;3650;3647;99,9;35,5;51,1
2004;3500501;Águas de Lindóia;16559;8171;8388;102,7;33,4;275,4
2004;3500550;Águas de Santa Bárbara;5395;2707;2688;99,3;32,6;13,3
2004;3500600;Águas de São Pedro;2211;1021;1190;116,6;39,2;612,1
2004;3500709;Agudos;33389;16567;16822;101,5;30,6;34,5
2004;3500758;Alambari;4137;2115;2022;95,6;30,4;25,9
2004;3500808;Alfredo Marcondes;3792;1933;1859;96,2;35,8;31,9
2004;3500907;Altair;3631;1941;1690;87,1;30,2;11,6
2004;3501004;Altinópolis;15658;7884;7774;98,6;32,7;16,9
2004;3501103;Alto Alegre;4203;2180;2023;92,8;36,1;13,2
2004;3501152;Alumínio;15961;8056;7905;98,1;29;190,9
2004;3501202;Álvares Florence;4173;2161;2012;93,1;37;11,5
2004;3501301;Álvares Machado;23127;11561;11566;100;31,8;66,5
2004;3501400;Álvaro de Carvalho;4320;2643;1677;63,5;30,9;28,1
2004;3501509;Alvinlândia;2896;1455;1441;99;31,2;34,1
2004;3501608;Americana;193926;95564;98362;102,9;33,2;1448,2
2004;3501707;Américo Brasiliense;30620;15519;15101;97,3;28,7;249
2004;3501806;Américo de Campos;5656;2835;2821;99,5;35,2;22,4
2004;3501905;Amparo;62724;31146;31578;101,4;33,5;140,9
2004;3502002;Analândia;3850;1987;1863;93,8;32,2;11,8
2004;3502101;Andradina;55402;27291;28111;103;33,8;57,5
2004;3502200;Angatuba;20553;10514;10039;95,5;31,5;20
2004;3502309;Anhembi;4951;2553;2398;93,9;31,2;6,7
2004;3502408;Anhumas;3540;1793;1747;97,4;32,2;11
2004;3502507;Aparecida;34859;17002;17857;105;31,8;288,4
2004;3502606;Aparecida d'Oeste;4771;2355;2416;102,6;35,5;26,7
2004;3502705;Apiaí;26648;13394;13254;99;28,6;27,4
2004;3502754;Araçariguama;13411;6869;6542;95,2;28;92,4
2004;3502804;Araçatuba;174526;84297;90229;107;33,7;149,5
2004;3502903;Araçoiaba da Serra;22765;11424;11341;99,3;31,9;89,2
2004;3503000;Aramina;4906;2488;2418;97,2;33,2;24,2
2004;3503109;Arandu;6150;3121;3029;97,1;30,3;21,5
2004;3503158;Arapeí;2570;1286;1284;99,8;32,3;16,4
2004;3503208;Araraquara;192621;93407;99214;106,2;33,7;191,9
2004;3503307;Araras;109828;54650;55178;101;32,3;170,3
2004;3503356;Arco-Íris;2080;1079;1001;92,8;34,4;7,9
2004;3503406;Arealva;7500;3846;3654;95;35,2;14,8
2004;3503505;Areias;3653;1834;1819;99,2;30,4;12
2004;3503604;Areiópolis;10475;5395;5080;94,2;28,3;121,9
2004;3503703;Ariranha;7896;4033;3863;95,8;33,2;59,5
2004;3503802;Artur Nogueira;37532;18807;18725;99,6;29,9;210,8
2004;3503901;Arujá;65396;32498;32898;101,2;28,7;680
2004;3503950;Aspásia;1856;945;911;96,4;35;26,8
2004;3504008;Assis;90456;44024;46432;105,5;33,5;196,4
2004;3504107;Atibaia;117782;58331;59451;101,9;31,7;246,1
2004;3504206;Auriflama;13856;6964;6892;99;33,7;31,9
2004;3504305;Avaí;4745;2442;2303;94,3;31,5;8,8
2004;3504404;Avanhandava;9809;5084;4725;92,9;30,4;29
2004;3504503;Avaré;79017;39379;39638;100,7;31,9;65,1
2004;3504602;Bady Bassitt;12749;6392;6357;99,5;32;115,5
2004;3504701;Balbinos;2265;1398;867;62;33,6;24,7
2004;3504800;Bálsamo;7661;3794;3867;101,9;35,1;51,1
2004;3504909;Bananal;9962;4943;5019;101,5;32,4;16,2
2004;3505005;Barão de Antonina;2937;1503;1434;95,4;32,8;19,2
2004;3505104;Barbosa;6154;3102;3052;98,4;31,4;30
2004;3505203;Bariri;29636;14847;14789;99,6;34;66,7
2004;3505302;Barra Bonita;35479;17596;17883;101,6;33,2;236,3
2004;3505351;Barra do Chapéu;5023;2686;2337;87;29,2;12,4
2004;3505401;Barra do Turvo;8001;4204;3797;90,3;29,2;7,9
2004;3505500;Barretos;107131;52055;55076;105,8;33,1;68,4
2004;3505609;Barrinha;25843;13069;12774;97,7;27,9;177
2004;3505708;Barueri;221238;108689;112549;103,6;28;3367,4
2004;3505807;Bastos;20660;10227;10433;102;31,6;120,9
2004;3505906;Batatais;53294;26333;26961;102,4;33;62,7
2004;3506003;Bauru;327726;159678;168048;105,2;32,6;490,8
2004;3506102;Bebedouro;75182;36904;38278;103,7;32,6;110
2004;3506201;Bento de Abreu;2482;1266;1216;96,1;32,2;8,2
2004;3506300;Bernardino de Campos;10782;5309;5473;103,1;34,4;44,2
2004;3506359;Bertioga;36681;18718;17963;96;28;74,6
2004;3506409;Bilac;6511;3220;3291;102,2;35,1;41,2
2004;3506508;Birigui;100042;49117;50925;103,7;32,6;188,7
2004;3506607;Biritiba Mirim;26247;13289;12958;97,5;29,6;82,7
2004;3506706;Boa Esperança do Sul;13030;6600;6430;97,4;30,1;18,9
2004;3506805;Bocaina;9980;4976;5004;100,6;32,5;27,4
2004;3506904;Bofete;8258;4284;3974;92,8;31,6;12,6
2004;3507001;Boituva;39696;20056;19640;97,9;30,4;159,5
2004;3507100;Bom Jesus dos Perdões;15803;7950;7853;98,8;30,2;145,8
2004;3507159;Bom Sucesso de Itararé;3362;1727;1635;94,7;26,6;25,2
2004;3507209;Borá;800;409;391;95,6;32;6,7
2004;3507308;Boracéia;3937;2020;1917;94,9;31,7;32,2
2004;3507407;Borborema;13767;6975;6792;97,4;33,8;24,9
2004;3507456;Borebi;2081;1064;1017;95,6;30,1;6
2004;3507506;Botucatu;115886;56441;59445;105,3;32,7;78,2
2004;3507605;Bragança Paulista;133937;66134;67803;102,5;32,1;261,3
2004;3507704;Braúna;4620;2348;2272;96,8;34,4;23,7
2004;3507753;Brejo Alegre;2424;1254;1170;93,3;31,9;22,9
2004;3507803;Brodowski;18799;9402;9397;99,9;32;67,5
2004;3507902;Brotas;19943;9999;9944;99,4;32,2;18,1
2004;3508009;Buri;18024;9375;8649;92,3;28,8;15,1
2004;3508108;Buritama;14495;7241;7254;100,2;33,3;44,3
2004;3508207;Buritizal;3815;1950;1865;95,6;33,5;14,3
2004;3508306;Cabrália Paulista;4566;2311;2255;97,6;30,4;19
2004;3508405;Cabreúva;36408;18581;17827;95,9;28,3;139,9
2004;3508504;Caçapava;79626;39520;40106;101,5;31,1;215,8
2004;3508603;Cachoeira Paulista;28419;14038;14381;102,4;32;98,7
2004;3508702;Caconde;18612;9397;9215;98,1;31,9;39,8
2004;3508801;Cafelândia;16129;7965;8164;102,5;33,4;17,5
2004;3508900;Caiabu;4103;2102;2001;95,2;33,2;16,2
2004;3509007;Caieiras;77179;38101;39078;102,6;29,1;790,4
2004;3509106;Caiuá;4530;2372;2158;91;32,4;8,2
2004;3509205;Cajamar;55968;28120;27848;99;28;426
2004;3509254;Cajati;29058;14884;14174;95,2;28,3;63,9
2004;3509304;Cajobi;9473;4883;4590;94;32,8;53,5
2004;3509403;Cajuru;21827;11012;10815;98,2;31,3;33,1
2004;3509452;Campina do Monte Alegre;5371;2762;2609;94,5;31,1;29,1
2004;3509502;Campinas;1013218;491796;521422;106;32,5;1275,2
2004;3509601;Campo Limpo Paulista;67785;33624;34161;101,6;29,8;853,7
2004;3509700;Campos do Jordão;45964;22711;23253;102,4;29,3;158,5
2004;3509809;Campos Novos Paulista;4307;2218;2089;94,2;32,4;8,9
2004;3509908;Cananéia;12276;6184;6092;98,5;30;9,9
2004;3509957;Canas;3904;2007;1897;94,5;29,5;73,3
2004;3510005;Cândido Mota;29582;14683;14899;101,5;32,7;49,6
2004;3510104;Cândido Rodrigues;2647;1303;1344;103,1;36,6;37,3
2004;3510153;Canitar;3884;1978;1906;96,4;28,6;67,6
2004;3510203;Capão Bonito;47058;23588;23470;99,5;29,7;28,7
2004;3510302;Capela do Alto;15592;8012;7580;94,6;29,5;91,8
2004;3510401;Capivari;44342;22122;22220;100,4;30,8;137,3
2004;3510500;Caraguatatuba;87602;43843;43759;99,8;30,3;180,6
2004;3510609;Carapicuíba;354606;173210;181396;104,7;28,6;10264,8
2004;3510708;Cardoso;11748;5811;5937;102,2;34,4;18,4
2004;3510807;Casa Branca;27415;14480;12935;89,3;33,3;31,7
2004;3510906;Cássia dos Coqueiros;2819;1455;1364;93,7;32,7;14,7
2004;3511003;Castilho;16134;8057;8077;100,2;32,1;15,1
2004;3511102;Catanduva;108642;53047;55595;104,8;34,1;373,9
2004;3511201;Catiguá;6784;3467;3317;95,7;32,5;45,7
2004;3511300;Cedral;7200;3617;3583;99,1;35,4;36,4
2004;3511409;Cerqueira César;16182;8056;8126;100,9;32;31,6
2004;3511508;Cerquilho;33450;16673;16777;100,6;31,7;261,7
2004;3511607;Cesário Lange;13896;7253;6643;91,6;31,4;73
2004;3511706;Charqueada;13849;7007;6842;97,6;30,9;78,8
2004;3511904;Clementina;6030;3121;2909;93,2;31,1;35,8
2004;3512001;Colina;16982;8480;8502;100,3;32,2;40,2
2004;3512100;Colômbia;5946;3068;2878;93,8;30;8,2
2004;3512209;Conchal;23791;12007;11784;98,1;29,5;130,2
2004;3512308;Conchas;15394;7813;7581;97;33,1;33
2004;3512407;Cordeirópolis;18940;9491;9449;99,6;31,4;137,7
2004;3512506;Coroados;4741;2377;2364;99,5;32,2;19,2
2004;3512605;Coronel Macedo;5357;2751;2606;94,7;31,1;17,6
2004;3512704;Corumbataí;3823;1979;1844;93,2;31,7;13,7
2004;3512803;Cosmópolis;50056;25059;24997;99,8;30,4;323,6
2004;3512902;Cosmorama;7337;3710;3627;97,8;36,1;16,6
2004;3513009;Cotia;169926;83743;86183;102,9;29;524,5
2004;3513108;Cravinhos;29763;15062;14701;97,6;31;95,6
2004;3513207;Cristais Paulista;6991;3598;3393;94,3;30,7;18,1
2004;3513306;Cruzália;2498;1240;1258;101,5;33,4;16,7
2004;3513405;Cruzeiro;75000;36661;38339;104,6;31,8;245,3
2004;3513504;Cubatão;112771;56589;56182;99,3;29;789,3
2004;3513603;Cunha;22791;11752;11039;93,9;31,2;16,2
2004;3513702;Descalvado;29809;14811;14998;101,3;32,9;39,5
2004;3513801;Diadema;369974;180610;189364;104,8;28,8;12038,7
2004;3513850;Dirce Reis;1646;846;800;94,6;35,3;18,7
2004;3513900;Divinolândia;11776;5959;5817;97,6;33,6;52,6
2004;3514007;Dobrada;7363;3857;3506;90,9;29,1;49,2
2004;3514106;Dois Córregos;23322;11703;11619;99,3;32,6;36,8
2004;3514205;Dolcinópolis;2127;1105;1022;92,5;35,3;27,3
2004;3514304;Dourado;8617;4400;4217;95,8;34,1;41,9
2004;3514403;Dracena;41698;20432;21266;104,1;35,2;85,5
2004;3514502;Duartina;12448;6100;6348;104,1;34,5;47,1
2004;3514601;Dumont;7056;3586;3470;96,8;30,9;63,4
2004;3514700;Echaporã;6657;3310;3347;101,1;32,1;12,9
2004;3514809;Eldorado;14423;7443;6980;93,8;28,7;8,7
2004;3514908;Elias Fausto;14670;7572;7098;93,7;29,8;72,5
2004;3514924;Elisiário;2785;1462;1323;90,5;33,8;29,6
2004;3514957;Embaúba;2460;1279;1181;92,3;33,6;29,6
2004;3515004;Embu das Artes;220481;108052;112429;104,1;27,5;3131,9
2004;3515103;Embu-Guaçu;59301;29650;29651;100;29,2;381
2004;3515129;Emilianópolis;2957;1499;1458;97,3;34,2;13,1
2004;3515152;Engenheiro Coelho;12207;6355;5852;92,1;28,2;111
2004;3515186;Espírito Santo do Pinhal;41259;20344;20915;102,8;33,4;106
2004;3515194;Espírito Santo do Turvo;3892;1995;1897;95,1;29,1;20,1
2004;3515202;Estrela d'Oeste;8292;4205;4087;97,2;34,1;28
2004;3515301;Estrela do Norte;2631;1365;1266;92,7;31,2;9,9
2004;3515350;Euclides da Cunha Paulista;9998;5054;4944;97,8;29,3;17,4
2004;3515400;Fartura;15119;7469;7650;102,4;32,6;35,2
2004;3515509;Fernandópolis;63088;30932;32156;104;34,3;114,7
2004;3515608;Fernando Prestes;5461;2699;2762;102,3;35,8;32,1
2004;3515657;Fernão;1489;761;728;95,7;33,1;14,8
2004;3515707;Ferraz de Vasconcelos;152960;75159;77801;103,5;27,7;5176,8
2004;3515806;Flora Rica;2010;1013;997;98,4;35,1;8,9
2004;3515905;Floreal;3157;1575;1582;100,4;37,5;15,5
2004;3516002;Flórida Paulista;11798;6109;5689;93,1;33,4;22,5
2004;3516101;Florínea;3024;1469;1555;105,9;32,8;13,4
2004;3516200;Franca;300696;147840;152856;103,4;31,1;496,5
2004;3516309;Francisco Morato;141983;70707;71276;100,8;26,6;2897,6
2004;3516408;Franco da Rocha;117614;60679;56935;93,8;28,7;885,8
2004;3516507;Gabriel Monteiro;2719;1393;1326;95,2;35,3;19,6
2004;3516606;Gália;7550;3813;3737;98;33,5;21,2
2004;3516705;Garça;43293;21206;22087;104,2;33,2;77,9
2004;3516804;Gastão Vidigal;3796;1961;1835;93,6;32,8;21
2004;3516853;Gavião Peixoto;4252;2244;2008;89,5;30;17,4
2004;3516903;General Salgado;10776;5457;5319;97,5;33,9;21,8
2004;3517000;Getulina;10541;5690;4851;85,3;32,8;15,6
2004;3517109;Glicério;4475;2254;2221;98,5;32,6;16,4
2004;3517208;Guaiçara;9771;4893;4878;99,7;30,9;35,3
2004;3517307;Guaimbê;5316;2655;2661;100,2;31,6;24,4
2004;3517406;Guaíra;35770;17881;17889;100;31,9;28,4
2004;3517505;Guapiaçu;15538;7878;7660;97,2;32,7;47,8
2004;3517604;Guapiara;19254;9863;9391;95,2;29,4;47,2
2004;3517703;Guará;19288;9641;9647;100,1;30,3;53,3
2004;3517802;Guaraçaí;8775;4404;4371;99,3;34,4;15,4
2004;3517901;Guaraci;9245;4706;4539;96,5;31,8;14,4
2004;3518008;Guarani d'Oeste;1986;1006;980;97,4;34,6;23,2
2004;3518107;Guarantã;6371;3232;3139;97,1;30,4;13,8
2004;3518206;Guararapes;29584;14648;14936;102;33,4;31
2004;3518305;Guararema;23577;11930;11647;97,6;30,8;87,1
2004;3518404;Guaratinguetá;107706;52314;55392;105,9;32,3;143,1
2004;3518503;Guareí;11916;6627;5289;79,8;31,1;21
2004;3518602;Guariba;32803;16580;16223;97,8;29,4;121,4
2004;3518701;Guarujá;275473;135450;140023;103,4;29,3;1902,5
2004;3518800;Guarulhos;1133171;555435;577736;104;28,9;3555,9
2004;3518859;Guatapará;6619;3415;3204;93,8;30,6;16
2004;3518909;Guzolândia;4493;2324;2169;93,3;32;17,8
2004;3519006;Herculândia;8286;4176;4110;98,4;31,9;22,7
2004;3519055;Holambra;8835;4513;4322;95,8;30,2;134,7
2004;3519071;Hortolândia;168402;84657;83745;98,9;28,6;2698,1
2004;3519105;Iacanga;8958;4566;4392;96,2;33,2;16,4
2004;3519204;Iacri;6626;3345;3281;98,1;33,2;20,6
2004;3519253;Iaras;4341;2554;1787;70;29,5;10,8
2004;3519303;Ibaté;28083;14345;13738;95,8;29,2;96,5
2004;3519402;Ibirá;9988;4927;5061;102,7;34,6;36,7
2004;3519501;Ibirarema;6095;3083;3012;97,7;32,6;26,7
2004;3519600;Ibitinga;49148;24275;24873;102,5;32,7;71,3
2004;3519709;Ibiúna;67487;34596;32891;95,1;29,7;63,8
2004;3519808;Icém;7044;3569;3475;97,4;31,7;19,4
2004;3519907;Iepê;7429;3693;3736;101,2;33,6;12,5
2004;3520004;Igaraçu do Tietê;22961;11514;11447;99,4;30,4;234,9
2004;3520103;Igarapava;26728;13185;13543;102,7;32,6;57,1
2004;3520202;Igaratá;8550;4421;4129;93,4;30,8;29,2
2004;3520301;Iguape;28227;14297;13930;97,4;31,7;14,3
2004;3520400;Ilhabela;23654;12214;11440;93,7;28,9;68,3
2004;3520426;Ilha Comprida;7581;3815;3766;98,7;32,8;38,6
2004;3520442;Ilha Solteira;24490;12033;12457;103,5;32,8;37,5
2004;3520509;Indaiatuba;168274;83895;84379;100,6;31,1;540,1
2004;3520608;Indiana;4914;2481;2433;98,1;33,2;38
2004;3520707;Indiaporã;4019;1994;2025;101,6;35,7;14,4
2004;3520806;Inúbia Paulista;3436;1744;1692;97;33,5;39,4
2004;3520905;Ipaussu;13037;6545;6492;99,2;31,8;62,2
2004;3521002;Iperó;22207;11908;10299;86,5;29,3;130,4
2004;3521101;Ipeúna;4995;2587;2408;93,1;30,5;26,3
2004;3521150;Ipiguá;3855;1972;1883;95,5;33,2;28,3
2004;3521200;Iporanga;4470;2294;2176;94,9;28,8;3,9
2004;3521309;Ipuã;12794;6525;6269;96,1;30,3;27,4
2004;3521408;Iracemápolis;17209;8665;8544;98,6;31,4;149,5
2004;3521507;Irapuã;6897;3571;3326;93,1;32,9;26,8
2004;3521606;Irapuru;7625;4058;3567;87,9;35,5;35,6
2004;3521705;Itaberá;18626;9446;9180;97,2;30,5;16,9
2004;3521804;Itaí;22215;11551;10664;92,3;30,3;20,3
2004;3521903;Itajobi;14386;7272;7114;97,8;35,1;28,7
2004;3522000;Itaju;2880;1499;1381;92,1;33,7;12,5
2004;3522109;Itanhaém;78122;38480;39642;103;31,4;129,8
2004;3522158;Itaoca;3256;1680;1576;93,8;31,5;17,8
2004;3522208;Itapecerica da Serra;139871;69495;70376;101,3;27,7;927,9
2004;3522307;Itapetininga;133457;66800;66657;99,8;30,8;74,6
2004;3522406;Itapeva;85474;42242;43232;102,3;29,4;46,8
2004;3522505;Itapevi;177402;87645;89757;102,4;26,9;2146,2
2004;3522604;Itapira;65571;32713;32858;100,4;33,7;126,5
2004;3522653;Itapirapuã Paulista;3728;1948;1780;91,4;28,5;9,2
2004;3522703;Itápolis;38787;19306;19481;100,9;33,7;38,9
2004;3522802;Itaporanga;14502;7288;7214;99;31,7;28,5
2004;3522901;Itapuí;11084;5659;5425;95,9;32;79,2
2004;3523008;Itapura;4014;2086;1928;92,4;31,7;13,3
2004;3523107;Itaquaquecetuba;292636;145385;147251;101,3;26,7;3541,9
2004;3523206;Itararé;47467;23429;24038;102,6;30,3;47,3
2004;3523305;Itariri;14366;7311;7055;96,5;28,8;52,5
2004;3523404;Itatiba;89321;44367;44954;101,3;31,7;277,2
2004;3523503;Itatinga;16467;8427;8040;95,4;29;16,8
2004;3523602;Itirapina;13955;7959;5996;75,3;31,1;24,7
2004;3523701;Itirapuã;5643;2916;2727;93,5;30,9;35
2004;3523800;Itobi;7538;3918;3620;92,4;31,8;54,2
2004;3523909;Itu;143039;71115;71924;101,1;30,8;223,2
2004;3524006;Itupeva;33216;16965;16251;95,8;29,2;165,4
2004;3524105;Ituverava;37363;18380;18983;103,3;32,9;53
2004;3524204;Jaborandi;6486;3314;3172;95,7;32,3;23,7
2004;3524303;Jaboticabal;69386;33901;35485;104,7;32,9;98,2
2004;3524402;Jacareí;199573;98249;101324;103,1;31;429,9
2004;3524501;Jaci;4729;2438;2291;94;31,6;32,6
2004;3524600;Jacupiranga;17149;8766;8383;95,6;29,8;24,4
2004;3524709;Jaguariúna;35282;17700;17582;99,3;31,1;249,5
2004;3524808;Jales;46641;22987;23654;102,9;34,1;126,5
2004;3524907;Jambeiro;4559;2374;2185;92;31,4;24,7
2004;3525003;Jandira;98705;48752;49953;102,5;27,5;5656,7
2004;3525102;Jardinópolis;33396;16826;16570;98,5;31,1;66,5
2004;3525201;Jarinu;19696;10084;9612;95,3;30,1;94,9
2004;3525300;Jaú;119588;58926;60662;102,9;33,1;174
2004;3525409;Jeriquara;3253;1702;1551;91,1;29,8;22,9
2004;3525508;Joanópolis;10952;5564;5388;96,8;33,1;29,3
2004;3525607;João Ramalho;3955;2001;1954;97,7;30,2;9,5
2004;3525706;José Bonifácio;30397;15204;15193;99,9;32,3;35,3
2004;3525805;Júlio Mesquita;4320;2130;2190;102,8;31,6;33,7
2004;3525854;Jumirim;2436;1276;1160;90,9;31,9;43
2004;3525904;Jundiaí;342148;167299;174849;104,5;33,3;793,5
2004;3526001;Junqueirópolis;17701;9311;8390;90,1;35;30,4
2004;3526100;Juquiá;20232;10321;9911;96;30;24,9
2004;3526209;Juquitiba;27611;13934;13677;98,2;28,6;52,9
2004;3526308;Lagoinha;4913;2541;2372;93,3;33,7;19,2
2004;3526407;Laranjal Paulista;23424;11640;11784;101,2;33,1;61
2004;3526506;Lavínia;6583;3753;2830;75,4;33,6;12,2
2004;3526605;Lavrinhas;6229;3168;3061;96,6;28,8;37,3
2004;3526704;Leme;85242;42971;42271;98,4;30,6;211,6
2004;3526803;Lençóis Paulista;57751;28831;28920;100,3;30,8;71,3
2004;3526902;Limeira;260011;128607;131404;102,2;31,8;447,7
2004;3527009;Lindóia;5861;2937;2924;99,6;33,1;120,2
2004;3527108;Lins;68295;33142;35153;106,1;33,7;119,8
2004;3527207;Lorena;79906;38794;41112;106;31,6;192,9
2004;3527256;Lourdes;2050;1066;984;92,3;34;18
2004;3527306;Louveira;28805;14596;14209;97,3;29,5;516,8
2004;3527405;Lucélia;19003;9932;9071;91,3;33,6;60,4
2004;3527504;Lucianópolis;2216;1134;1082;95,4;32,6;11,7
2004;3527603;Luís Antônio;8761;4503;4258;94,6;28,3;14,6
2004;3527702;Luiziânia;4552;2317;2235;96,5;32,9;27,3
2004;3527801;Lupércio;4287;2132;2155;101,1;31,1;27,6
2004;3527900;Lutécia;2837;1435;1402;97,7;33;6
2004;3528007;Macatuba;16014;8051;7963;98,9;30,5;71,3
2004;3528106;Macaubal;7467;3796;3671;96,7;35,6;30,1
2004;3528205;Macedônia;3744;1890;1854;98,1;34,7;11,4
2004;3528304;Magda;3332;1724;1608;93,3;35,1;10,7
2004;3528403;Mairinque;41241;20614;20627;100,1;29,7;196,2
2004;3528502;Mairiporã;68326;34445;33881;98,4;30,2;213,1
2004;3528601;Manduri;8563;4346;4217;97;32,7;37,4
2004;3528700;Marabá Paulista;4150;2315;1835;79,3;31,7;4,5
2004;3528809;Maracaí;13151;6657;6494;97,6;31,9;24,7
2004;3528858;Marapoama;2403;1225;1178;96,2;33,9;21,6
2004;3528908;Mariápolis;3880;1992;1888;94,8;34,1;20,8
2004;3529005;Marília;205464;100052;105412;105,4;32,7;175,5
2004;3529104;Marinópolis;2190;1118;1072;95,9;32,8;28,1
2004;3529203;Martinópolis;23101;11912;11189;93,9;32,8;18,4
2004;3529302;Matão;74061;36909;37152;100,7;31,7;141,1
2004;3529401;Mauá;386061;189692;196369;103,5;29,1;6233,1
2004;3529500;Mendonça;4110;2102;2008;95,5;35,2;21,1
2004;3529609;Meridiano;3981;2008;1973;98,3;34,1;17,4
2004;3529658;Mesópolis;1921;988;933;94,4;33,7;12,9
2004;3529708;Miguelópolis;19597;9824;9773;99,5;30,8;23,9
2004;3529807;Mineiros do Tietê;11704;5868;5836;99,5;31,6;54,9
2004;3529906;Miracatu;21843;11190;10653;95,2;28,8;21,8
2004;3530003;Mira Estrela;2708;1389;1319;95;34,6;12,5
2004;3530102;Mirandópolis;26565;14297;12268;85,8;34,4;28,9
2004;3530201;Mirante do Paranapanema;16592;8451;8141;96,3;32,9;13,4
2004;3530300;Mirassol;50499;24879;25620;103;33,3;207,6
2004;3530409;Mirassolândia;3951;2024;1927;95,2;33,3;23,8
2004;3530508;Mococa;66173;33233;32940;99,1;32,7;77,4
2004;3530607;Mogi das Cruzes;353492;173386;180106;103,9;30,2;496,1
2004;3530706;Mogi Guaçu;129720;64884;64836;99,9;31,6;159,6
2004;3530805;Mogi Mirim;83507;41506;42001;101,2;32,7;167,8
2004;3530904;Mombuca;3177;1623;1554;95,7;30,1;23,8
2004;3531001;Monções;2095;1074;1021;95,1;35,9;20,1
2004;3531100;Mongaguá;39500;20057;19443;96,9;31,7;276,7
2004;3531209;Monte Alegre do Sul;6641;3354;3287;98;34,5;60,2
2004;3531308;Monte Alto;44917;22355;22562;100,9;33,7;129,5
2004;3531407;Monte Aprazível;19687;9772;9915;101,5;35,2;39,7
2004;3531506;Monte Azul Paulista;19427;9786;9641;98,5;32,4;73,7
2004;3531605;Monte Castelo;4087;2051;2036;99,3;35,4;17,5
2004;3531704;Monteiro Lobato;3819;1977;1842;93,2;32,1;11,5
2004;3531803;Monte Mor;41946;21049;20897;99,3;29,2;174,4
2004;3531902;Morro Agudo;26845;13715;13130;95,7;29,4;19,3
2004;3532009;Morungaba;10667;5376;5291;98,4;30,9;72,7
2004;3532058;Motuca;4036;2065;1971;95,4;30,6;17,6
2004;3532108;Murutinga do Sul;4065;2052;2013;98,1;36,6;16,2
2004;3532157;Nantes;2463;1249;1214;97,2;29,7;8,6
2004;3532207;Narandiba;3973;2012;1961;97,5;30,6;11,1
2004;3532306;Natividade da Serra;6869;3611;3258;90,2;33,6;8,2
2004;3532405;Nazaré Paulista;15266;7873;7393;93,9;31,8;46,8
2004;3532504;Neves Paulista;8876;4450;4426;99,5;36,1;40,5
2004;3532603;Nhandeara;10445;5142;5303;103,1;36,5;23,9
2004;3532702;Nipoã;3626;1886;1740;92,3;32,6;26,3
2004;3532801;Nova Aliança;5213;2589;2624;101,4;34,9;24
2004;3532827;Nova Campina;7814;4043;3771;93,3;26,6;20,3
2004;3532843;Nova Canaã Paulista;2354;1215;1139;93,7;37,3;18,9
2004;3532868;Nova Castilho;1033;527;506;96;33,3;5,6
2004;3532900;Nova Europa;8012;4043;3969;98,2;30,8;50
2004;3533007;Nova Granada;17868;8980;8888;99;32,8;33,6
2004;3533106;Nova Guataporanga;2134;1091;1043;95,6;35,8;62,5
2004;3533205;Nova Independência;2450;1234;1216;98,5;32,4;9,2
2004;3533254;Novais;3731;1970;1761;89,4;30,6;31,7
2004;3533304;Nova Luzitânia;3006;1578;1428;90,5;32,2;40,7
2004;3533403;Nova Odessa;45850;22725;23125;101,8;31,5;621,4
2004;3533502;Novo Horizonte;34119;16981;17138;100,9;33,6;36,6
2004;3533601;Nuporanga;6521;3293;3228;98;32,8;18,7
2004;3533700;Ocauçu;4180;2165;2015;93,1;32,5;13,9
2004;3533809;Óleo;2867;1458;1409;96,6;34,1;14,4
2004;3533908;Olímpia;47662;23581;24081;102,1;33,4;59,4
2004;3534005;Onda Verde;3621;1850;1771;95,7;31,4;14,9
2004;3534104;Oriente;5996;2957;3039;102,8;34;27,4
2004;3534203;Orindiúva;4723;2424;2299;94,8;29,5;19,1
2004;3534302;Orlândia;37643;18591;19052;102,5;31,8;129
2004;3534401;Osasco;659988;319786;340202;106,4;30,2;10160,8
2004;3534500;Oscar Bressane;2537;1226;1311;106,9;35,8;11,4
2004;3534609;Osvaldo Cruz;30292;15050;15242;101,3;35,1;122,1
2004;3534708;Ourinhos;97690;47748;49942;104,6;32,2;330,2
2004;3534757;Ouroeste;7098;3555;3543;99,7;32,9;24,6
2004;3534807;Ouro Verde;7431;3711;3720;100,2;32,1;27,9
2004;3534906;Pacaembu;12837;7087;5750;81,1;34,9;37,8
2004;3535002;Palestina;9829;4920;4909;99,8;35,4;14,1
2004;3535101;Palmares Paulista;9408;4887;4521;92,5;28,7;114,6
2004;3535200;Palmeira d'Oeste;10099;5109;4990;97,7;35,5;31,7
2004;3535309;Palmital;20957;10327;10630;102,9;34,4;38,2
2004;3535408;Panorama;14055;7120;6935;97,4;30,5;39,5
2004;3535507;Paraguaçu Paulista;40827;20346;20481;100,7;31,8;40,8
2004;3535606;Paraibuna;17261;8816;8445;95,8;31,1;21,3
2004;3535705;Paraíso;5614;2896;2718;93,9;32,9;36,2
2004;3535804;Paranapanema;16472;8495;7977;93,9;29,7;16,2
2004;3535903;Paranapuã;3732;1902;1830;96,2;33,9;26,6
2004;3536000;Parapuã;11060;5631;5429;96,4;34,6;30,2
2004;3536109;Pardinho;5068;2613;2455;94;30,4;24,1
2004;3536208;Pariquera-Açu;18006;9013;8993;99,8;30,2;50,1
2004;3536257;Parisi;1988;1031;957;92,8;34,9;23,5
2004;3536307;Patrocínio Paulista;12009;6124;5885;96,1;31,1;19,9
2004;3536406;Paulicéia;5739;2985;2754;92,3;30,3;15,3
2004;3536505;Paulínia;63136;31481;31655;100,6;30,1;454,9
2004;3536570;Paulistânia;1793;946;847;89,5;31,8;7
2004;3536604;Paulo de Faria;8553;4277;4276;100;32,4;11,6
2004;3536703;Pederneiras;38599;19455;19144;98,4;31,1;53,1
2004;3536802;Pedra Bela;5666;2983;2683;89,9;33;35,7
2004;3536901;Pedranópolis;2673;1374;1299;94,5;35,7;10,3
2004;3537008;Pedregulho;15323;7819;7504;96;30,8;21,5
2004;3537107;Pedreira;37833;18763;19070;101,6;32,1;347,7
2004;3537156;Pedrinhas Paulista;2900;1458;1442;98,9;32,5;19
2004;3537206;Pedro de Toledo;9625;4890;4735;96,8;30,4;14,4
2004;3537305;Penápolis;56280;27499;28781;104,7;33,6;79,1
2004;3537404;Pereira Barreto;25049;12355;12694;102,7;32,8;25,7
2004;3537503;Pereiras;6664;3403;3261;95,8;33,1;29,9
2004;3537602;Peruíbe;54901;27139;27762;102,3;31,5;168,3
2004;3537701;Piacatu;4882;2460;2422;98,5;33,4;21
2004;3537800;Piedade;51204;26567;24637;92,7;31,1;68,6
2004;3537909;Pilar do Sul;25053;12845;12208;95;30;36,8
2004;3538006;Pindamonhangaba;134803;66893;67910;101,5;30,2;184,3
2004;3538105;Pindorama;13898;7073;6825;96,5;34,6;75,2
2004;3538204;Pinhalzinho;11824;6058;5766;95,2;33,5;76,5
2004;3538303;Piquerobi;3503;1762;1741;98,8;33,8;7,3
2004;3538501;Piquete;14808;7204;7604;105,6;33,1;84,1
2004;3538600;Piracaia;24130;12165;11965;98,4;31,9;62,6
2004;3538709;Piracicaba;343710;169066;174644;103,3;32,3;249,4
2004;3538808;Piraju;28364;13853;14511;104,7;33,2;56,2
2004;3538907;Pirajuí;21218;11481;9737;84,8;33,4;25,8
2004;3539004;Pirangi;10290;5255;5035;95,8;34,6;47,7
2004;3539103;Pirapora do Bom Jesus;13745;6867;6878;100,2;27,3;126,7
2004;3539202;Pirapozinho;23266;11390;11876;104,3;32;48,7
2004;3539301;Pirassununga;67050;32977;34073;103,3;33,2;92,2
2004;3539400;Piratininga;11212;5625;5587;99,3;33,3;27,9
2004;3539509;Pitangueiras;32897;16829;16068;95,5;29,4;76,4
2004;3539608;Planalto;3978;2040;1938;95;31,6;13,7
2004;3539707;Platina;3002;1567;1435;91,6;31,6;9,2
2004;3539806;Poá;99738;48668;51070;104,9;29,3;5777,3
2004;3539905;Poloni;4992;2446;2546;104,1;36,3;36,9
2004;3540002;Pompéia;18949;9363;9586;102,4;32,9;24,1
2004;3540101;Pongaí;3616;1876;1740;92,8;35,5;19,7
2004;3540200;Pontal;33685;17326;16359;94,4;28,3;94,5
2004;3540259;Pontalinda;3750;1972;1778;90,2;31,3;17,9
2004;3540309;Pontes Gestal;2522;1257;1265;100,6;34,2;11,6
2004;3540408;Populina;4358;2234;2124;95,1;34,7;13,8
2004;3540507;Porangaba;7342;3846;3496;90,9;33,5;27,6
2004;3540606;Porto Feliz;47005;23589;23416;99,3;31,3;84,4
2004;3540705;Porto Ferreira;49002;24387;24615;100,9;32,1;200,1
2004;3540754;Potim;15901;8403;7498;89,2;28,2;356,2
2004;3540804;Potirendaba;14340;7334;7006;95,5;35;41,9
2004;3540853;Pracinha;2004;1174;830;70,7;32,8;31,8
2004;3540903;Pradópolis;14580;7419;7161;96,5;30,3;87,1
2004;3541000;Praia Grande;220340;106988;113352;105,9;31,2;1472,4
2004;3541059;Pratânia;4227;2197;2030;92,4;29,7;24,1
2004;3541109;Presidente Alves;4231;2121;2110;99,5;32,9;14,8
2004;3541208;Presidente Bernardes;14349;7317;7032;96,1;34,7;19,2
2004;3541307;Presidente Epitácio;40208;19887;20321;102,2;31,3;31,9
2004;3541406;Presidente Prudente;196965;95316;101649;106,6;32,9;351,3
2004;3541505;Presidente Venceslau;37754;18887;18867;99,9;33,8;50
2004;3541604;Promissão;32929;16534;16395;99,2;32,2;42,3
2004;3541653;Quadra;2863;1509;1354;89,7;32,7;13,9
2004;3541703;Quatá;12070;6009;6061;100,9;31,5;18,5
2004;3541802;Queiroz;2445;1249;1196;95,8;30,7;10,4
2004;3541901;Queluz;10036;5026;5010;99,7;30,3;40,2
2004;3542008;Quintana;5658;2836;2822;99,5;32,8;17,7
2004;3542107;Rafard;8491;4234;4257;100,5;31,8;69,8
2004;3542206;Rancharia;28948;14311;14637;102,3;32,5;18,2
2004;3542305;Redenção da Serra;3966;2111;1855;87,9;32,8;12,8
2004;3542404;Regente Feijó;17621;8796;8825;100,3;32,7;66,9
2004;3542503;Reginópolis;5778;3184;2594;81,5;33,2;14,1
2004;3542602;Registro;54357;26976;27381;101,5;30;75,3
2004;3542701;Restinga;5992;3033;2959;97,6;28,9;24,4
2004;3542800;Ribeira;3480;1818;1662;91,4;32;10,4
2004;3542909;Ribeirão Bonito;11609;5869;5740;97,8;31,2;24,6
2004;3543006;Ribeirão Branco;20441;10616;9825;92,5;26,8;29,3
2004;3543105;Ribeirão Corrente;4032;2118;1914;90,4;29,9;27,2
2004;3543204;Ribeirão do Sul;4477;2269;2208;97,3;33,4;22
2004;3543238;Ribeirão dos Índios;2214;1124;1090;97;35,2;11,3
2004;3543253;Ribeirão Grande;7428;3821;3607;94,4;29,9;22,3
2004;3543303;Ribeirão Pires;108374;53363;55011;103,1;31,1;1095
2004;3543402;Ribeirão Preto;544897;261978;282919;108;32,6;837,1
2004;3543501;Riversul;6844;3452;3392;98,3;32,3;17,7
2004;3543600;Rifaina;3390;1720;1670;97,1;33,2;20,9
2004;3543709;Rincão;10415;5260;5155;98;30,7;32,9
2004;3543808;Rinópolis;10122;5172;4950;95,7;35,2;28,2
2004;3543907;Rio Claro;175256;85542;89714;104,9;33,1;351,6
2004;3544004;Rio das Pedras;25792;13096;12696;96,9;30,1;113,8
2004;3544103;Rio Grande da Serra;39942;19864;20078;101,1;28,2;1099,1
2004;3544202;Riolândia;9292;5227;4065;77,8;31,4;14,7
2004;3544251;Rosana;22635;11414;11221;98,3;28,9;30,4
2004;3544301;Roseira;8972;4559;4413;96,8;29,9;69,1
2004;3544400;Rubiácea;2471;1259;1212;96,3;31,8;10,4
2004;3544509;Rubinéia;2722;1342;1380;102,8;35,7;11,2
2004;3544608;Sabino;4998;2502;2496;99,8;34,1;16,4
2004;3544707;Sagres;2417;1222;1195;97,8;32,9;16,3
2004;3544806;Sales;4906;2503;2403;96;33,3;15,9
2004;3544905;Sales Oliveira;9787;4888;4899;100,2;32,6;32
2004;3545001;Salesópolis;14904;7545;7359;97,5;30,9;35,1
2004;3545100;Salmourão;4576;2339;2237;95,6;33,1;26,5
2004;3545159;Saltinho;6260;3144;3116;99,1;33,4;62,8
2004;3545209;Salto;98192;48901;49291;100,8;30,8;738
2004;3545308;Salto de Pirapora;37157;18580;18577;100;30,4;132,5
2004;3545407;Salto Grande;8635;4318;4317;100;32,8;45,8
2004;3545506;Sandovalina;3334;1671;1663;99,5;29,6;7,3
2004;3545605;Santa Adélia;13838;6960;6878;98,8;33;41,9
2004;3545704;Santa Albertina;5674;2863;2811;98,2;36,4;20,8
2004;3545803;Santa Bárbara d'Oeste;174227;86845;87382;100,6;31,4;642,8
2004;3546009;Santa Branca;13354;6725;6629;98,6;31,8;49,1
2004;3546108;Santa Clara d'Oeste;2118;1073;1045;97,4;34,9;11,5
2004;3546207;Santa Cruz da Conceição;3718;1878;1840;98;33,6;24,8
2004;3546256;Santa Cruz da Esperança;1877;948;929;98;31,6;12,7
2004;3546306;Santa Cruz das Palmeiras;27278;13820;13458;97,4;30,9;92,4
2004;3546405;Santa Cruz do Rio Pardo;42205;20817;21388;102,7;32,8;37,9
2004;3546504;Santa Ernestina;5685;3022;2663;88,1;29,5;42,3
2004;3546603;Santa Fé do Sul;27694;13431;14263;106,2;34,6;134,1
2004;3546702;Santa Gertrudes;18115;9212;8903;96,6;29,7;184,3
2004;3546801;Santa Isabel;46612;23468;23144;98,6;30,2;128,3
2004;3546900;Santa Lúcia;7987;4074;3913;96;29,5;51,9
2004;3547007;Santa Maria da Serra;4945;2552;2393;93,8;30,3;19,6
2004;3547106;Santa Mercedes;2834;1429;1405;98,3;33,3;17
2004;3547205;Santana da Ponte Pensa;1795;916;879;96;37,8;13,8
2004;3547304;Santana de Parnaíba;87726;43581;44145;101,3;28,4;487,5
2004;3547403;Santa Rita d'Oeste;2659;1338;1321;98,7;37,5;12,7
2004;3547502;Santa Rita do Passa Quatro;26355;12815;13540;105,7;35,9;34,9
2004;3547601;Santa Rosa de Viterbo;22383;11122;11261;101,2;32,6;77,6
2004;3547650;Santa Salete;1417;734;683;93,1;37,3;17,9
2004;3547700;Santo Anastácio;20724;10133;10591;104,5;33,8;37,5
2004;3547809;Santo André;661589;318944;342645;107,4;33,3;3763,7
2004;3547908;Santo Antônio da Alegria;6012;3123;2889;92,5;33,1;19,4
2004;3548005;Santo Antônio de Posse;19148;9649;9499;98,4;30,9;124,2
2004;3548054;Santo Antônio do Aracanguá;7223;3728;3495;93,8;31,4;5,5
2004;3548104;Santo Antônio do Jardim;6089;3162;2927;92,6;33,2;55,4
2004;3548203;Santo Antônio do Pinhal;6406;3268;3138;96;30,7;48,2
2004;3548302;Santo Expedito;2626;1340;1286;96;34,2;27,8
2004;3548401;Santópolis do Aguapeí;3984;2021;1963;97,1;31,1;31,1
2004;3548500;Santos;419348;193179;226169;117,1;36,8;1492,2
2004;3548609;São Bento do Sapucaí;10438;5272;5166;98;33,2;41,3
2004;3548708;São Bernardo do Campo;728366;353550;374816;106;31;1778,5
2004;3548807;São Caetano do Sul;143752;66893;76859;114,9;37,5;9376,7
2004;3548906;São Carlos;204515;100953;103562;102,6;32,9;179,9
2004;3549003;São Francisco;2854;1439;1415;98,3;35;37,8
2004;3549102;São João da Boa Vista;80077;39173;40904;104,4;33,9;155,1
2004;3549201;São João das Duas Pontes;2639;1341;1298;96,8;33,3;20,4
2004;3549250;São João de Iracema;1721;874;847;96,9;33,4;9,6
2004;3549300;São João do Pau d'Alho;2163;1094;1069;97,7;36,7;18,4
2004;3549409;São Joaquim da Barra;43580;21445;22135;103,2;32,1;106,1
2004;3549508;São José da Bela Vista;8242;4217;4025;95,4;29,6;29,8
2004;3549607;São José do Barreiro;4126;2119;2007;94,7;31,7;7,2
2004;3549706;São José do Rio Pardo;51053;25241;25812;102,3;33,1;121,6
2004;3549805;São José do Rio Preto;378289;182529;195760;107,2;33,6;875,8
2004;3549904;São José dos Campos;575337;283482;291855;103;30,3;523,3
2004;3549953;São Lourenço da Serra;12968;6582;6386;97;29,4;69,5
2004;3550001;São Luiz do Paraitinga;10476;5408;5068;93,7;33,1;17
2004;3550100;São Manuel;37435;18483;18952;102,5;31,9;57,5
2004;3550209;São Miguel Arcanjo;31157;15908;15249;95,9;29,5;33,5
2004;3550308;São Paulo;10782296;5127759;5654537;110,3;32;7088
2004;3550407;São Pedro;29432;14448;14984;103,7;33,2;48,1
2004;3550506;São Pedro do Turvo;7037;3572;3465;97;31,8;9,6
2004;3550605;São Roque;71852;35618;36234;101,7;31,9;234,1
2004;3550704;São Sebastião;64212;32355;31857;98,5;28,9;159,6
2004;3550803;São Sebastião da Grama;12399;6321;6078;96,2;32,2;49,1
2004;3550902;São Simão;13988;6938;7050;101,6;32,7;22,7
2004;3551009;São Vicente;315318;152434;162884;106,9;31;2128,4
2004;3551108;Sarapuí;8340;4305;4035;93,7;30,9;23,7
2004;3551207;Sarutaiá;3679;1852;1827;98,7;32;26
2004;3551306;Sebastianópolis do Sul;2724;1388;1336;96,3;35,3;16,2
2004;3551405;Serra Azul;8965;4891;4074;83,3;30;31,7
2004;3551504;Serrana;35062;17627;17435;98,9;28,6;278,2
2004;3551603;Serra Negra;24894;12231;12663;103,5;34,8;122,2
2004;3551702;Sertãozinho;100776;50406;50370;99,9;30,8;250
2004;3551801;Sete Barras;13520;7026;6494;92,4;29,7;12,7
2004;3551900;Severínia;14363;7466;6897;92,4;29,8;102,3
2004;3552007;Silveiras;5572;2844;2728;95,9;31,3;13,4
2004;3552106;Socorro;34331;17107;17224;100,7;34,8;76,5
2004;3552205;Sorocaba;531040;260752;270288;103,7;31,3;1180,4
2004;3552304;Sud Mennucci;7380;3748;3632;96,9;31,3;12,4
2004;3552403;Sumaré;213842;106941;106901;100;29,3;1393,4
2004;3552502;Suzano;242655;119762;122893;102,6;28,8;1176,6
2004;3552551;Suzanápolis;3021;1559;1462;93,8;33,2;9,1
2004;3552601;Tabapuã;10821;5470;5351;97,8;34,4;31,3
2004;3552700;Tabatinga;13732;7012;6720;95,8;31,6;37,3
2004;3552809;Taboão da Serra;216763;104297;112466;107,8;28,8;10632
2004;3552908;Taciba;5438;2747;2691;98;31,7;9
2004;3553005;Taguaí;8745;4392;4353;99,1;30,6;60,2
2004;3553104;Taiaçu;5744;2908;2836;97,5;32,3;53,7
2004;3553203;Taiúva;5522;2759;2763;100,1;34,6;41,7
2004;3553302;Tambaú;22437;11287;11150;98,8;32,2;39,9
2004;3553401;Tanabi;23221;11554;11667;101;34,7;31,1
2004;3553500;Tapiraí;8420;4303;4117;95,7;29,2;11,2
2004;3553609;Tapiratiba;12917;6425;6492;101;31,8;58,2
2004;3553658;Taquaral;2733;1396;1337;95,8;32,1;50,7
2004;3553708;Taquaritinga;52979;26556;26423;99,5;32,5;89,1
2004;3553807;Taquarituba;22175;11103;11072;99,7;31,2;49,4
2004;3553856;Taquarivaí;4781;2426;2355;97,1;27,1;20,6
2004;3553906;Tarabai;6117;3088;3029;98,1;30,6;30,4
2004;3553955;Tarumã;11560;5917;5643;95,4;29,8;38,2
2004;3554003;Tatuí;99059;49194;49865;101,4;31,1;189,1
2004;3554102;Taubaté;258182;127026;131156;103,3;31,5;413,1
2004;3554201;Tejupá;5164;2687;2477;92,2;29,3;17,4
2004;3554300;Teodoro Sampaio;20682;10356;10326;99,7;29,7;13,3
2004;3554409;Terra Roxa;8028;4088;3940;96,4;32;36,2
2004;3554508;Tietê;33719;16730;16989;101,5;32,6;83,4
2004;3554607;Timburi;2708;1394;1314;94,3;34,2;13,8
2004;3554656;Torre de Pedra;2186;1134;1052;92,8;34,3;30,6
2004;3554706;Torrinha;9022;4566;4456;97,6;34,1;28,6
2004;3554755;Trabiju;1448;738;710;96,2;31;22,8
2004;3554805;Tremembé;37302;19542;17760;90,9;30,6;195,2
2004;3554904;Três Fronteiras;5300;2663;2637;99;35,4;35
2004;3554953;Tuiuti;5331;2737;2594;94,8;34,4;42,1
2004;3555000;Tupã;63677;30958;32719;105,7;34,9;101,4
2004;3555109;Tupi Paulista;13752;6978;6774;97,1;36,9;56,2
2004;3555208;Turiúba;1906;988;918;92,9;36,6;12,4
2004;3555307;Turmalina;2225;1108;1117;100,8;36,9;15,1
2004;3555356;Ubarana;4665;2416;2249;93,1;29,6;22,2
2004;3555406;Ubatuba;71857;36152;35705;98,8;29;101,5
2004;3555505;Ubirajara;4239;2184;2055;94,1;32,2;15
2004;3555604;Uchoa;9213;4610;4603;99,8;34,9;36,5
2004;3555703;União Paulista;1460;759;701;92,4;33,7;18,5
2004;3555802;Urânia;8886;4435;4451;100,4;35;42,5
2004;3555901;Uru;1342;701;641;91,4;34,8;9,1
2004;3556008;Urupês;12229;6133;6096;99,4;35,4;37,8
2004;3556107;Valentim Gentil;9541;4832;4709;97,5;32,4;63,7
2004;3556206;Valinhos;92360;45869;46491;101,4;32,8;621,8
2004;3556305;Valparaíso;20113;10735;9378;87,4;31,4;23,5
2004;3556354;Vargem;7702;3958;3744;94,6;32,9;54
2004;3556404;Vargem Grande do Sul;37478;18664;18814;100,8;32,2;140,3
2004;3556453;Vargem Grande Paulista;36655;18307;18348;100,2;28,8;862,7
2004;3556503;Várzea Paulista;98400;49298;49102;99,6;28,8;2801,8
2004;3556602;Vera Cruz;11013;5457;5556;101,8;33,6;44,5
2004;3556701;Vinhedo;53561;26619;26942;101,2;32,2;661,7
2004;3556800;Viradouro;16496;8341;8155;97,8;31,5;75,8
2004;3556909;Vista Alegre do Alto;5573;2827;2746;97,1;32,1;58,4
2004;3556958;Vitória Brasil;1705;877;828;94,4;33,2;34,2
2004;3557006;Votorantim;101328;50491;50837;100,7;29,9;550,1
2004;3557105;Votuporanga;79362;38875;40487;104,1;34,1;188,6
2004;3557154;Zacarias;2104;1077;1027;95,4;33,9;6,6
2004;3557204;Chavantes;12178;6070;6108;100,6;31,7;64,5
2004;3557303;Estiva Gerbi;9339;4778;4561;95,5;30,4;126
2005;3500105;Adamantina;33764;16426;17338;105,6;35,7;82
2005;3500204;Adolfo;3644;1846;1798;97,4;34,3;17,3
2005;3500303;Aguaí;30184;15178;15006;98,9;31,6;63,6
2005;3500402;Águas da Prata;7330;3657;3673;100,4;35,9;51,4
2005;3500501;Águas de Lindóia;16698;8231;8467;102,9;33,8;277,7
2005;3500550;Águas de Santa Bárbara;5428;2721;2707;99,5;33;13,4
2005;3500600;Águas de São Pedro;2287;1057;1230;116,4;39,5;633,1
2005;3500709;Agudos;33580;16654;16926;101,6;31;34,7
2005;3500758;Alambari;4256;2170;2086;96,1;30,7;26,7
2005;3500808;Alfredo Marcondes;3811;1942;1869;96,2;36,3;32
2005;3500907;Altair;3656;1954;1702;87,1;30,5;11,7
2005;3501004;Altinópolis;15672;7881;7791;98,9;33,1;16,9
2005;3501103;Alto Alegre;4187;2168;2019;93,1;36,5;13,1
2005;3501152;Alumínio;16140;8147;7993;98,1;29,3;193
2005;3501202;Álvares Florence;4125;2133;1992;93,4;37,5;11,4
2005;3501301;Álvares Machado;23261;11609;11652;100,4;32,2;66,9
2005;3501400;Álvaro de Carvalho;4375;2691;1684;62,6;31,2;28,5
2005;3501509;Alvinlândia;2918;1460;1458;99,9;31,6;34,4
2005;3501608;Americana;196838;96905;99933;103,1;33,5;1469,9
2005;3501707;Américo Brasiliense;31251;15822;15429;97,5;29,1;254,2
2005;3501806;Américo de Campos;5662;2838;2824;99,5;35,5;22,4
2005;3501905;Amparo;63268;31377;31891;101,6;33,9;142,1
2005;3502002;Analândia;3923;2022;1901;94;32,6;12
2005;3502101;Andradina;55433;27299;28134;103,1;34,2;57,5
2005;3502200;Angatuba;20828;10638;10190;95,8;31,8;20,3
2005;3502309;Anhembi;5055;2605;2450;94;31,4;6,9
2005;3502408;Anhumas;3576;1807;1769;97,9;32,5;11,1
2005;3502507;Aparecida;34872;16982;17890;105,3;32,2;288,5
2005;3502606;Aparecida d'Oeste;4720;2324;2396;103,1;36;26,4
2005;3502705;Apiaí;26447;13281;13166;99,1;29,1;27,1
2005;3502754;Araçariguama;14017;7173;6844;95,4;28,3;96,5
2005;3502804;Araçatuba;175829;84865;90964;107,2;34;150,7
2005;3502903;Araçoiaba da Serra;23503;11785;11718;99,4;32,2;92,1
2005;3503000;Aramina;4944;2504;2440;97,4;33,6;24,4
2005;3503109;Arandu;6175;3129;3046;97,3;30,8;21,6
2005;3503158;Arapeí;2550;1274;1276;100,2;32,6;16,3
2005;3503208;Araraquara;195328;94644;100684;106,4;34;194,6
2005;3503307;Araras;111305;55319;55986;101,2;32,7;172,6
2005;3503356;Arco-Íris;2055;1062;993;93,5;34,9;7,8
2005;3503406;Arealva;7566;3872;3694;95,4;35,6;14,9
2005;3503505;Areias;3668;1836;1832;99,8;30,8;12
2005;3503604;Areiópolis;10501;5413;5088;94;28,6;122,2
2005;3503703;Ariranha;8011;4094;3917;95,7;33,4;60,4
2005;3503802;Artur Nogueira;38633;19352;19281;99,6;30,3;217
2005;3503901;Arujá;67010;33265;33745;101,4;29,1;696,8
2005;3503950;Aspásia;1843;939;904;96,3;35,3;26,6
2005;3504008;Assis;91184;44380;46804;105,5;33,9;198
2005;3504107;Atibaia;119342;59039;60303;102,1;32,1;249,4
2005;3504206;Auriflama;13935;6997;6938;99,2;34,1;32,1
2005;3504305;Avaí;4777;2450;2327;95;31,8;8,8
2005;3504404;Avanhandava;10045;5257;4788;91,1;30,6;29,7
2005;3504503;Avaré;79708;39699;40009;100,8;32,3;65,7
2005;3504602;Bady Bassitt;13057;6537;6520;99,7;32,4;118,3
2005;3504701;Balbinos;2506;1626;880;54,1;33,7;27,3
2005;3504800;Bálsamo;7743;3829;3914;102,2;35,4;51,7
2005;3504909;Bananal;10007;4965;5042;101,6;32,7;16,2
2005;3505005;Barão de Antonina;2960;1515;1445;95,4;33,1;19,3
2005;3505104;Barbosa;6233;3141;3092;98,4;31,7;30,4
2005;3505203;Bariri;29965;15011;14954;99,6;34,2;67,4
2005;3505302;Barra Bonita;35480;17559;17921;102,1;33,7;236,3
2005;3505351;Barra do Chapéu;5075;2709;2366;87,3;29,5;12,5
2005;3505401;Barra do Turvo;7977;4191;3786;90,3;29,7;7,9
2005;3505500;Barretos;107919;52392;55527;106;33,4;68,9
2005;3505609;Barrinha;26287;13279;13008;98;28,2;180
2005;3505708;Barueri;224616;110178;114438;103,9;28,4;3418,8
2005;3505807;Bastos;20658;10211;10447;102,3;32;120,9
2005;3505906;Batatais;53857;26587;27270;102,6;33,3;63,4
2005;3506003;Bauru;330750;161020;169730;105,4;32,9;495,4
2005;3506102;Bebedouro;75211;36869;38342;104;33;110,1
2005;3506201;Bento de Abreu;2511;1280;1231;96,2;32,4;8,3
2005;3506300;Bernardino de Campos;10790;5304;5486;103,4;34,7;44,2
2005;3506359;Bertioga;38500;19585;18915;96,6;28,3;78,3
2005;3506409;Bilac;6607;3270;3337;102;35,4;41,8
2005;3506508;Birigui;101458;49770;51688;103,9;33;191,4
2005;3506607;Biritiba Mirim;26630;13475;13155;97,6;30;83,9
2005;3506706;Boa Esperança do Sul;13148;6654;6494;97,6;30,4;19
2005;3506805;Bocaina;10125;5048;5077;100,6;32,8;27,8
2005;3506904;Bofete;8480;4389;4091;93,2;32;13
2005;3507001;Boituva;41090;20748;20342;98;30,7;165,1
2005;3507100;Bom Jesus dos Perdões;16453;8277;8176;98,8;30,5;151,8
2005;3507159;Bom Sucesso de Itararé;3395;1739;1656;95,2;26,9;25,4
2005;3507209;Borá;803;407;396;97,3;32,3;6,8
2005;3507308;Boracéia;3988;2043;1945;95,2;32;32,7
2005;3507407;Borborema;13916;7049;6867;97,4;34,1;25,2
2005;3507456;Borebi;2115;1077;1038;96,4;30,4;6,1
2005;3507506;Botucatu;117775;57324;60451;105,5;33;79,4
2005;3507605;Bragança Paulista;136080;67140;68940;102,7;32,5;265,5
2005;3507704;Braúna;4685;2379;2306;96,9;34,6;24
2005;3507753;Brejo Alegre;2454;1265;1189;94;32,3;23,2
2005;3507803;Brodowski;19191;9585;9606;100,2;32,3;68,9
2005;3507902;Brotas;20247;10137;10110;99,7;32,5;18,4
2005;3508009;Buri;18151;9417;8734;92,7;29,1;15,2
2005;3508108;Buritama;14630;7311;7319;100,1;33,7;44,8
2005;3508207;Buritizal;3860;1967;1893;96,2;33,9;14,5
2005;3508306;Cabrália Paulista;4547;2305;2242;97,3;30,8;18,9
2005;3508405;Cabreúva;37275;19009;18266;96,1;28,6;143,2
2005;3508504;Caçapava;80490;39940;40550;101,5;31,4;218,1
2005;3508603;Cachoeira Paulista;28674;14145;14529;102,7;32,3;99,6
2005;3508702;Caconde;18631;9396;9235;98,3;32,3;39,8
2005;3508801;Cafelândia;16235;8014;8221;102,6;33,7;17,6
2005;3508900;Caiabu;4105;2104;2001;95,1;33,6;16,2
2005;3509007;Caieiras;78723;38806;39917;102,9;29,4;806,2
2005;3509106;Caiuá;4609;2414;2195;90,9;32,8;8,4
2005;3509205;Cajamar;57352;28789;28563;99,2;28,3;436,5
2005;3509254;Cajati;29020;14831;14189;95,7;28,7;63,9
2005;3509304;Cajobi;9525;4909;4616;94;33,2;53,8
2005;3509403;Cajuru;22083;11130;10953;98,4;31,6;33,5
2005;3509452;Campina do Monte Alegre;5415;2787;2628;94,3;31,4;29,4
2005;3509502;Campinas;1024207;496651;527556;106,2;32,9;1289
2005;3509601;Campo Limpo Paulista;68835;34099;34736;101,9;30,2;866,9
2005;3509700;Campos do Jordão;46364;22878;23486;102,7;29,7;159,9
2005;3509809;Campos Novos Paulista;4348;2239;2109;94,2;32,6;9
2005;3509908;Cananéia;12270;6175;6095;98,7;30,4;9,9
2005;3509957;Canas;3973;2036;1937;95,1;29,7;74,6
2005;3510005;Cândido Mota;29646;14686;14960;101,9;33;49,8
2005;3510104;Cândido Rodrigues;2652;1305;1347;103,2;36,9;37,4
2005;3510153;Canitar;3979;2026;1953;96,4;28,8;69,2
2005;3510203;Capão Bonito;47053;23565;23488;99,7;30,1;28,7
2005;3510302;Capela do Alto;15921;8184;7737;94,5;29,9;93,7
2005;3510401;Capivari;45054;22496;22558;100,3;31,1;139,5
2005;3510500;Caraguatatuba;89783;44864;44919;100,1;30,7;185,1
2005;3510609;Carapicuíba;357275;174344;182931;104,9;29;10342,1
2005;3510708;Cardoso;11768;5818;5950;102,3;34,8;18,4
2005;3510807;Casa Branca;27562;14565;12997;89,2;33,6;31,9
2005;3510906;Cássia dos Coqueiros;2795;1440;1355;94,1;33,2;14,6
2005;3511003;Castilho;16436;8207;8229;100,3;32,4;15,4
2005;3511102;Catanduva;109368;53352;56016;105;34,5;376,4
2005;3511201;Catiguá;6843;3495;3348;95,8;32,8;46,1
2005;3511300;Cedral;7331;3680;3651;99,2;35,6;37,1
2005;3511409;Cerqueira César;16420;8168;8252;101;32,3;32,1
2005;3511508;Cerquilho;34413;17138;17275;100,8;32;269,3
2005;3511607;Cesário Lange;14157;7382;6775;91,8;31,7;74,4
2005;3511706;Charqueada;14046;7115;6931;97,4;31,2;79,9
2005;3511904;Clementina;6188;3202;2986;93,3;31,3;36,7
2005;3512001;Colina;17068;8515;8553;100,4;32,6;40,4
2005;3512100;Colômbia;5964;3073;2891;94,1;30,4;8,2
2005;3512209;Conchal;24041;12138;11903;98,1;29,9;131,5
2005;3512308;Conchas;15567;7887;7680;97,4;33,4;33,4
2005;3512407;Cordeirópolis;19287;9671;9616;99,4;31,7;140,2
2005;3512506;Coroados;4821;2415;2406;99,6;32,6;19,5
2005;3512605;Coronel Macedo;5302;2722;2580;94,8;31,5;17,5
2005;3512704;Corumbataí;3833;1980;1853;93,6;32;13,8
2005;3512803;Cosmópolis;51481;25768;25713;99,8;30,6;332,9
2005;3512902;Cosmorama;7319;3701;3618;97,8;36,5;16,6
2005;3513009;Cotia;175036;86184;88852;103,1;29,4;540,2
2005;3513108;Cravinhos;30112;15214;14898;97,9;31,4;96,7
2005;3513207;Cristais Paulista;7090;3644;3446;94,6;31,1;18,4
2005;3513306;Cruzália;2468;1220;1248;102,3;33,9;16,5
2005;3513405;Cruzeiro;75381;36819;38562;104,7;32,1;246,6
2005;3513504;Cubatão;113869;57089;56780;99,5;29,3;797
2005;3513603;Cunha;22684;11676;11008;94,3;31,7;16,1
2005;3513702;Descalvado;30030;14904;15126;101,5;33,3;39,8
2005;3513801;Diadema;372856;181780;191076;105,1;29,1;12132,5
2005;3513850;Dirce Reis;1652;850;802;94,4;35,7;18,7
2005;3513900;Divinolândia;11707;5911;5796;98,1;34,1;52,3
2005;3514007;Dobrada;7447;3894;3553;91,2;29,4;49,7
2005;3514106;Dois Córregos;23539;11808;11731;99,3;32,8;37,2
2005;3514205;Dolcinópolis;2129;1108;1021;92,1;35,8;27,3
2005;3514304;Dourado;8627;4403;4224;95,9;34,4;41,9
2005;3514403;Dracena;41974;20599;21375;103,8;35,5;86,1
2005;3514502;Duartina;12433;6087;6346;104,3;34,8;47
2005;3514601;Dumont;7227;3671;3556;96,9;31,1;64,9
2005;3514700;Echaporã;6612;3284;3328;101,3;32,6;12,8
2005;3514809;Eldorado;14485;7463;7022;94,1;29,1;8,8
2005;3514908;Elias Fausto;14859;7673;7186;93,7;30,1;73,4
2005;3514924;Elisiário;2843;1495;1348;90,2;34,1;30,3
2005;3514957;Embaúba;2463;1279;1184;92,6;34;29,6
2005;3515004;Embu das Artes;223753;109519;114234;104,3;27,9;3178,4
2005;3515103;Embu-Guaçu;59902;29918;29984;100,2;29,5;384,9
2005;3515129;Emilianópolis;2973;1502;1471;97,9;34,7;13,2
2005;3515152;Engenheiro Coelho;12776;6657;6119;91,9;28,4;116,2
2005;3515186;Espírito Santo do Pinhal;41403;20392;21011;103;33,8;106,4
2005;3515194;Espírito Santo do Turvo;3958;2020;1938;95,9;29,4;20,4
2005;3515202;Estrela d'Oeste;8274;4189;4085;97,5;34,5;27,9
2005;3515301;Estrela do Norte;2631;1364;1267;92,9;31,5;9,9
2005;3515350;Euclides da Cunha Paulista;9957;5032;4925;97,9;29,8;17,3
2005;3515400;Fartura;15148;7458;7690;103,1;33;35,3
2005;3515509;Fernandópolis;63435;31068;32367;104,2;34,7;115,4
2005;3515608;Fernando Prestes;5484;2714;2770;102,1;36,2;32,3
2005;3515657;Fernão;1512;771;741;96,1;33,6;15
2005;3515707;Ferraz de Vasconcelos;155567;76366;79201;103,7;28,1;5265
2005;3515806;Flora Rica;1972;995;977;98,2;35,6;8,8
2005;3515905;Floreal;3139;1567;1572;100,3;37,9;15,4
2005;3516002;Flórida Paulista;11967;6251;5716;91,4;33,6;22,8
2005;3516101;Florínea;2999;1457;1542;105,8;33,3;13,3
2005;3516200;Franca;303881;149223;154658;103,6;31,4;501,7
2005;3516309;Francisco Morato;144180;71767;72413;100,9;27;2942,4
2005;3516408;Franco da Rocha;119965;61832;58133;94;29;903,5
2005;3516507;Gabriel Monteiro;2713;1387;1326;95,6;35,7;19,6
2005;3516606;Gália;7464;3764;3700;98,3;34;21
2005;3516705;Garça;43301;21189;22112;104,4;33,5;77,9
2005;3516804;Gastão Vidigal;3863;2009;1854;92,3;33;21,4
2005;3516853;Gavião Peixoto;4285;2254;2031;90,1;30,4;17,6
2005;3516903;General Salgado;10753;5436;5317;97,8;34,3;21,8
2005;3517000;Getulina;10594;5726;4868;85;33,1;15,7
2005;3517109;Glicério;4496;2265;2231;98,5;32,9;16,5
2005;3517208;Guaiçara;9908;4968;4940;99,4;31,2;35,7
2005;3517307;Guaimbê;5355;2677;2678;100;32;24,6
2005;3517406;Guaíra;36081;18014;18067;100,3;32,2;28,7
2005;3517505;Guapiaçu;15885;8047;7838;97,4;33;48,9
2005;3517604;Guapiara;19112;9780;9332;95,4;29,9;46,8
2005;3517703;Guará;19412;9695;9717;100,2;30,5;53,6
2005;3517802;Guaraçaí;8714;4370;4344;99,4;34,9;15,3
2005;3517901;Guaraci;9355;4763;4592;96,4;32;14,6
2005;3518008;Guarani d'Oeste;1983;996;987;99,1;35;23,1
2005;3518107;Guarantã;6384;3233;3151;97,5;30,7;13,8
2005;3518206;Guararapes;29755;14723;15032;102,1;33,8;31,1
2005;3518305;Guararema;23986;12130;11856;97,7;31,1;88,6
2005;3518404;Guaratinguetá;108510;52629;55881;106,2;32,7;144,2
2005;3518503;Guareí;12359;6977;5382;77,1;31,4;21,8
2005;3518602;Guariba;33242;16798;16444;97,9;29,7;123
2005;3518701;Guarujá;278166;136587;141579;103,7;29,7;1921,1
2005;3518800;Guarulhos;1148551;562444;586107;104,2;29,3;3604,2
2005;3518859;Guatapará;6676;3443;3233;93,9;31;16,1
2005;3518909;Guzolândia;4539;2343;2196;93,7;32,3;18
2005;3519006;Herculândia;8366;4211;4155;98,7;32,2;23
2005;3519055;Holambra;9252;4723;4529;95,9;30,5;141,1
2005;3519071;Hortolândia;172472;86801;85671;98,7;29;2763,3
2005;3519105;Iacanga;9125;4659;4466;95,9;33,5;16,7
2005;3519204;Iacri;6595;3334;3261;97,8;33,7;20,5
2005;3519253;Iaras;4671;2800;1871;66,8;30;11,6
2005;3519303;Ibaté;28532;14597;13935;95,5;29,5;98,1
2005;3519402;Ibirá;10135;5005;5130;102,5;34,8;37,3
2005;3519501;Ibirarema;6198;3136;3062;97,6;32,9;27,2
2005;3519600;Ibitinga;49791;24584;25207;102,5;33;72,2
2005;3519709;Ibiúna;68238;34943;33295;95,3;30,1;64,5
2005;3519808;Icém;7114;3605;3509;97,3;31,9;19,6
2005;3519907;Iepê;7454;3700;3754;101,5;33,9;12,5
2005;3520004;Igaraçu do Tietê;23047;11549;11498;99,6;30,8;235,8
2005;3520103;Igarapava;26937;13295;13642;102,6;32,9;57,5
2005;3520202;Igaratá;8621;4453;4168;93,6;31,3;29,4
2005;3520301;Iguape;28394;14354;14040;97,8;32,2;14,3
2005;3520400;Ilhabela;24414;12575;11839;94,1;29,2;70,5
2005;3520426;Ilha Comprida;7811;3916;3895;99,5;33,4;39,7
2005;3520442;Ilha Solteira;24608;12074;12534;103,8;33,3;37,7
2005;3520509;Indaiatuba;173828;86619;87209;100,7;31,4;558
2005;3520608;Indiana;4903;2473;2430;98,3;33,6;37,9
2005;3520707;Indiaporã;3997;1980;2017;101,9;36,1;14,3
2005;3520806;Inúbia Paulista;3471;1757;1714;97,6;33,8;39,8
2005;3520905;Ipaussu;13137;6599;6538;99,1;32;62,7
2005;3521002;Iperó;23189;12438;10751;86,4;29,5;136,2
2005;3521101;Ipeúna;5163;2674;2489;93,1;30,7;27,2
2005;3521150;Ipiguá;3966;2026;1940;95,8;33,5;29,2
2005;3521200;Iporanga;4451;2280;2171;95,2;29,2;3,9
2005;3521309;Ipuã;13050;6657;6393;96;30,5;28
2005;3521408;Iracemápolis;17678;8895;8783;98,7;31,7;153,6
2005;3521507;Irapuã;6957;3610;3347;92,7;33,1;27
2005;3521606;Irapuru;7665;4132;3533;85,5;35,7;35,7
2005;3521705;Itaberá;18503;9379;9124;97,3;31;16,8
2005;3521804;Itaí;22558;11769;10789;91,7;30,7;20,6
2005;3521903;Itajobi;14427;7292;7135;97,8;35,5;28,7
2005;3522000;Itaju;2948;1539;1409;91,6;33,8;12,8
2005;3522109;Itanhaém;79668;39143;40525;103,5;31,8;132,4
2005;3522158;Itaoca;3269;1691;1578;93,3;32;17,9
2005;3522208;Itapecerica da Serra;142140;70702;71438;101;28,1;942,9
2005;3522307;Itapetininga;135422;67771;67651;99,8;31,1;75,7
2005;3522406;Itapeva;86053;42509;43544;102,4;29,7;47,1
2005;3522505;Itapevi;181280;89508;91772;102,5;27,2;2193,1
2005;3522604;Itapira;66096;32939;33157;100,7;34,1;127,5
2005;3522653;Itapirapuã Paulista;3777;1969;1808;91,8;28,8;9,3
2005;3522703;Itápolis;39043;19420;19623;101;34;39,2
2005;3522802;Itaporanga;14518;7289;7229;99,2;32,1;28,6
2005;3522901;Itapuí;11259;5739;5520;96,2;32,2;80,4
2005;3523008;Itapura;4070;2114;1956;92,5;32;13,5
2005;3523107;Itaquaquecetuba;297461;147600;149861;101,5;27;3600,3
2005;3523206;Itararé;47656;23502;24154;102,8;30,7;47,5
2005;3523305;Itariri;14550;7392;7158;96,8;29,1;53,2
2005;3523404;Itatiba;91349;45339;46010;101,5;32;283,5
2005;3523503;Itatinga;16736;8561;8175;95,5;29,3;17,1
2005;3523602;Itirapina;14214;8154;6060;74,3;31,3;25,2
2005;3523701;Itirapuã;5695;2938;2757;93,8;31,1;35,3
2005;3523800;Itobi;7534;3914;3620;92,5;32,2;54,2
2005;3523909;Itu;144969;72020;72949;101,3;31,2;226,3
2005;3524006;Itupeva;35064;17895;17169;95,9;29,5;174,6
2005;3524105;Ituverava;37645;18491;19154;103,6;33,3;53,4
2005;3524204;Jaborandi;6499;3314;3185;96,1;32,5;23,8
2005;3524303;Jaboticabal;69842;34090;35752;104,9;33,2;98,8
2005;3524402;Jacareí;201634;99134;102500;103,4;31,4;434,3
2005;3524501;Jaci;4878;2511;2367;94,3;31,9;33,6
2005;3524600;Jacupiranga;17205;8797;8408;95,6;30,1;24,4
2005;3524709;Jaguariúna;36752;18405;18347;99,7;31,4;259,9
2005;3524808;Jales;46737;23006;23731;103,2;34,6;126,8
2005;3524907;Jambeiro;4686;2436;2250;92,4;31,7;25,4
2005;3525003;Jandira;100414;49534;50880;102,7;27,9;5754,7
2005;3525102;Jardinópolis;34116;17183;16933;98,5;31,3;68
2005;3525201;Jarinu;20393;10409;9984;95,9;30,5;98,3
2005;3525300;Jaú;121460;59799;61661;103,1;33,3;176,8
2005;3525409;Jeriquara;3238;1688;1550;91,8;30,1;22,8
2005;3525508;Joanópolis;11094;5629;5465;97,1;33,4;29,6
2005;3525607;João Ramalho;3985;2017;1968;97,6;30,5;9,6
2005;3525706;José Bonifácio;30798;15398;15400;100;32,7;35,8
2005;3525805;Júlio Mesquita;4336;2142;2194;102,4;31,9;33,8
2005;3525854;Jumirim;2497;1303;1194;91,6;32,1;44,1
2005;3525904;Jundiaí;346703;169395;177308;104,7;33,6;804
2005;3526001;Junqueirópolis;17870;9410;8460;89,9;35,3;30,7
2005;3526100;Juquiá;20127;10254;9873;96,3;30,4;24,8
2005;3526209;Juquitiba;27875;14075;13800;98;29,1;53,4
2005;3526308;Lagoinha;4902;2531;2371;93,7;34,2;19,2
2005;3526407;Laranjal Paulista;23738;11785;11953;101,4;33,4;61,8
2005;3526506;Lavínia;6942;4096;2846;69,5;33,8;12,9
2005;3526605;Lavrinhas;6299;3201;3098;96,8;29,1;37,7
2005;3526704;Leme;86426;43536;42890;98,5;30,9;214,5
2005;3526803;Lençóis Paulista;58384;29119;29265;100,5;31,1;72,1
2005;3526902;Limeira;262908;129914;132994;102,4;32,1;452,7
2005;3527009;Lindóia;6001;3002;2999;99,9;33,4;123,1
2005;3527108;Lins;68832;33404;35428;106,1;34;120,7
2005;3527207;Lorena;80382;38990;41392;106,2;32;194,1
2005;3527256;Lourdes;2065;1067;998;93,5;34,6;18,1
2005;3527306;Louveira;30105;15255;14850;97,3;29,7;540,1
2005;3527405;Lucélia;19177;10052;9125;90,8;33,9;60,9
2005;3527504;Lucianópolis;2232;1138;1094;96,1;33;11,8
2005;3527603;Luís Antônio;9179;4724;4455;94,3;28,5;15,3
2005;3527702;Luiziânia;4635;2367;2268;95,8;33,2;27,8
2005;3527801;Lupércio;4307;2134;2173;101,8;31,5;27,8
2005;3527900;Lutécia;2826;1423;1403;98,6;33,3;5,9
2005;3528007;Macatuba;16062;8074;7988;98,9;30,9;71,5
2005;3528106;Macaubal;7501;3816;3685;96,6;35,9;30,2
2005;3528205;Macedônia;3735;1884;1851;98,2;35,2;11,4
2005;3528304;Magda;3306;1710;1596;93,3;35,6;10,6
2005;3528403;Mairinque;41542;20759;20783;100,1;30,1;197,7
2005;3528502;Mairiporã;70421;35523;34898;98,2;30,6;219,6
2005;3528601;Manduri;8650;4382;4268;97,4;33;37,8
2005;3528700;Marabá Paulista;4264;2428;1836;75,6;32;4,6
2005;3528809;Maracaí;13192;6663;6529;98;32,2;24,7
2005;3528858;Marapoama;2452;1253;1199;95,7;34,3;22
2005;3528908;Mariápolis;3885;1994;1891;94,8;34,4;20,8
2005;3529005;Marília;207429;100888;106541;105,6;33,1;177,2
2005;3529104;Marinópolis;2183;1112;1071;96,3;33,2;28
2005;3529203;Martinópolis;23267;12015;11252;93,6;33,2;18,6
2005;3529302;Matão;74630;37155;37475;100,9;32,1;142,2
2005;3529401;Mauá;391589;192303;199286;103,6;29,5;6322,4
2005;3529500;Mendonça;4187;2138;2049;95,8;35,4;21,5
2005;3529609;Meridiano;3963;1989;1974;99,2;34,5;17,4
2005;3529658;Mesópolis;1915;984;931;94,6;34,1;12,9
2005;3529708;Miguelópolis;19750;9895;9855;99,6;31,1;24,1
2005;3529807;Mineiros do Tietê;11777;5896;5881;99,7;31,9;55,2
2005;3529906;Miracatu;21682;11084;10598;95,6;29,2;21,6
2005;3530003;Mira Estrela;2732;1398;1334;95,4;35;12,6
2005;3530102;Mirandópolis;26741;14435;12306;85,3;34,7;29,1
2005;3530201;Mirante do Paranapanema;16643;8472;8171;96,4;33,2;13,4
2005;3530300;Mirassol;51060;25141;25919;103,1;33,7;209,9
2005;3530409;Mirassolândia;4010;2053;1957;95,3;33,7;24,1
2005;3530508;Mococa;66261;33240;33021;99,3;33,1;77,5
2005;3530607;Mogi das Cruzes;359436;176114;183322;104,1;30,6;504,4
2005;3530706;Mogi Guaçu;130984;65439;65545;100,2;32;161,2
2005;3530805;Mogi Mirim;84036;41710;42326;101,5;33,1;168,8
2005;3530904;Mombuca;3191;1629;1562;95,9;30,4;23,9
2005;3531001;Monções;2105;1081;1024;94,7;36,3;20,2
2005;3531100;Mongaguá;40651;20585;20066;97,5;32,1;284,8
2005;3531209;Monte Alegre do Sul;6731;3395;3336;98,3;34,8;61
2005;3531308;Monte Alto;45229;22474;22755;101,3;34,1;130,4
2005;3531407;Monte Aprazível;19982;9921;10061;101,4;35,4;40,3
2005;3531506;Monte Azul Paulista;19386;9761;9625;98,6;32,8;73,6
2005;3531605;Monte Castelo;4081;2042;2039;99,9;35,8;17,5
2005;3531704;Monteiro Lobato;3864;2004;1860;92,8;32,6;11,6
2005;3531803;Monte Mor;43057;21593;21464;99,4;29,6;179
2005;3531902;Morro Agudo;27218;13908;13310;95,7;29,7;19,6
2005;3532009;Morungaba;10850;5464;5386;98,6;31,3;73,9
2005;3532058;Motuca;4086;2088;1998;95,7;31;17,9
2005;3532108;Murutinga do Sul;4084;2058;2026;98,4;37;16,3
2005;3532157;Nantes;2508;1271;1237;97,3;30;8,7
2005;3532207;Narandiba;4016;2035;1981;97,3;30,8;11,2
2005;3532306;Natividade da Serra;6833;3589;3244;90,4;34;8,2
2005;3532405;Nazaré Paulista;15466;7974;7492;94;32,2;47,4
2005;3532504;Neves Paulista;8867;4439;4428;99,8;36,6;40,5
2005;3532603;Nhandeara;10487;5162;5325;103,2;36,9;24
2005;3532702;Nipoã;3716;1934;1782;92,1;32,8;27
2005;3532801;Nova Aliança;5321;2641;2680;101,5;35,1;24,5
2005;3532827;Nova Campina;7949;4104;3845;93,7;27;20,6
2005;3532843;Nova Canaã Paulista;2314;1194;1120;93,8;37,7;18,6
2005;3532868;Nova Castilho;1045;530;515;97,2;33,5;5,7
2005;3532900;Nova Europa;8225;4144;4081;98,5;31,1;51,3
2005;3533007;Nova Granada;18054;9076;8978;98,9;33,1;33,9
2005;3533106;Nova Guataporanga;2146;1098;1048;95,4;36,1;62,8
2005;3533205;Nova Independência;2544;1278;1266;99,1;32,4;9,6
2005;3533254;Novais;3857;2048;1809;88,3;30,6;32,7
2005;3533304;Nova Luzitânia;3073;1615;1458;90,3;32,4;41,6
2005;3533403;Nova Odessa;46755;23172;23583;101,8;31,9;633,6
2005;3533502;Novo Horizonte;34535;17197;17338;100,8;33,9;37,1
2005;3533601;Nuporanga;6572;3313;3259;98,4;33,1;18,9
2005;3533700;Ocauçu;4178;2160;2018;93,4;32,9;13,9
2005;3533809;Óleo;2837;1440;1397;97;34,6;14,3
2005;3533908;Olímpia;48056;23769;24287;102,2;33,7;59,9
2005;3534005;Onda Verde;3671;1876;1795;95,7;31,7;15,1
2005;3534104;Oriente;6014;2962;3052;103;34,3;27,5
2005;3534203;Orindiúva;4881;2500;2381;95,2;29,8;19,7
2005;3534302;Orlândia;38024;18756;19268;102,7;32,1;130,3
2005;3534401;Osasco;661677;320215;341462;106,6;30,6;10186,8
2005;3534500;Oscar Bressane;2529;1228;1301;105,9;36,1;11,4
2005;3534609;Osvaldo Cruz;30454;15161;15293;100,9;35,5;122,8
2005;3534708;Ourinhos;98655;48163;50492;104,8;32,6;333,5
2005;3534757;Ouroeste;7309;3660;3649;99,7;33,2;25,3
2005;3534807;Ouro Verde;7492;3737;3755;100,5;32,4;28,1
2005;3534906;Pacaembu;12894;7185;5709;79,5;35,2;38
2005;3535002;Palestina;10020;5025;4995;99,4;35,6;14,4
2005;3535101;Palmares Paulista;9654;5041;4613;91,5;28,9;117,6
2005;3535200;Palmeira d'Oeste;10029;5068;4961;97,9;35,9;31,5
2005;3535309;Palmital;20977;10324;10653;103,2;34,7;38,3
2005;3535408;Panorama;14155;7161;6994;97,7;30,8;39,8
2005;3535507;Paraguaçu Paulista;41072;20499;20573;100,4;32,1;41
2005;3535606;Paraibuna;17304;8830;8474;96;31,5;21,4
2005;3535705;Paraíso;5661;2916;2745;94,1;33,3;36,5
2005;3535804;Paranapanema;16728;8610;8118;94,3;30;16,4
2005;3535903;Paranapuã;3758;1918;1840;95,9;34,2;26,8
2005;3536000;Parapuã;11037;5624;5413;96,2;35;30,1
2005;3536109;Pardinho;5147;2652;2495;94,1;30,8;24,5
2005;3536208;Pariquera-Açu;18111;9050;9061;100,1;30,6;50,4
2005;3536257;Parisi;1998;1036;962;92,9;35,4;23,6
2005;3536307;Patrocínio Paulista;12176;6203;5973;96,3;31,4;20,2
2005;3536406;Paulicéia;5827;3030;2797;92,3;30,6;15,6
2005;3536505;Paulínia;66214;32984;33230;100,7;30,4;477,1
2005;3536570;Paulistânia;1789;945;844;89,3;32,2;7
2005;3536604;Paulo de Faria;8573;4289;4284;99,9;32,7;11,6
2005;3536703;Pederneiras;39091;19694;19397;98,5;31,4;53,7
2005;3536802;Pedra Bela;5684;2990;2694;90,1;33,3;35,8
2005;3536901;Pedranópolis;2660;1366;1294;94,7;36,1;10,2
2005;3537008;Pedregulho;15377;7845;7532;96;31,1;21,6
2005;3537107;Pedreira;38474;19081;19393;101,6;32,5;353,6
2005;3537156;Pedrinhas Paulista;2914;1464;1450;99;32,9;19,1
2005;3537206;Pedro de Toledo;9762;4954;4808;97,1;30,8;14,6
2005;3537305;Penápolis;56676;27687;28989;104,7;34;79,7
2005;3537404;Pereira Barreto;25042;12349;12693;102,8;33,2;25,7
2005;3537503;Pereiras;6783;3460;3323;96;33,2;30,4
2005;3537602;Peruíbe;55782;27517;28265;102,7;31,9;171
2005;3537701;Piacatu;4946;2492;2454;98,5;33,7;21,3
2005;3537800;Piedade;51376;26580;24796;93,3;31,5;68,8
2005;3537909;Pilar do Sul;25339;12970;12369;95,4;30,4;37,2
2005;3538006;Pindamonhangaba;136939;67858;69081;101,8;30,6;187,2
2005;3538105;Pindorama;14105;7182;6923;96,4;34,9;76,3
2005;3538204;Pinhalzinho;12025;6142;5883;95,8;33,8;77,8
2005;3538303;Piquerobi;3513;1763;1750;99,3;34,1;7,3
2005;3538501;Piquete;14703;7145;7558;105,8;33,5;83,5
2005;3538600;Piracaia;24323;12240;12083;98,7;32,3;63,1
2005;3538709;Piracicaba;347360;170715;176645;103,5;32,6;252,1
2005;3538808;Piraju;28434;13874;14560;104,9;33,5;56,4
2005;3538907;Pirajuí;21485;11673;9812;84,1;33,7;26,1
2005;3539004;Pirangi;10347;5278;5069;96;34,9;47,9
2005;3539103;Pirapora do Bom Jesus;14109;7044;7065;100,3;27,6;130,1
2005;3539202;Pirapozinho;23511;11510;12001;104,3;32,4;49,2
2005;3539301;Pirassununga;67569;33214;34355;103,4;33,5;92,9
2005;3539400;Piratininga;11373;5699;5674;99,6;33,7;28,3
2005;3539509;Pitangueiras;33355;17058;16297;95,5;29,6;77,5
2005;3539608;Planalto;4046;2077;1969;94,8;31,8;14
2005;3539707;Platina;3039;1585;1454;91,7;31,9;9,3
2005;3539806;Poá;100765;49107;51658;105,2;29,7;5836,8
2005;3539905;Poloni;5056;2481;2575;103,8;36,4;37,4
2005;3540002;Pompéia;19130;9444;9686;102,6;33,2;24,4
2005;3540101;Pongaí;3602;1863;1739;93,3;36;19,6
2005;3540200;Pontal;34742;17932;16810;93,7;28,6;97,5
2005;3540259;Pontalinda;3806;2006;1800;89,7;31,6;18,2
2005;3540309;Pontes Gestal;2516;1253;1263;100,8;34,5;11,6
2005;3540408;Populina;4342;2222;2120;95,4;35,2;13,7
2005;3540507;Porangaba;7517;3922;3595;91,7;33,9;28,3
2005;3540606;Porto Feliz;47344;23761;23583;99,3;31,7;85
2005;3540705;Porto Ferreira;49446;24599;24847;101;32,4;201,9
2005;3540754;Potim;16456;8791;7665;87,2;28,5;368,6
2005;3540804;Potirendaba;14510;7414;7096;95,7;35,2;42,4
2005;3540853;Pracinha;2151;1306;845;64,7;32,8;34,1
2005;3540903;Pradópolis;15037;7655;7382;96,4;30,6;89,8
2005;3541000;Praia Grande;227325;110212;117113;106,3;31,5;1519
2005;3541059;Pratânia;4289;2226;2063;92,7;30;24,5
2005;3541109;Presidente Alves;4206;2104;2102;99,9;33,3;14,7
2005;3541208;Presidente Bernardes;14238;7218;7020;97,3;35,1;19
2005;3541307;Presidente Epitácio;40406;19954;20452;102,5;31,7;32,1
2005;3541406;Presidente Prudente;198813;96134;102679;106,8;33,3;354,6
2005;3541505;Presidente Venceslau;37799;18901;18898;100;34,2;50,1
2005;3541604;Promissão;33401;16749;16652;99,4;32,4;42,9
2005;3541653;Quadra;2922;1543;1379;89,4;33;14,2
2005;3541703;Quatá;12171;6064;6107;100,7;31,7;18,7
2005;3541802;Queiroz;2509;1280;1229;96;30,9;10,7
2005;3541901;Queluz;10267;5155;5112;99,2;30,6;41,2
2005;3542008;Quintana;5723;2863;2860;99,9;33,2;17,9
2005;3542107;Rafard;8505;4235;4270;100,8;32,1;69,9
2005;3542206;Rancharia;28974;14311;14663;102,5;32,8;18,3
2005;3542305;Redenção da Serra;3959;2095;1864;89;33,2;12,8
2005;3542404;Regente Feijó;17777;8866;8911;100,5;33,1;67,5
2005;3542503;Reginópolis;6035;3403;2632;77,3;33,1;14,7
2005;3542602;Registro;54409;26959;27450;101,8;30,4;75,3
2005;3542701;Restinga;6085;3075;3010;97,9;29,2;24,8
2005;3542800;Ribeira;3476;1813;1663;91,7;32,3;10,4
2005;3542909;Ribeirão Bonito;11693;5909;5784;97,9;31,5;24,8
2005;3543006;Ribeirão Branco;20135;10441;9694;92,8;27,3;28,9
2005;3543105;Ribeirão Corrente;4074;2134;1940;90,9;30,2;27,5
2005;3543204;Ribeirão do Sul;4479;2265;2214;97,7;33,9;22
2005;3543238;Ribeirão dos Índios;2215;1119;1096;97,9;35,6;11,3
2005;3543253;Ribeirão Grande;7447;3826;3621;94,6;30,3;22,3
2005;3543303;Ribeirão Pires;109279;53757;55522;103,3;31,5;1104,1
2005;3543402;Ribeirão Preto;554996;266752;288244;108,1;32,9;852,6
2005;3543501;Riversul;6738;3388;3350;98,9;32,7;17,5
2005;3543600;Rifaina;3407;1726;1681;97,4;33,5;21
2005;3543709;Rincão;10424;5261;5163;98,1;31,1;32,9
2005;3543808;Rinópolis;10100;5157;4943;95,9;35,5;28,2
2005;3543907;Rio Claro;177067;86393;90674;105;33,4;355,3
2005;3544004;Rio das Pedras;26375;13382;12993;97,1;30,3;116,4
2005;3544103;Rio Grande da Serra;40661;20212;20449;101,2;28,6;1118,9
2005;3544202;Riolândia;9495;5352;4143;77,4;31,6;15
2005;3544251;Rosana;22193;11168;11025;98,7;29,4;29,8
2005;3544301;Roseira;9078;4608;4470;97;30,3;69,9
2005;3544400;Rubiácea;2511;1281;1230;96;31,9;10,6
2005;3544509;Rubinéia;2748;1353;1395;103,1;36,2;11,3
2005;3544608;Sabino;5038;2524;2514;99,6;34,5;16,5
2005;3544707;Sagres;2411;1219;1192;97,8;33,3;16,3
2005;3544806;Sales;4985;2546;2439;95,8;33,8;16,2
2005;3544905;Sales Oliveira;9917;4945;4972;100,5;33;32,4
2005;3545001;Salesópolis;15056;7621;7435;97,6;31,3;35,4
2005;3545100;Salmourão;4613;2361;2252;95,4;33,3;26,7
2005;3545159;Saltinho;6384;3202;3182;99,4;33,8;64
2005;3545209;Salto;99428;49456;49972;101;31,2;747,3
2005;3545308;Salto de Pirapora;37661;18815;18846;100,2;30,8;134,3
2005;3545407;Salto Grande;8674;4335;4339;100,1;33,1;46
2005;3545506;Sandovalina;3397;1705;1692;99,2;30;7,5
2005;3545605;Santa Adélia;13935;7002;6933;99;33,3;42,2
2005;3545704;Santa Albertina;5683;2869;2814;98,1;36,7;20,8
2005;3545803;Santa Bárbara d'Oeste;175311;87321;87990;100,8;31,8;646,8
2005;3546009;Santa Branca;13442;6762;6680;98,8;32,2;49,4
2005;3546108;Santa Clara d'Oeste;2119;1076;1043;96,9;35,3;11,6
2005;3546207;Santa Cruz da Conceição;3766;1895;1871;98,7;34;25,1
2005;3546256;Santa Cruz da Esperança;1888;949;939;98,9;32;12,8
2005;3546306;Santa Cruz das Palmeiras;27725;14054;13671;97,3;31,2;93,9
2005;3546405;Santa Cruz do Rio Pardo;42523;20949;21574;103;33,2;38,1
2005;3546504;Santa Ernestina;5672;2995;2677;89,4;29,9;42,2
2005;3546603;Santa Fé do Sul;27964;13545;14419;106,5;35;135,4
2005;3546702;Santa Gertrudes;18690;9498;9192;96,8;29,9;190,1
2005;3546801;Santa Isabel;47294;23793;23501;98,8;30,6;130,2
2005;3546900;Santa Lúcia;8012;4076;3936;96,6;29,8;52,1
2005;3547007;Santa Maria da Serra;5012;2581;2431;94,2;30,5;19,8
2005;3547106;Santa Mercedes;2844;1434;1410;98,3;33,5;17,1
2005;3547205;Santana da Ponte Pensa;1769;902;867;96,1;38,5;13,6
2005;3547304;Santana de Parnaíba;91157;45242;45915;101,5;28,8;506,6
2005;3547403;Santa Rita d'Oeste;2646;1331;1315;98,8;37,9;12,6
2005;3547502;Santa Rita do Passa Quatro;26395;12826;13569;105,8;36,2;35
2005;3547601;Santa Rosa de Viterbo;22625;11232;11393;101,4;32,9;78,4
2005;3547650;Santa Salete;1425;736;689;93,6;37,7;18
2005;3547700;Santo Anastácio;20705;10119;10586;104,6;34,2;37,4
2005;3547809;Santo André;664321;320031;344290;107,6;33,6;3779,2
2005;3547908;Santo Antônio da Alegria;6073;3153;2920;92,6;33,5;19,6
2005;3548005;Santo Antônio de Posse;19406;9779;9627;98,4;31,2;125,9
2005;3548054;Santo Antônio do Aracanguá;7286;3752;3534;94,2;31,8;5,6
2005;3548104;Santo Antônio do Jardim;6069;3144;2925;93;33,6;55,2
2005;3548203;Santo Antônio do Pinhal;6418;3267;3151;96,4;31,1;48,3
2005;3548302;Santo Expedito;2660;1354;1306;96,5;34,7;28,2
2005;3548401;Santópolis do Aguapeí;4025;2043;1982;97;31,3;31,4
2005;3548500;Santos;419800;193194;226606;117,3;37,1;1493,8
2005;3548609;São Bento do Sapucaí;10442;5269;5173;98,2;33,6;41,3
2005;3548708;São Bernardo do Campo;734596;356320;378276;106,2;31,3;1793,7
2005;3548807;São Caetano do Sul;144647;67224;77423;115,2;37,8;9435,1
2005;3548906;São Carlos;207445;102311;105134;102,8;33,2;182,5
2005;3549003;São Francisco;2848;1436;1412;98,3;35,4;37,7
2005;3549102;São João da Boa Vista;80749;39447;41302;104,7;34,3;156,4
2005;3549201;São João das Duas Pontes;2630;1335;1295;97;33,7;20,3
2005;3549250;São João de Iracema;1730;876;854;97,5;33,8;9,7
2005;3549300;São João do Pau d'Alho;2155;1090;1065;97,7;37,2;18,3
2005;3549409;São Joaquim da Barra;44086;21682;22404;103,3;32,5;107,3
2005;3549508;São José da Bela Vista;8270;4233;4037;95,4;29,9;29,9
2005;3549607;São José do Barreiro;4119;2108;2011;95,4;32;7,2
2005;3549706;São José do Rio Pardo;51206;25299;25907;102,4;33,5;122
2005;3549805;São José do Rio Preto;383181;184748;198433;107,4;33,9;887,1
2005;3549904;São José dos Campos;584311;287670;296641;103,1;30,7;531,5
2005;3549953;São Lourenço da Serra;13135;6669;6466;97;29,8;70,4
2005;3550001;São Luiz do Paraitinga;10479;5403;5076;93,9;33,5;17
2005;3550100;São Manuel;37620;18549;19071;102,8;32,2;57,8
2005;3550209;São Miguel Arcanjo;31251;15947;15304;96;29,9;33,6
2005;3550308;São Paulo;10865573;5164140;5701433;110,4;32,3;7142,8
2005;3550407;São Pedro;29814;14621;15193;103,9;33,6;48,8
2005;3550506;São Pedro do Turvo;7073;3594;3479;96,8;32,1;9,7
2005;3550605;São Roque;73082;36183;36899;102;32,3;238,1
2005;3550704;São Sebastião;65816;33114;32702;98,8;29,2;163,6
2005;3550803;São Sebastião da Grama;12353;6298;6055;96,1;32,5;48,9
2005;3550902;São Simão;14060;6965;7095;101,9;33;22,8
2005;3551009;São Vicente;318322;153743;164579;107;31,3;2148,6
2005;3551108;Sarapuí;8475;4361;4114;94,3;31,3;24
2005;3551207;Sarutaiá;3660;1837;1823;99,2;32,4;25,8
2005;3551306;Sebastianópolis do Sul;2771;1412;1359;96,2;35,5;16,5
2005;3551405;Serra Azul;9346;5189;4157;80,1;30,3;33
2005;3551504;Serrana;35709;17948;17761;99;28,9;283,3
2005;3551603;Serra Negra;25167;12350;12817;103,8;35,2;123,5
2005;3551702;Sertãozinho;102268;51098;51170;100,1;31,1;253,7
2005;3551801;Sete Barras;13451;6981;6470;92,7;30,1;12,7
2005;3551900;Severínia;14554;7565;6989;92,4;30,1;103,6
2005;3552007;Silveiras;5617;2863;2754;96,2;31,7;13,5
2005;3552106;Socorro;34721;17290;17431;100,8;35,2;77,3
2005;3552205;Sorocaba;540256;265132;275124;103,8;31,6;1200,9
2005;3552304;Sud Mennucci;7381;3742;3639;97,2;31,8;12,4
2005;3552403;Sumaré;218276;109050;109226;100,2;29,7;1422,3
2005;3552502;Suzano;246285;121438;124847;102,8;29,2;1194,2
2005;3552551;Suzanápolis;3076;1589;1487;93,6;33,5;9,3
2005;3552601;Tabapuã;10905;5514;5391;97,8;34,7;31,5
2005;3552700;Tabatinga;13911;7113;6798;95,6;31,9;37,7
2005;3552809;Taboão da Serra;221494;106483;115011;108;29,2;10864,1
2005;3552908;Taciba;5484;2767;2717;98,2;32,1;9
2005;3553005;Taguaí;9076;4549;4527;99,5;30,8;62,5
2005;3553104;Taiaçu;5773;2920;2853;97,7;32,7;53,9
2005;3553203;Taiúva;5501;2746;2755;100,3;34,9;41,5
2005;3553302;Tambaú;22443;11271;11172;99,1;32,6;39,9
2005;3553401;Tanabi;23360;11636;11724;100,8;35;31,3
2005;3553500;Tapiraí;8376;4270;4106;96,2;29,5;11,1
2005;3553609;Tapiratiba;12894;6413;6481;101,1;32,3;58,1
2005;3553658;Taquaral;2742;1400;1342;95,9;32,4;50,9
2005;3553708;Taquaritinga;53233;26620;26613;100;32,8;89,6
2005;3553807;Taquarituba;22195;11099;11096;100;31,6;49,5
2005;3553856;Taquarivaí;4847;2454;2393;97,5;27,4;20,9
2005;3553906;Tarabai;6210;3132;3078;98,3;30,9;30,8
2005;3553955;Tarumã;11761;6019;5742;95,4;30,1;38,8
2005;3554003;Tatuí;100477;49856;50621;101,5;31,4;191,8
2005;3554102;Taubaté;261670;128690;132980;103,3;31,8;418,7
2005;3554201;Tejupá;5111;2653;2458;92,6;29,7;17,3
2005;3554300;Teodoro Sampaio;20803;10410;10393;99,8;30,1;13,4
2005;3554409;Terra Roxa;8109;4123;3986;96,7;32,4;36,6
2005;3554508;Tietê;34211;16970;17241;101,6;32,9;84,6
2005;3554607;Timburi;2701;1394;1307;93,8;34,6;13,7
2005;3554656;Torre de Pedra;2210;1152;1058;91,8;34,6;31
2005;3554706;Torrinha;9070;4588;4482;97,7;34,5;28,8
2005;3554755;Trabiju;1461;744;717;96,4;31,3;23
2005;3554805;Tremembé;37923;19899;18024;90,6;31;198,5
2005;3554904;Três Fronteiras;5329;2676;2653;99,1;35,8;35,2
2005;3554953;Tuiuti;5439;2788;2651;95,1;34,8;42,9
2005;3555000;Tupã;63679;30940;32739;105,8;35,3;101,4
2005;3555109;Tupi Paulista;13842;7074;6768;95,7;37,3;56,6
2005;3555208;Turiúba;1914;990;924;93,3;37;12,5
2005;3555307;Turmalina;2191;1092;1099;100,6;37,3;14,8
2005;3555356;Ubarana;4782;2479;2303;92,9;29,8;22,8
2005;3555406;Ubatuba;73075;36693;36382;99,2;29,5;103,2
2005;3555505;Ubirajara;4269;2195;2074;94,5;32,6;15,1
2005;3555604;Uchoa;9264;4633;4631;100;35,2;36,7
2005;3555703;União Paulista;1487;775;712;91,9;33,8;18,8
2005;3555802;Urânia;8874;4428;4446;100,4;35,4;42,4
2005;3555901;Uru;1323;689;634;92;35,2;9
2005;3556008;Urupês;12327;6171;6156;99,8;35,7;38,1
2005;3556107;Valentim Gentil;9791;4956;4835;97,6;32,7;65,4
2005;3556206;Valinhos;94773;47019;47754;101,6;33,2;638
2005;3556305;Valparaíso;20490;10986;9504;86,5;31,6;23,9
2005;3556354;Vargem;7889;4053;3836;94,6;33,2;55,3
2005;3556404;Vargem Grande do Sul;37800;18814;18986;100,9;32,5;141,5
2005;3556453;Vargem Grande Paulista;37722;18825;18897;100,4;29,2;887,8
2005;3556503;Várzea Paulista;99778;49959;49819;99,7;29,2;2841,1
2005;3556602;Vera Cruz;10983;5435;5548;102,1;33,9;44,3
2005;3556701;Vinhedo;55165;27402;27763;101,3;32,5;681,5
2005;3556800;Viradouro;16639;8409;8230;97,9;31,9;76,4
2005;3556909;Vista Alegre do Alto;5793;2944;2849;96,8;32,2;60,7
2005;3556958;Vitória Brasil;1707;879;828;94,2;33,6;34,3
2005;3557006;Votorantim;102679;51136;51543;100,8;30,2;557,5
2005;3557105;Votuporanga;80260;39293;40967;104,3;34,4;190,8
2005;3557154;Zacarias;2137;1090;1047;96,1;34,3;6,7
2005;3557204;Chavantes;12169;6063;6106;100,7;32,1;64,5
2005;3557303;Estiva Gerbi;9469;4833;4636;95,9;30,8;127,7
2006;3500105;Adamantina;33784;16428;17356;105,6;36,1;82
2006;3500204;Adolfo;3642;1841;1801;97,8;34,7;17,3
2006;3500303;Aguaí;30598;15396;15202;98,7;31,9;64,5
2006;3500402;Águas da Prata;7370;3668;3702;100,9;36,3;51,7
2006;3500501;Águas de Lindóia;16859;8299;8560;103,1;34,2;280,4
2006;3500550;Águas de Santa Bárbara;5462;2734;2728;99,8;33,3;13,5
2006;3500600;Águas de São Pedro;2367;1097;1270;115,8;39,9;655,3
2006;3500709;Agudos;33794;16751;17043;101,7;31,4;35
2006;3500758;Alambari;4381;2229;2152;96,5;31;27,4
2006;3500808;Alfredo Marcondes;3843;1961;1882;96;36,8;32,3
2006;3500907;Altair;3685;1971;1714;87;30,8;11,8
2006;3501004;Altinópolis;15673;7875;7798;99;33,5;16,9
2006;3501103;Alto Alegre;4164;2154;2010;93,3;36,8;13,1
2006;3501152;Alumínio;16289;8221;8068;98,1;29,6;194,8
2006;3501202;Álvares Florence;4077;2101;1976;94,1;38;11,2
2006;3501301;Álvares Machado;23354;11638;11716;100,7;32,6;67,2
2006;3501400;Álvaro de Carvalho;4434;2742;1692;61,7;31,4;28,9
2006;3501509;Alvinlândia;2939;1468;1471;100,2;31,8;34,6
2006;3501608;Americana;199700;98218;101482;103,3;33,9;1491,3
2006;3501707;Américo Brasiliense;31875;16115;15760;97,8;29,4;259,2
2006;3501806;Américo de Campos;5676;2846;2830;99,4;35,9;22,4
2006;3501905;Amparo;63807;31609;32198;101,9;34,2;143,3
2006;3502002;Analândia;4004;2062;1942;94,2;32,9;12,3
2006;3502101;Andradina;55456;27301;28155;103,1;34,6;57,5
2006;3502200;Angatuba;21098;10761;10337;96,1;32;20,5
2006;3502309;Anhembi;5175;2669;2506;93,9;31,6;7
2006;3502408;Anhumas;3619;1822;1797;98,6;33;11,3
2006;3502507;Aparecida;34933;16982;17951;105,7;32,5;289
2006;3502606;Aparecida d'Oeste;4673;2297;2376;103,4;36,4;26,1
2006;3502705;Apiaí;26263;13174;13089;99,4;29,6;27
2006;3502754;Araçariguama;14639;7485;7154;95,6;28,5;100,8
2006;3502804;Araçatuba;177016;85378;91638;107,3;34,4;151,7
2006;3502903;Araçoiaba da Serra;24247;12143;12104;99,7;32,5;95
2006;3503000;Aramina;4980;2519;2461;97,7;33,9;24,6
2006;3503109;Arandu;6176;3126;3050;97,6;31,2;21,6
2006;3503158;Arapeí;2535;1268;1267;99,9;32,9;16,2
2006;3503208;Araraquara;198025;95876;102149;106,5;34,3;197,3
2006;3503307;Araras;112803;55998;56805;101,4;33;174,9
2006;3503356;Arco-Íris;2034;1048;986;94,1;35,2;7,7
2006;3503406;Arealva;7619;3896;3723;95,6;35,9;15,1
2006;3503505;Areias;3684;1841;1843;100,1;31,2;12,1
2006;3503604;Areiópolis;10506;5419;5087;93,9;29;122,3
2006;3503703;Ariranha;8135;4156;3979;95,7;33,6;61,3
2006;3503802;Artur Nogueira;39734;19895;19839;99,7;30,6;223,2
2006;3503901;Arujá;68594;34010;34584;101,7;29,5;713,3
2006;3503950;Aspásia;1837;933;904;96,9;35,7;26,5
2006;3504008;Assis;91936;44751;47185;105,4;34,2;199,6
2006;3504107;Atibaia;120842;59712;61130;102,4;32,5;252,5
2006;3504206;Auriflama;13990;7020;6970;99,3;34,5;32,2
2006;3504305;Avaí;4810;2457;2353;95,8;32;8,9
2006;3504404;Avanhandava;10300;5446;4854;89,1;30,8;30,4
2006;3504503;Avaré;80381;40005;40376;100,9;32,6;66,3
2006;3504602;Bady Bassitt;13353;6673;6680;100,1;32,8;121
2006;3504701;Balbinos;2744;1868;876;46,9;33,7;29,9
2006;3504800;Bálsamo;7826;3863;3963;102,6;35,8;52,2
2006;3504909;Bananal;10062;4991;5071;101,6;33;16,3
2006;3505005;Barão de Antonina;2973;1524;1449;95,1;33,3;19,4
2006;3505104;Barbosa;6316;3182;3134;98,5;32;30,8
2006;3505203;Bariri;30311;15184;15127;99,6;34,5;68,2
2006;3505302;Barra Bonita;35454;17507;17947;102,5;34,1;236,2
2006;3505351;Barra do Chapéu;5120;2728;2392;87,7;29,9;12,6
2006;3505401;Barra do Turvo;7936;4169;3767;90,4;30,2;7,9
2006;3505500;Barretos;108761;52756;56005;106,2;33,7;69,4
2006;3505609;Barrinha;26710;13479;13231;98,2;28,5;182,9
2006;3505708;Barueri;227914;111617;116297;104,2;28,8;3469
2006;3505807;Bastos;20642;10190;10452;102,6;32,4;120,8
2006;3505906;Batatais;54351;26804;27547;102,8;33,6;64
2006;3506003;Bauru;333526;162230;171296;105,6;33,3;499,5
2006;3506102;Bebedouro;75256;36844;38412;104,3;33,4;110,2
2006;3506201;Bento de Abreu;2539;1293;1246;96,4;32,7;8,4
2006;3506300;Bernardino de Campos;10795;5298;5497;103,8;35;44,2
2006;3506359;Bertioga;40290;20429;19861;97,2;28,6;82
2006;3506409;Bilac;6692;3315;3377;101,9;35,7;42,3
2006;3506508;Birigui;102853;50412;52441;104;33,3;194,1
2006;3506607;Biritiba Mirim;27023;13666;13357;97,7;30,4;85,1
2006;3506706;Boa Esperança do Sul;13259;6704;6555;97,8;30,7;19,2
2006;3506805;Bocaina;10266;5119;5147;100,5;33;28,2
2006;3506904;Bofete;8697;4487;4210;93,8;32,4;13,3
2006;3507001;Boituva;42498;21448;21050;98,1;31;170,7
2006;3507100;Bom Jesus dos Perdões;17097;8602;8495;98,8;30,8;157,8
2006;3507159;Bom Sucesso de Itararé;3431;1756;1675;95,4;27,3;25,7
2006;3507209;Borá;806;409;397;97,1;32,5;6,8
2006;3507308;Boracéia;4044;2070;1974;95,4;32,2;33,1
2006;3507407;Borborema;14040;7109;6931;97,5;34,4;25,4
2006;3507456;Borebi;2153;1089;1064;97,7;30,7;6,2
2006;3507506;Botucatu;119672;58209;61463;105,6;33,3;80,7
2006;3507605;Bragança Paulista;138285;68173;70112;102,8;32,9;269,8
2006;3507704;Braúna;4743;2413;2330;96,6;34,8;24,3
2006;3507753;Brejo Alegre;2480;1277;1203;94,2;32,6;23,5
2006;3507803;Brodowski;19575;9764;9811;100,5;32,6;70,3
2006;3507902;Brotas;20531;10264;10267;100;32,8;18,6
2006;3508009;Buri;18258;9450;8808;93,2;29,4;15,3
2006;3508108;Buritama;14775;7391;7384;99,9;34;45,2
2006;3508207;Buritizal;3908;1995;1913;95,9;34,3;14,7
2006;3508306;Cabrália Paulista;4523;2297;2226;96,9;31,2;18,8
2006;3508405;Cabreúva;38130;19422;18708;96,3;28,9;146,5
2006;3508504;Caçapava;81323;40345;40978;101,6;31,8;220,4
2006;3508603;Cachoeira Paulista;28940;14257;14683;103;32,6;100,5
2006;3508702;Caconde;18635;9386;9249;98,5;32,7;39,8
2006;3508801;Cafelândia;16324;8055;8269;102,7;34,1;17,7
2006;3508900;Caiabu;4104;2104;2000;95,1;34;16,2
2006;3509007;Caieiras;80298;39521;40777;103,2;29,8;822,4
2006;3509106;Caiuá;4687;2457;2230;90,8;33,3;8,5
2006;3509205;Cajamar;58692;29433;29259;99,4;28,6;446,7
2006;3509254;Cajati;28957;14764;14193;96,1;29,1;63,7
2006;3509304;Cajobi;9578;4938;4640;94;33,5;54,1
2006;3509403;Cajuru;22330;11240;11090;98,7;31,9;33,8
2006;3509452;Campina do Monte Alegre;5457;2809;2648;94,3;31,8;29,6
2006;3509502;Campinas;1034904;501328;533576;106,4;33,2;1302,5
2006;3509601;Campo Limpo Paulista;69899;34573;35326;102,2;30,5;880,3
2006;3509700;Campos do Jordão;46745;23031;23714;103;30,1;161,2
2006;3509809;Campos Novos Paulista;4391;2260;2131;94,3;32,9;9,1
2006;3509908;Cananéia;12276;6172;6104;98,9;30,8;9,9
2006;3509957;Canas;4048;2071;1977;95,5;29,8;76
2006;3510005;Cândido Mota;29720;14698;15022;102,2;33,4;49,9
2006;3510104;Cândido Rodrigues;2655;1307;1348;103,1;37,2;37,5
2006;3510153;Canitar;4063;2070;1993;96,3;29;70,7
2006;3510203;Capão Bonito;46987;23515;23472;99,8;30,5;28,6
2006;3510302;Capela do Alto;16240;8352;7888;94,4;30,2;95,6
2006;3510401;Capivari;45762;22872;22890;100,1;31,4;141,7
2006;3510500;Caraguatatuba;91970;45886;46084;100,4;31,1;189,6
2006;3510609;Carapicuíba;359909;175452;184457;105,1;29,4;10418,3
2006;3510708;Cardoso;11796;5830;5966;102,3;35,1;18,5
2006;3510807;Casa Branca;27693;14640;13053;89,2;33,9;32
2006;3510906;Cássia dos Coqueiros;2767;1425;1342;94,2;33,6;14,4
2006;3511003;Castilho;16733;8353;8380;100,3;32,8;15,7
2006;3511102;Catanduva;110072;53645;56427;105,2;34,8;378,8
2006;3511201;Catiguá;6900;3521;3379;96;33,1;46,5
2006;3511300;Cedral;7455;3736;3719;99,5;35,9;37,7
2006;3511409;Cerqueira César;16645;8271;8374;101,2;32,5;32,5
2006;3511508;Cerquilho;35416;17620;17796;101;32,4;277,1
2006;3511607;Cesário Lange;14442;7523;6919;92;31,9;75,9
2006;3511706;Charqueada;14238;7220;7018;97,2;31,5;81
2006;3511904;Clementina;6342;3283;3059;93,2;31,5;37,6
2006;3512001;Colina;17143;8544;8599;100,6;32,9;40,6
2006;3512100;Colômbia;5984;3080;2904;94,3;30,8;8,2
2006;3512209;Conchal;24276;12262;12014;98;30,2;132,8
2006;3512308;Conchas;15725;7957;7768;97,6;33,7;33,7
2006;3512407;Cordeirópolis;19658;9861;9797;99,4;32;142,9
2006;3512506;Coroados;4909;2459;2450;99,6;32,9;19,9
2006;3512605;Coronel Macedo;5256;2700;2556;94,7;32;17,3
2006;3512704;Corumbataí;3844;1980;1864;94,1;32,4;13,8
2006;3512803;Cosmópolis;52887;26464;26423;99,8;30,9;341,9
2006;3512902;Cosmorama;7300;3692;3608;97,7;36,8;16,5
2006;3513009;Cotia;180058;88566;91492;103,3;29,7;555,7
2006;3513108;Cravinhos;30456;15362;15094;98,3;31,7;97,8
2006;3513207;Cristais Paulista;7189;3688;3501;94,9;31,6;18,7
2006;3513306;Cruzália;2436;1202;1234;102,7;34,4;16,3
2006;3513405;Cruzeiro;75786;36990;38796;104,9;32,5;247,9
2006;3513504;Cubatão;114930;57566;57364;99,6;29,7;804,4
2006;3513603;Cunha;22565;11599;10966;94,5;32,2;16
2006;3513702;Descalvado;30245;14995;15250;101,7;33,6;40,1
2006;3513801;Diadema;375607;182873;192734;105,4;29,5;12222
2006;3513850;Dirce Reis;1663;856;807;94,3;36,1;18,9
2006;3513900;Divinolândia;11633;5861;5772;98,5;34,6;52
2006;3514007;Dobrada;7537;3935;3602;91,5;29,6;50,3
2006;3514106;Dois Córregos;23771;11926;11845;99,3;33;37,6
2006;3514205;Dolcinópolis;2130;1112;1018;91,5;36,2;27,3
2006;3514304;Dourado;8628;4397;4231;96,2;34,8;41,9
2006;3514403;Dracena;42237;20763;21474;103,4;35,9;86,6
2006;3514502;Duartina;12424;6078;6346;104,4;35,2;47
2006;3514601;Dumont;7420;3762;3658;97,2;31,4;66,6
2006;3514700;Echaporã;6567;3258;3309;101,6;33;12,7
2006;3514809;Eldorado;14563;7493;7070;94,4;29,5;8,8
2006;3514908;Elias Fausto;15043;7775;7268;93,5;30,5;74,3
2006;3514924;Elisiário;2905;1532;1373;89,6;34,3;30,9
2006;3514957;Embaúba;2455;1278;1177;92,1;34,3;29,5
2006;3515004;Embu das Artes;227040;110986;116054;104,6;28,3;3225,1
2006;3515103;Embu-Guaçu;60530;30205;30325;100,4;29,9;388,9
2006;3515129;Emilianópolis;2990;1508;1482;98,3;35;13,3
2006;3515152;Engenheiro Coelho;13346;6960;6386;91,8;28,6;121,4
2006;3515186;Espírito Santo do Pinhal;41533;20432;21101;103,3;34,1;106,7
2006;3515194;Espírito Santo do Turvo;4023;2048;1975;96,4;29,7;20,8
2006;3515202;Estrela d'Oeste;8255;4176;4079;97,7;34,9;27,9
2006;3515301;Estrela do Norte;2634;1366;1268;92,8;31,8;9,9
2006;3515350;Euclides da Cunha Paulista;9914;5009;4905;97,9;30,3;17,3
2006;3515400;Fartura;15183;7453;7730;103,7;33,4;35,4
2006;3515509;Fernandópolis;63720;31178;32542;104,4;35,2;115,9
2006;3515608;Fernando Prestes;5499;2721;2778;102,1;36,5;32,3
2006;3515657;Fernão;1528;778;750;96,4;33,9;15,2
2006;3515707;Ferraz de Vasconcelos;158084;77523;80561;103,9;28,4;5350,2
2006;3515806;Flora Rica;1942;978;964;98,6;36,2;8,6
2006;3515905;Floreal;3118;1555;1563;100,5;38,4;15,3
2006;3516002;Flórida Paulista;12132;6397;5735;89,7;33,8;23,1
2006;3516101;Florínea;2970;1444;1526;105,7;33,8;13,1
2006;3516200;Franca;306998;150567;156431;103,9;31,8;506,9
2006;3516309;Francisco Morato;146323;72795;73528;101;27,4;2986,1
2006;3516408;Franco da Rocha;122268;62959;59309;94,2;29,3;920,9
2006;3516507;Gabriel Monteiro;2710;1386;1324;95,5;36,1;19,5
2006;3516606;Gália;7379;3717;3662;98,5;34,5;20,7
2006;3516705;Garça;43305;21168;22137;104,6;33,8;77,9
2006;3516804;Gastão Vidigal;3922;2059;1863;90,5;33,2;21,7
2006;3516853;Gavião Peixoto;4312;2262;2050;90,6;30,7;17,7
2006;3516903;General Salgado;10731;5422;5309;97,9;34,7;21,7
2006;3517000;Getulina;10636;5756;4880;84,8;33,3;15,7
2006;3517109;Glicério;4515;2273;2242;98,6;33,2;16,6
2006;3517208;Guaiçara;10051;5046;5005;99,2;31,5;36,3
2006;3517307;Guaimbê;5384;2690;2694;100,1;32,3;24,7
2006;3517406;Guaíra;36366;18124;18242;100,7;32,6;28,9
2006;3517505;Guapiaçu;16259;8233;8026;97,5;33,3;50
2006;3517604;Guapiara;18935;9677;9258;95,7;30,4;46,4
2006;3517703;Guará;19524;9743;9781;100,4;30,8;53,9
2006;3517802;Guaraçaí;8650;4331;4319;99,7;35,3;15,2
2006;3517901;Guaraci;9477;4827;4650;96,3;32,3;14,8
2006;3518008;Guarani d'Oeste;1983;989;994;100,5;35,4;23,1
2006;3518107;Guarantã;6391;3231;3160;97,8;31,1;13,8
2006;3518206;Guararapes;29930;14802;15128;102,2;34,1;31,3
2006;3518305;Guararema;24362;12308;12054;97,9;31,5;90
2006;3518404;Guaratinguetá;109276;52924;56352;106,5;33,1;145,2
2006;3518503;Guareí;12804;7343;5461;74,4;31,7;22,5
2006;3518602;Guariba;33673;17013;16660;97,9;30;124,6
2006;3518701;Guarujá;280797;137687;143110;103,9;30,1;1939,3
2006;3518800;Guarulhos;1163521;569210;594311;104,4;29,6;3651,1
2006;3518859;Guatapará;6748;3475;3273;94,2;31,3;16,3
2006;3518909;Guzolândia;4577;2358;2219;94,1;32,6;18,1
2006;3519006;Herculândia;8456;4247;4209;99,1;32,6;23,2
2006;3519055;Holambra;9648;4920;4728;96,1;30,9;147,1
2006;3519071;Hortolândia;176472;88910;87562;98,5;29,3;2827,4
2006;3519105;Iacanga;9297;4756;4541;95,5;33,7;17
2006;3519204;Iacri;6564;3321;3243;97,7;34,1;20,4
2006;3519253;Iaras;5007;3056;1951;63,8;30,6;12,5
2006;3519303;Ibaté;28999;14855;14144;95,2;29,8;99,7
2006;3519402;Ibirá;10284;5083;5201;102,3;35;37,8
2006;3519501;Ibirarema;6307;3194;3113;97,5;33,1;27,6
2006;3519600;Ibitinga;50413;24886;25527;102,6;33,2;73,1
2006;3519709;Ibiúna;68911;35244;33667;95,5;30,5;65,1
2006;3519808;Icém;7182;3643;3539;97,1;32,1;19,8
2006;3519907;Iepê;7494;3718;3776;101,6;34,2;12,6
2006;3520004;Igaraçu do Tietê;23128;11576;11552;99,8;31,2;236,6
2006;3520103;Igarapava;27133;13399;13734;102,5;33,1;57,9
2006;3520202;Igaratá;8692;4483;4209;93,9;31,7;29,7
2006;3520301;Iguape;28545;14408;14137;98,1;32,6;14,4
2006;3520400;Ilhabela;25172;12929;12243;94,7;29,5;72,7
2006;3520426;Ilha Comprida;8049;4024;4025;100;33,9;40,9
2006;3520442;Ilha Solteira;24718;12110;12608;104,1;33,8;37,9
2006;3520509;Indaiatuba;179288;89298;89990;100,8;31,7;575,5
2006;3520608;Indiana;4880;2457;2423;98,6;34;37,7
2006;3520707;Indiaporã;3976;1967;2009;102,1;36,6;14,2
2006;3520806;Inúbia Paulista;3514;1774;1740;98,1;34,2;40,3
2006;3520905;Ipaussu;13245;6659;6586;98,9;32,3;63,2
2006;3521002;Iperó;24190;12977;11213;86,4;29,8;142,1
2006;3521101;Ipeúna;5330;2759;2571;93,2;30,9;28,1
2006;3521150;Ipiguá;4060;2072;1988;95,9;34;29,8
2006;3521200;Iporanga;4432;2262;2170;95,9;29,6;3,8
2006;3521309;Ipuã;13281;6774;6507;96,1;30,8;28,5
2006;3521408;Iracemápolis;18134;9119;9015;98,9;32;157,5
2006;3521507;Irapuã;7014;3646;3368;92,4;33,3;27,2
2006;3521606;Irapuru;7702;4211;3491;82,9;35,9;35,9
2006;3521705;Itaberá;18394;9319;9075;97,4;31,4;16,7
2006;3521804;Itaí;22886;11982;10904;91;31,1;20,9
2006;3521903;Itajobi;14465;7312;7153;97,8;35,9;28,8
2006;3522000;Itaju;3014;1572;1442;91,7;33,8;13,1
2006;3522109;Itanhaém;81153;39769;41384;104,1;32,3;134,9
2006;3522158;Itaoca;3276;1695;1581;93,3;32,5;17,9
2006;3522208;Itapecerica da Serra;144344;71875;72469;100,8;28,4;957,6
2006;3522307;Itapetininga;137295;68694;68601;99,9;31,4;76,7
2006;3522406;Itapeva;86599;42759;43840;102,5;30,1;47,4
2006;3522505;Itapevi;185144;91357;93787;102,7;27,6;2239,9
2006;3522604;Itapira;66641;33174;33467;100,9;34,4;128,5
2006;3522653;Itapirapuã Paulista;3812;1982;1830;92,3;29,1;9,4
2006;3522703;Itápolis;39274;19523;19751;101,2;34,3;39,4
2006;3522802;Itaporanga;14537;7295;7242;99,3;32,5;28,6
2006;3522901;Itapuí;11431;5817;5614;96,5;32,5;81,6
2006;3523008;Itapura;4122;2137;1985;92,9;32,3;13,7
2006;3523107;Itaquaquecetuba;302204;149762;152442;101,8;27,4;3657,7
2006;3523206;Itararé;47796;23547;24249;103;31;47,6
2006;3523305;Itariri;14727;7471;7256;97,1;29,4;53,8
2006;3523404;Itatiba;93349;46292;47057;101,7;32,3;289,7
2006;3523503;Itatinga;17017;8706;8311;95,5;29,6;17,4
2006;3523602;Itirapina;14480;8351;6129;73,4;31,6;25,6
2006;3523701;Itirapuã;5736;2951;2785;94,4;31,4;35,6
2006;3523800;Itobi;7534;3913;3621;92,5;32,5;54,2
2006;3523909;Itu;146819;72879;73940;101,5;31,5;229,1
2006;3524006;Itupeva;36897;18814;18083;96,1;29,7;183,7
2006;3524105;Ituverava;37929;18604;19325;103,9;33,6;53,8
2006;3524204;Jaborandi;6509;3313;3196;96,5;32,8;23,8
2006;3524303;Jaboticabal;70265;34262;36003;105,1;33,6;99,4
2006;3524402;Jacareí;203681;100003;103678;103,7;31,7;438,7
2006;3524501;Jaci;5018;2584;2434;94,2;32,1;34,6
2006;3524600;Jacupiranga;17232;8808;8424;95,6;30,5;24,5
2006;3524709;Jaguariúna;38240;19121;19119;100;31,7;270,5
2006;3524808;Jales;46822;23017;23805;103,4;35;127
2006;3524907;Jambeiro;4816;2502;2314;92,5;32;26,1
2006;3525003;Jandira;102020;50262;51758;103;28,3;5846,7
2006;3525102;Jardinópolis;34832;17539;17293;98,6;31,6;69,4
2006;3525201;Jarinu;21073;10727;10346;96,4;30,9;101,5
2006;3525300;Jaú;123409;60709;62700;103,3;33,6;179,6
2006;3525409;Jeriquara;3227;1675;1552;92,7;30,4;22,7
2006;3525508;Joanópolis;11236;5696;5540;97,3;33,8;30
2006;3525607;João Ramalho;4017;2032;1985;97,7;30,9;9,7
2006;3525706;José Bonifácio;31195;15593;15602;100,1;33;36,3
2006;3525805;Júlio Mesquita;4354;2151;2203;102,4;32,2;34
2006;3525854;Jumirim;2555;1332;1223;91,8;32,3;45,1
2006;3525904;Jundiaí;351177;171442;179735;104,8;33,9;814,4
2006;3526001;Junqueirópolis;18031;9505;8526;89,7;35,5;31
2006;3526100;Juquiá;20007;10182;9825;96,5;30,9;24,6
2006;3526209;Juquitiba;28109;14199;13910;98;29,5;53,8
2006;3526308;Lagoinha;4890;2522;2368;93,9;34,6;19,1
2006;3526407;Laranjal Paulista;24054;11927;12127;101,7;33,7;62,6
2006;3526506;Lavínia;7307;4465;2842;63,7;34;13,6
2006;3526605;Lavrinhas;6370;3233;3137;97;29,4;38,1
2006;3526704;Leme;87511;44048;43463;98,7;31,2;217,2
2006;3526803;Lençóis Paulista;58993;29396;29597;100,7;31,5;72,9
2006;3526902;Limeira;265784;131203;134581;102,6;32,5;457,7
2006;3527009;Lindóia;6138;3065;3073;100,3;33,6;125,9
2006;3527108;Lins;69362;33666;35696;106;34,3;121,7
2006;3527207;Lorena;80792;39154;41638;106,3;32,3;195,1
2006;3527256;Lourdes;2082;1075;1007;93,7;35,1;18,3
2006;3527306;Louveira;31429;15922;15507;97,4;29,9;563,9
2006;3527405;Lucélia;19326;10154;9172;90,3;34,2;61,4
2006;3527504;Lucianópolis;2236;1139;1097;96,3;33,4;11,8
2006;3527603;Luís Antônio;9594;4943;4651;94,1;28,8;16
2006;3527702;Luiziânia;4716;2420;2296;94,9;33,4;28,3
2006;3527801;Lupércio;4323;2137;2186;102,3;31,9;27,9
2006;3527900;Lutécia;2810;1412;1398;99;33,5;5,9
2006;3528007;Macatuba;16094;8089;8005;99;31,3;71,7
2006;3528106;Macaubal;7534;3827;3707;96,9;36,3;30,4
2006;3528205;Macedônia;3725;1875;1850;98,7;35,6;11,4
2006;3528304;Magda;3274;1699;1575;92,7;36;10,5
2006;3528403;Mairinque;41843;20899;20944;100,2;30,5;199,1
2006;3528502;Mairiporã;72517;36606;35911;98,1;30,9;226,1
2006;3528601;Manduri;8723;4412;4311;97,7;33,4;38,1
2006;3528700;Marabá Paulista;4378;2542;1836;72,2;32,2;4,8
2006;3528809;Maracaí;13227;6669;6558;98,3;32,6;24,8
2006;3528858;Marapoama;2490;1276;1214;95,1;34,7;22,4
2006;3528908;Mariápolis;3888;1997;1891;94,7;34,6;20,8
2006;3529005;Marília;209355;101705;107650;105,8;33,5;178,9
2006;3529104;Marinópolis;2174;1106;1068;96,6;33,7;27,9
2006;3529203;Martinópolis;23451;12130;11321;93,3;33,5;18,7
2006;3529302;Matão;75160;37385;37775;101;32,5;143,2
2006;3529401;Mauá;396930;194809;202121;103,8;29,9;6408,6
2006;3529500;Mendonça;4270;2176;2094;96,2;35,6;21,9
2006;3529609;Meridiano;3949;1976;1973;99,8;34,9;17,3
2006;3529658;Mesópolis;1913;982;931;94,8;34,4;12,9
2006;3529708;Miguelópolis;19915;9971;9944;99,7;31,4;24,3
2006;3529807;Mineiros do Tietê;11841;5922;5919;99,9;32,3;55,5
2006;3529906;Miracatu;21496;10965;10531;96;29,6;21,5
2006;3530003;Mira Estrela;2749;1401;1348;96,2;35,5;12,7
2006;3530102;Mirandópolis;26898;14560;12338;84,7;35,1;29,3
2006;3530201;Mirante do Paranapanema;16711;8501;8210;96,6;33,6;13,5
2006;3530300;Mirassol;51620;25402;26218;103,2;34;212,2
2006;3530409;Mirassolândia;4059;2075;1984;95,6;34,1;24,4
2006;3530508;Mococa;66327;33236;33091;99,6;33,5;77,6
2006;3530607;Mogi das Cruzes;365241;178757;186484;104,3;30,9;512,6
2006;3530706;Mogi Guaçu;132232;65977;66255;100,4;32,4;162,7
2006;3530805;Mogi Mirim;84531;41891;42640;101,8;33,5;169,8
2006;3530904;Mombuca;3209;1637;1572;96;30,8;24
2006;3531001;Monções;2112;1087;1025;94,3;36,7;20,2
2006;3531100;Mongaguá;41785;21102;20683;98;32,5;292,7
2006;3531209;Monte Alegre do Sul;6812;3428;3384;98,7;35,1;61,8
2006;3531308;Monte Alto;45548;22591;22957;101,6;34,5;131,3
2006;3531407;Monte Aprazível;20306;10086;10220;101,3;35,5;41
2006;3531506;Monte Azul Paulista;19307;9715;9592;98,7;33,3;73,3
2006;3531605;Monte Castelo;4082;2038;2044;100,3;36,2;17,5
2006;3531704;Monteiro Lobato;3906;2030;1876;92,4;33;11,7
2006;3531803;Monte Mor;44190;22150;22040;99,5;29,9;183,7
2006;3531902;Morro Agudo;27589;14098;13491;95,7;29,9;19,9
2006;3532009;Morungaba;11028;5550;5478;98,7;31,6;75,1
2006;3532058;Motuca;4132;2107;2025;96,1;31,4;18,1
2006;3532108;Murutinga do Sul;4107;2067;2040;98,7;37,3;16,4
2006;3532157;Nantes;2543;1286;1257;97,7;30,3;8,9
2006;3532207;Narandiba;4049;2053;1996;97,2;31;11,3
2006;3532306;Natividade da Serra;6802;3567;3235;90,7;34,5;8,2
2006;3532405;Nazaré Paulista;15662;8073;7589;94;32,6;48
2006;3532504;Neves Paulista;8859;4428;4431;100,1;37;40,4
2006;3532603;Nhandeara;10528;5179;5349;103,3;37,2;24,1
2006;3532702;Nipoã;3824;2000;1824;91,2;32,8;27,8
2006;3532801;Nova Aliança;5427;2692;2735;101,6;35,3;24,9
2006;3532827;Nova Campina;8085;4165;3920;94,1;27,3;21
2006;3532843;Nova Canaã Paulista;2278;1171;1107;94,5;38,2;18,3
2006;3532868;Nova Castilho;1057;532;525;98,7;33,8;5,8
2006;3532900;Nova Europa;8436;4245;4191;98,7;31,3;52,6
2006;3533007;Nova Granada;18251;9178;9073;98,9;33,4;34,3
2006;3533106;Nova Guataporanga;2160;1107;1053;95,1;36,5;63,2
2006;3533205;Nova Independência;2641;1322;1319;99,8;32,4;10
2006;3533254;Novais;3981;2120;1861;87,8;30,6;33,8
2006;3533304;Nova Luzitânia;3139;1649;1490;90,4;32,7;42,5
2006;3533403;Nova Odessa;47666;23616;24050;101,8;32,2;646
2006;3533502;Novo Horizonte;34921;17398;17523;100,7;34,1;37,5
2006;3533601;Nuporanga;6617;3331;3286;98,6;33,4;19
2006;3533700;Ocauçu;4169;2150;2019;93,9;33,2;13,8
2006;3533809;Óleo;2806;1421;1385;97,5;35,1;14,1
2006;3533908;Olímpia;48470;23964;24506;102,3;34;60,4
2006;3534005;Onda Verde;3718;1901;1817;95,6;32,1;15,3
2006;3534104;Oriente;6031;2967;3064;103,3;34,6;27,6
2006;3534203;Orindiúva;5040;2578;2462;95,5;30;20,4
2006;3534302;Orlândia;38388;18910;19478;103;32,5;131,6
2006;3534401;Osasco;663128;320513;342615;106,9;31;10209,2
2006;3534500;Oscar Bressane;2523;1220;1303;106,8;36,7;11,4
2006;3534609;Osvaldo Cruz;30580;15252;15328;100,5;35,9;123,3
2006;3534708;Ourinhos;99545;48535;51010;105,1;32,9;336,5
2006;3534757;Ouroeste;7517;3759;3758;100;33,4;26
2006;3534807;Ouro Verde;7557;3766;3791;100,7;32,7;28,3
2006;3534906;Pacaembu;12952;7291;5661;77,6;35,5;38,2
2006;3535002;Palestina;10215;5133;5082;99;35,8;14,6
2006;3535101;Palmares Paulista;9907;5199;4708;90,6;29,1;120,6
2006;3535200;Palmeira d'Oeste;9938;5014;4924;98,2;36,4;31,2
2006;3535309;Palmital;21024;10330;10694;103,5;35,1;38,3
2006;3535408;Panorama;14261;7202;7059;98;31,1;40,1
2006;3535507;Paraguaçu Paulista;41315;20650;20665;100,1;32,5;41,3
2006;3535606;Paraibuna;17334;8842;8492;96;31,9;21,4
2006;3535705;Paraíso;5707;2936;2771;94,4;33,6;36,8
2006;3535804;Paranapanema;16948;8705;8243;94,7;30,3;16,6
2006;3535903;Paranapuã;3774;1929;1845;95,6;34,6;26,9
2006;3536000;Parapuã;11013;5613;5400;96,2;35,3;30
2006;3536109;Pardinho;5227;2689;2538;94,4;31,1;24,9
2006;3536208;Pariquera-Açu;18189;9078;9111;100,4;31,1;50,6
2006;3536257;Parisi;2001;1034;967;93,5;35,8;23,6
2006;3536307;Patrocínio Paulista;12344;6282;6062;96,5;31,8;20,5
2006;3536406;Paulicéia;5927;3082;2845;92,3;31;15,8
2006;3536505;Paulínia;69348;34507;34841;101;30,7;499,7
2006;3536570;Paulistânia;1788;943;845;89,6;32,6;7
2006;3536604;Paulo de Faria;8592;4299;4293;99,9;33;11,6
2006;3536703;Pederneiras;39587;19939;19648;98,5;31,7;54,4
2006;3536802;Pedra Bela;5707;3000;2707;90,2;33,7;36
2006;3536901;Pedranópolis;2647;1358;1289;94,9;36,4;10,2
2006;3537008;Pedregulho;15445;7875;7570;96,1;31,5;21,7
2006;3537107;Pedreira;39120;19403;19717;101,6;32,8;359,5
2006;3537156;Pedrinhas Paulista;2927;1468;1459;99,4;33,4;19,2
2006;3537206;Pedro de Toledo;9894;5015;4879;97,3;31,3;14,8
2006;3537305;Penápolis;57027;27860;29167;104,7;34,3;80,2
2006;3537404;Pereira Barreto;25013;12326;12687;102,9;33,6;25,7
2006;3537503;Pereiras;6904;3518;3386;96,2;33,4;30,9
2006;3537602;Peruíbe;56593;27857;28736;103,2;32,4;173,5
2006;3537701;Piacatu;5005;2521;2484;98,5;34;21,5
2006;3537800;Piedade;51552;26593;24959;93,9;31,9;69
2006;3537909;Pilar do Sul;25591;13081;12510;95,6;30,8;37,6
2006;3538006;Pindamonhangaba;138943;68754;70189;102,1;31;190
2006;3538105;Pindorama;14303;7291;7012;96,2;35,1;77,4
2006;3538204;Pinhalzinho;12237;6233;6004;96,3;34,2;79,2
2006;3538303;Piquerobi;3524;1765;1759;99,7;34,4;7,3
2006;3538501;Piquete;14594;7083;7511;106;33,9;82,9
2006;3538600;Piracaia;24506;12312;12194;99;32,7;63,6
2006;3538709;Piracicaba;350887;172298;178589;103,7;32,9;254,6
2006;3538808;Piraju;28490;13888;14602;105,1;33,9;56,5
2006;3538907;Pirajuí;21722;11845;9877;83,4;34;26,4
2006;3539004;Pirangi;10408;5303;5105;96,3;35,2;48,2
2006;3539103;Pirapora do Bom Jesus;14459;7212;7247;100,5;27,9;133,3
2006;3539202;Pirapozinho;23741;11619;12122;104,3;32,8;49,7
2006;3539301;Pirassununga;68055;33428;34627;103,6;33,9;93,6
2006;3539400;Piratininga;11522;5762;5760;100;34,1;28,6
2006;3539509;Pitangueiras;33788;17269;16519;95,7;29,9;78,5
2006;3539608;Planalto;4111;2118;1993;94,1;32;14,2
2006;3539707;Platina;3072;1600;1472;92;32,2;9,4
2006;3539806;Poá;101804;49549;52255;105,5;30;5897
2006;3539905;Poloni;5110;2506;2604;103,9;36,6;37,8
2006;3540002;Pompéia;19304;9520;9784;102,8;33,6;24,6
2006;3540101;Pongaí;3586;1853;1733;93,5;36,4;19,6
2006;3540200;Pontal;35836;18567;17269;93;28,8;100,6
2006;3540259;Pontalinda;3854;2034;1820;89,5;31,9;18,4
2006;3540309;Pontes Gestal;2507;1246;1261;101,2;34,9;11,5
2006;3540408;Populina;4322;2207;2115;95,8;35,6;13,7
2006;3540507;Porangaba;7686;3998;3688;92,2;34,3;28,9
2006;3540606;Porto Feliz;47649;23915;23734;99,2;32;85,6
2006;3540705;Porto Ferreira;49869;24795;25074;101,1;32,8;203,6
2006;3540754;Potim;17008;9189;7819;85,1;28,8;381
2006;3540804;Potirendaba;14660;7481;7179;96;35,4;42,8
2006;3540853;Pracinha;2296;1448;848;58,6;32,7;36,4
2006;3540903;Pradópolis;15494;7894;7600;96,3;30,8;92,6
2006;3541000;Praia Grande;234130;113330;120800;106,6;31,9;1564,5
2006;3541059;Pratânia;4347;2254;2093;92,9;30,3;24,8
2006;3541109;Presidente Alves;4181;2095;2086;99,6;33,6;14,6
2006;3541208;Presidente Bernardes;14116;7118;6998;98,3;35,6;18,8
2006;3541307;Presidente Epitácio;40587;20006;20581;102,9;32,1;32,2
2006;3541406;Presidente Prudente;200688;96961;103727;107;33,6;358
2006;3541505;Presidente Venceslau;37859;18922;18937;100,1;34,6;50,1
2006;3541604;Promissão;33872;16957;16915;99,8;32,7;43,5
2006;3541653;Quadra;2984;1580;1404;88,9;33,2;14,5
2006;3541703;Quatá;12289;6123;6166;100,7;32;18,9
2006;3541802;Queiroz;2569;1309;1260;96,3;31,1;10,9
2006;3541901;Queluz;10476;5273;5203;98,7;30,9;42
2006;3542008;Quintana;5779;2886;2893;100,2;33,5;18,1
2006;3542107;Rafard;8520;4235;4285;101,2;32,5;70
2006;3542206;Rancharia;28963;14292;14671;102,7;33,2;18,2
2006;3542305;Redenção da Serra;3948;2084;1864;89,4;33,6;12,8
2006;3542404;Regente Feijó;17928;8937;8991;100,6;33,5;68,1
2006;3542503;Reginópolis;6286;3631;2655;73,1;33,1;15,3
2006;3542602;Registro;54410;26914;27496;102,2;30,9;75,3
2006;3542701;Restinga;6185;3120;3065;98,2;29,5;25,2
2006;3542800;Ribeira;3467;1807;1660;91,9;32,7;10,3
2006;3542909;Ribeirão Bonito;11786;5951;5835;98,1;31,7;25
2006;3543006;Ribeirão Branco;19844;10273;9571;93,2;27,7;28,5
2006;3543105;Ribeirão Corrente;4113;2148;1965;91,5;30,4;27,7
2006;3543204;Ribeirão do Sul;4470;2259;2211;97,9;34,3;22
2006;3543238;Ribeirão dos Índios;2213;1112;1101;99;36;11,3
2006;3543253;Ribeirão Grande;7459;3829;3630;94,8;30,8;22,4
2006;3543303;Ribeirão Pires;110146;54129;56017;103,5;31,9;1112,9
2006;3543402;Ribeirão Preto;564808;271387;293421;108,1;33,2;867,7
2006;3543501;Riversul;6633;3325;3308;99,5;33,2;17,2
2006;3543600;Rifaina;3420;1730;1690;97,7;33,9;21
2006;3543709;Rincão;10429;5262;5167;98,2;31,4;32,9
2006;3543808;Rinópolis;10070;5137;4933;96;35,8;28,1
2006;3543907;Rio Claro;178912;87258;91654;105;33,7;359
2006;3544004;Rio das Pedras;26987;13683;13304;97,2;30,6;119,1
2006;3544103;Rio Grande da Serra;41366;20553;20813;101,3;29;1138,3
2006;3544202;Riolândia;9702;5483;4219;76,9;31,7;15,4
2006;3544251;Rosana;21739;10917;10822;99,1;30;29,2
2006;3544301;Roseira;9175;4653;4522;97,2;30,7;70,7
2006;3544400;Rubiácea;2554;1306;1248;95,6;32,1;10,8
2006;3544509;Rubinéia;2775;1366;1409;103,1;36,6;11,4
2006;3544608;Sabino;5083;2552;2531;99,2;34,8;16,7
2006;3544707;Sagres;2406;1213;1193;98,4;33,8;16,3
2006;3544806;Sales;5071;2593;2478;95,6;34,2;16,4
2006;3544905;Sales Oliveira;10054;5009;5045;100,7;33,3;32,9
2006;3545001;Salesópolis;15201;7695;7506;97,5;31,6;35,8
2006;3545100;Salmourão;4651;2380;2271;95,4;33,6;26,9
2006;3545159;Saltinho;6513;3263;3250;99,6;34,1;65,3
2006;3545209;Salto;100645;50004;50641;101,3;31,6;756,4
2006;3545308;Salto de Pirapora;38166;19051;19115;100,3;31,2;136,1
2006;3545407;Salto Grande;8704;4344;4360;100,4;33,4;46,2
2006;3545506;Sandovalina;3460;1738;1722;99,1;30,4;7,6
2006;3545605;Santa Adélia;14033;7039;6994;99,4;33,6;42,5
2006;3545704;Santa Albertina;5692;2875;2817;98;37;20,9
2006;3545803;Santa Bárbara d'Oeste;176320;87757;88563;100,9;32,2;650,6
2006;3546009;Santa Branca;13518;6792;6726;99;32,5;49,7
2006;3546108;Santa Clara d'Oeste;2111;1074;1037;96,6;35,6;11,5
2006;3546207;Santa Cruz da Conceição;3817;1914;1903;99,4;34,4;25,4
2006;3546256;Santa Cruz da Esperança;1896;950;946;99,6;32,2;12,8
2006;3546306;Santa Cruz das Palmeiras;28173;14291;13882;97,1;31,4;95,4
2006;3546405;Santa Cruz do Rio Pardo;42831;21077;21754;103,2;33,5;38,4
2006;3546504;Santa Ernestina;5664;2975;2689;90,4;30,2;42,1
2006;3546603;Santa Fé do Sul;28231;13661;14570;106,7;35,4;136,7
2006;3546702;Santa Gertrudes;19256;9782;9474;96,9;30;195,9
2006;3546801;Santa Isabel;47957;24106;23851;98,9;31;132
2006;3546900;Santa Lúcia;8045;4077;3968;97,3;30,2;52,3
2006;3547007;Santa Maria da Serra;5087;2613;2474;94,7;30,8;20,1
2006;3547106;Santa Mercedes;2850;1434;1416;98,7;33,8;17,1
2006;3547205;Santana da Ponte Pensa;1741;888;853;96,1;39;13,4
2006;3547304;Santana de Parnaíba;94553;46878;47675;101,7;29,2;525,4
2006;3547403;Santa Rita d'Oeste;2626;1321;1305;98,8;38,3;12,5
2006;3547502;Santa Rita do Passa Quatro;26430;12832;13598;106;36,6;35
2006;3547601;Santa Rosa de Viterbo;22860;11334;11526;101,7;33,3;79,2
2006;3547650;Santa Salete;1434;740;694;93,8;38;18,1
2006;3547700;Santo Anastácio;20678;10104;10574;104,7;34,6;37,4
2006;3547809;Santo André;667104;321126;345978;107,7;34;3795,1
2006;3547908;Santo Antônio da Alegria;6121;3179;2942;92,5;33,8;19,7
2006;3548005;Santo Antônio de Posse;19649;9900;9749;98,5;31,5;127,5
2006;3548054;Santo Antônio do Aracanguá;7354;3779;3575;94,6;32,2;5,6
2006;3548104;Santo Antônio do Jardim;6044;3125;2919;93,4;34;55
2006;3548203;Santo Antônio do Pinhal;6437;3272;3165;96,7;31,5;48,4
2006;3548302;Santo Expedito;2696;1372;1324;96,5;35,1;28,5
2006;3548401;Santópolis do Aguapeí;4080;2067;2013;97,4;31,6;31,9
2006;3548500;Santos;420032;193100;226932;117,5;37,4;1494,6
2006;3548609;São Bento do Sapucaí;10449;5271;5178;98,2;34;41,4
2006;3548708;São Bernardo do Campo;740845;359072;381773;106,3;31,7;1809
2006;3548807;São Caetano do Sul;145568;67560;78008;115,5;38,1;9495,2
2006;3548906;São Carlos;210335;103639;106696;102,9;33,5;185
2006;3549003;São Francisco;2841;1431;1410;98,5;35,9;37,6
2006;3549102;São João da Boa Vista;81389;39706;41683;105;34,6;157,6
2006;3549201;São João das Duas Pontes;2624;1330;1294;97,3;34,2;20,3
2006;3549250;São João de Iracema;1737;876;861;98,3;34,2;9,7
2006;3549300;São João do Pau d'Alho;2137;1075;1062;98,8;37,7;18,2
2006;3549409;São Joaquim da Barra;44593;21913;22680;103,5;32,8;108,5
2006;3549508;São José da Bela Vista;8301;4247;4054;95,5;30,2;30
2006;3549607;São José do Barreiro;4117;2099;2018;96,1;32,3;7,2
2006;3549706;São José do Rio Pardo;51343;25349;25994;102,5;33,9;122,3
2006;3549805;São José do Rio Preto;387956;186906;201050;107,6;34,3;898,2
2006;3549904;São José dos Campos;593252;291822;301430;103,3;31,1;539,6
2006;3549953;São Lourenço da Serra;13295;6748;6547;97;30,3;71,3
2006;3550001;São Luiz do Paraitinga;10478;5395;5083;94,2;33,9;17
2006;3550100;São Manuel;37791;18606;19185;103,1;32,5;58,1
2006;3550209;São Miguel Arcanjo;31319;15971;15348;96,1;30,4;33,7
2006;3550308;São Paulo;10944889;5198384;5746505;110,5;32,6;7194,9
2006;3550407;São Pedro;30196;14789;15407;104,2;34;49,4
2006;3550506;São Pedro do Turvo;7110;3615;3495;96,7;32,4;9,7
2006;3550605;São Roque;74253;36716;37537;102,2;32,7;241,9
2006;3550704;São Sebastião;67441;33873;33568;99,1;29,6;167,6
2006;3550803;São Sebastião da Grama;12304;6273;6031;96,1;32,9;48,7
2006;3550902;São Simão;14118;6987;7131;102,1;33,3;22,9
2006;3551009;São Vicente;321162;154961;166201;107,3;31,7;2167,8
2006;3551108;Sarapuí;8600;4414;4186;94,8;31,6;24,4
2006;3551207;Sarutaiá;3654;1835;1819;99,1;32,7;25,8
2006;3551306;Sebastianópolis do Sul;2817;1429;1388;97,1;35,9;16,8
2006;3551405;Serra Azul;9730;5503;4227;76,8;30,7;34,4
2006;3551504;Serrana;36350;18259;18091;99,1;29,2;288,4
2006;3551603;Serra Negra;25430;12465;12965;104;35,5;124,8
2006;3551702;Sertãozinho;103724;51777;51947;100,3;31,4;257,3
2006;3551801;Sete Barras;13362;6920;6442;93,1;30,5;12,6
2006;3551900;Severínia;14739;7658;7081;92,5;30,4;104,9
2006;3552007;Silveiras;5671;2887;2784;96,4;32;13,7
2006;3552106;Socorro;35146;17493;17653;100,9;35,5;78,3
2006;3552205;Sorocaba;549317;269427;279890;103,9;32;1221,1
2006;3552304;Sud Mennucci;7373;3736;3637;97,4;32,1;12,4
2006;3552403;Sumaré;222803;111195;111608;100,4;30;1451,8
2006;3552502;Suzano;249742;123017;126725;103;29,6;1211
2006;3552551;Suzanápolis;3133;1618;1515;93,6;33,8;9,5
2006;3552601;Tabapuã;11004;5570;5434;97,6;35;31,8
2006;3552700;Tabatinga;14089;7215;6874;95,3;32,2;38,2
2006;3552809;Taboão da Serra;226060;108573;117487;108,2;29,5;11088
2006;3552908;Taciba;5528;2783;2745;98,6;32,5;9,1
2006;3553005;Taguaí;9418;4715;4703;99,7;31;64,8
2006;3553104;Taiaçu;5815;2937;2878;98;33;54,3
2006;3553203;Taiúva;5490;2735;2755;100,7;35,4;41,4
2006;3553302;Tambaú;22455;11263;11192;99,4;32,9;40
2006;3553401;Tanabi;23475;11705;11770;100,6;35,4;31,4
2006;3553500;Tapiraí;8325;4235;4090;96,6;29,9;11
2006;3553609;Tapiratiba;12867;6400;6467;101;32,7;58
2006;3553658;Taquaral;2750;1402;1348;96,1;32,8;51
2006;3553708;Taquaritinga;53438;26655;26783;100,5;33,2;89,9
2006;3553807;Taquarituba;22230;11105;11125;100,2;31,9;49,6
2006;3553856;Taquarivaí;4910;2480;2430;98;27,8;21,2
2006;3553906;Tarabai;6292;3169;3123;98,5;31,2;31,2
2006;3553955;Tarumã;11963;6117;5846;95,6;30,4;39,5
2006;3554003;Tatuí;101895;50521;51374;101,7;31,7;194,5
2006;3554102;Taubaté;265077;130311;134766;103,4;32,1;424,1
2006;3554201;Tejupá;5063;2622;2441;93,1;30;17,1
2006;3554300;Teodoro Sampaio;20920;10464;10456;99,9;30,4;13,4
2006;3554409;Terra Roxa;8197;4166;4031;96,8;32,7;37
2006;3554508;Tietê;34717;17218;17499;101,6;33,2;85,8
2006;3554607;Timburi;2694;1391;1303;93,7;35;13,7
2006;3554656;Torre de Pedra;2223;1164;1059;91;34,9;31,2
2006;3554706;Torrinha;9128;4616;4512;97,7;34,8;29
2006;3554755;Trabiju;1476;748;728;97,3;31,6;23,3
2006;3554805;Tremembé;38534;20250;18284;90,3;31,3;201,6
2006;3554904;Três Fronteiras;5340;2680;2660;99,3;36,2;35,2
2006;3554953;Tuiuti;5542;2840;2702;95,1;35,2;43,7
2006;3555000;Tupã;63697;30930;32767;105,9;35,7;101,4
2006;3555109;Tupi Paulista;13916;7164;6752;94,2;37,6;56,9
2006;3555208;Turiúba;1920;991;929;93,7;37,4;12,5
2006;3555307;Turmalina;2156;1074;1082;100,7;37,9;14,6
2006;3555356;Ubarana;4881;2522;2359;93,5;30,2;23,3
2006;3555406;Ubatuba;74309;37240;37069;99,5;29,9;104,9
2006;3555505;Ubirajara;4303;2211;2092;94,6;32,9;15,2
2006;3555604;Uchoa;9305;4647;4658;100,2;35,5;36,9
2006;3555703;União Paulista;1513;790;723;91,5;33,9;19,1
2006;3555802;Urânia;8869;4423;4446;100,5;35,7;42,4
2006;3555901;Uru;1307;679;628;92,5;35,6;8,9
2006;3556008;Urupês;12411;6202;6209;100,1;36;38,3
2006;3556107;Valentim Gentil;10044;5074;4970;98;33;67,1
2006;3556206;Valinhos;97168;48159;49009;101,8;33,5;654,2
2006;3556305;Valparaíso;20855;11237;9618;85,6;31,9;24,3
2006;3556354;Vargem;8059;4142;3917;94,6;33,5;56,5
2006;3556404;Vargem Grande do Sul;38116;18965;19151;101;32,8;142,7
2006;3556453;Vargem Grande Paulista;38761;19328;19433;100,5;29,6;912,3
2006;3556503;Várzea Paulista;101190;50633;50557;99,8;29,6;2881,3
2006;3556602;Vera Cruz;10950;5413;5537;102,3;34,3;44,2
2006;3556701;Vinhedo;56803;28196;28607;101,5;32,8;701,7
2006;3556800;Viradouro;16780;8475;8305;98;32,3;77,1
2006;3556909;Vista Alegre do Alto;6004;3060;2944;96,2;32,3;62,9
2006;3556958;Vitória Brasil;1716;884;832;94,1;34,1;34,4
2006;3557006;Votorantim;103979;51755;52224;100,9;30,5;564,5
2006;3557105;Votuporanga;81111;39683;41428;104,4;34,8;192,8
2006;3557154;Zacarias;2169;1102;1067;96,8;34,6;6,8
2006;3557204;Chavantes;12163;6057;6106;100,8;32,4;64,4
2006;3557303;Estiva Gerbi;9585;4883;4702;96,3;31,1;129,3
2007;3500105;Adamantina;33791;16417;17374;105,8;36,5;82
2007;3500204;Adolfo;3629;1835;1794;97,8;35,1;17,2
2007;3500303;Aguaí;30994;15605;15389;98,6;32,2;65,3
2007;3500402;Águas da Prata;7419;3685;3734;101,3;36,7;52
2007;3500501;Águas de Lindóia;16979;8350;8629;103,3;34,6;282,4
2007;3500550;Águas de Santa Bárbara;5508;2751;2757;100,2;33,7;13,6
2007;3500600;Águas de São Pedro;2450;1138;1312;115,3;40,2;678,3
2007;3500709;Agudos;33996;16838;17158;101,9;31,8;35,2
2007;3500758;Alambari;4497;2282;2215;97,1;31,4;28,2
2007;3500808;Alfredo Marcondes;3867;1975;1892;95,8;37,2;32,5
2007;3500907;Altair;3722;1996;1726;86,5;31;11,9
2007;3501004;Altinópolis;15680;7871;7809;99,2;33,9;16,9
2007;3501103;Alto Alegre;4147;2142;2005;93,6;37,2;13
2007;3501152;Alumínio;16415;8283;8132;98,2;30;196,3
2007;3501202;Álvares Florence;4034;2077;1957;94,2;38,5;11,1
2007;3501301;Álvares Machado;23429;11653;11776;101,1;33;67,4
2007;3501400;Álvaro de Carvalho;4492;2794;1698;60,8;31,7;29,2
2007;3501509;Alvinlândia;2943;1472;1471;99,9;32,1;34,7
2007;3501608;Americana;202406;99448;102958;103,5;34,3;1511,5
2007;3501707;Américo Brasiliense;32492;16403;16089;98,1;29,7;264,3
2007;3501806;Américo de Campos;5679;2853;2826;99,1;36,2;22,5
2007;3501905;Amparo;64289;31807;32482;102,1;34,6;144,4
2007;3502002;Analândia;4083;2100;1983;94,4;33,2;12,5
2007;3502101;Andradina;55416;27272;28144;103,2;34,9;57,5
2007;3502200;Angatuba;21360;10875;10485;96,4;32,3;20,8
2007;3502309;Anhembi;5300;2732;2568;94;31,9;7,2
2007;3502408;Anhumas;3651;1833;1818;99,2;33,3;11,4
2007;3502507;Aparecida;34964;16968;17996;106,1;32,9;289,2
2007;3502606;Aparecida d'Oeste;4619;2268;2351;103,7;36,9;25,8
2007;3502705;Apiaí;26033;13044;12989;99,6;30,1;26,7
2007;3502754;Araçariguama;15261;7795;7466;95,8;28,8;105,1
2007;3502804;Araçatuba;178059;85823;92236;107,5;34,8;152,6
2007;3502903;Araçoiaba da Serra;25006;12507;12499;99,9;32,9;97,9
2007;3503000;Aramina;5012;2527;2485;98,3;34,2;24,7
2007;3503109;Arandu;6164;3118;3046;97,7;31,7;21,6
2007;3503158;Arapeí;2528;1264;1264;100;33,2;16,1
2007;3503208;Araraquara;200588;97029;103559;106,7;34,6;199,9
2007;3503307;Araras;114237;56641;57596;101,7;33,4;177,2
2007;3503356;Arco-Íris;2015;1034;981;94,9;35,6;7,6
2007;3503406;Arealva;7662;3911;3751;95,9;36,3;15,1
2007;3503505;Areias;3694;1842;1852;100,5;31,5;12,1
2007;3503604;Areiópolis;10516;5422;5094;94;29,4;122,4
2007;3503703;Ariranha;8237;4209;4028;95,7;33,8;62,1
2007;3503802;Artur Nogueira;40835;20437;20398;99,8;31;229,4
2007;3503901;Arujá;70135;34732;35403;101,9;29,9;729,3
2007;3503950;Aspásia;1831;926;905;97,7;36,1;26,4
2007;3504008;Assis;92686;45115;47571;105,4;34,5;201,2
2007;3504107;Atibaia;122225;60320;61905;102,6;32,8;255,4
2007;3504206;Auriflama;14036;7037;6999;99,5;34,9;32,3
2007;3504305;Avaí;4850;2470;2380;96,4;32,3;9
2007;3504404;Avanhandava;10553;5641;4912;87,1;31,1;31,2
2007;3504503;Avaré;80992;40277;40715;101,1;33;66,8
2007;3504602;Bady Bassitt;13650;6807;6843;100,5;33,1;123,7
2007;3504701;Balbinos;2978;2123;855;40,3;33,7;32,5
2007;3504800;Bálsamo;7907;3895;4012;103;36,2;52,8
2007;3504909;Bananal;10117;5015;5102;101,7;33,4;16,4
2007;3505005;Barão de Antonina;2990;1525;1465;96,1;33,8;19,5
2007;3505104;Barbosa;6386;3218;3168;98,4;32,4;31,1
2007;3505203;Bariri;30633;15344;15289;99,6;34,7;68,9
2007;3505302;Barra Bonita;35395;17443;17952;102,9;34,6;235,8
2007;3505351;Barra do Chapéu;5159;2744;2415;88;30,3;12,7
2007;3505401;Barra do Turvo;7889;4144;3745;90,4;30,6;7,8
2007;3505500;Barretos;109525;53079;56446;106,3;34;69,9
2007;3505609;Barrinha;27138;13683;13455;98,3;28,8;185,8
2007;3505708;Barueri;231011;112946;118065;104,5;29,2;3516,1
2007;3505807;Bastos;20622;10162;10460;102,9;32,8;120,7
2007;3505906;Batatais;54867;27034;27833;103;34;64,6
2007;3506003;Bauru;336085;163332;172753;105,8;33,6;503,4
2007;3506102;Bebedouro;75218;36779;38439;104,5;33,8;110,1
2007;3506201;Bento de Abreu;2567;1306;1261;96,6;32,9;8,5
2007;3506300;Bernardino de Campos;10791;5288;5503;104,1;35,3;44,2
2007;3506359;Bertioga;42058;21256;20802;97,9;28,9;85,6
2007;3506409;Bilac;6780;3358;3422;101,9;36;42,9
2007;3506508;Birigui;104238;51043;53195;104,2;33,7;196,7
2007;3506607;Biritiba Mirim;27416;13855;13561;97,9;30,8;86,4
2007;3506706;Boa Esperança do Sul;13356;6746;6610;98;31,1;19,3
2007;3506805;Bocaina;10417;5194;5223;100,6;33,2;28,6
2007;3506904;Bofete;8908;4584;4324;94,3;32,8;13,6
2007;3507001;Boituva;43868;22124;21744;98,3;31,3;176,2
2007;3507100;Bom Jesus dos Perdões;17730;8923;8807;98,7;31,1;163,6
2007;3507159;Bom Sucesso de Itararé;3466;1770;1696;95,8;27,7;25,9
2007;3507209;Borá;809;411;398;96,8;32,6;6,8
2007;3507308;Boracéia;4105;2100;2005;95,5;32,5;33,6
2007;3507407;Borborema;14160;7171;6989;97,5;34,7;25,6
2007;3507456;Borebi;2192;1105;1087;98,4;31;6,3
2007;3507506;Botucatu;121534;59077;62457;105,7;33,6;82
2007;3507605;Bragança Paulista;140374;69147;71227;103;33,2;273,9
2007;3507704;Braúna;4803;2444;2359;96,5;35;24,6
2007;3507753;Brejo Alegre;2507;1289;1218;94,5;33;23,7
2007;3507803;Brodowski;19963;9944;10019;100,8;32,9;71,7
2007;3507902;Brotas;20790;10378;10412;100,3;33;18,9
2007;3508009;Buri;18337;9465;8872;93,7;29,7;15,3
2007;3508108;Buritama;14917;7468;7449;99,7;34,4;45,6
2007;3508207;Buritizal;3951;2019;1932;95,7;34,6;14,8
2007;3508306;Cabrália Paulista;4478;2277;2201;96,7;31,6;18,7
2007;3508405;Cabreúva;38952;19815;19137;96,6;29,2;149,7
2007;3508504;Caçapava;82114;40726;41388;101,6;32,2;222,5
2007;3508603;Cachoeira Paulista;29245;14389;14856;103,2;33;101,5
2007;3508702;Caconde;18628;9374;9254;98,7;33,1;39,8
2007;3508801;Cafelândia;16386;8083;8303;102,7;34,4;17,8
2007;3508900;Caiabu;4094;2097;1997;95,2;34,4;16,2
2007;3509007;Caieiras;81849;40220;41629;103,5;30,1;838,3
2007;3509106;Caiuá;4772;2505;2267;90,5;33,7;8,7
2007;3509205;Cajamar;60002;30058;29944;99,6;28,9;456,7
2007;3509254;Cajati;28858;14681;14177;96,6;29,5;63,5
2007;3509304;Cajobi;9625;4957;4668;94,2;33,9;54,4
2007;3509403;Cajuru;22576;11351;11225;98,9;32,2;34,2
2007;3509452;Campina do Monte Alegre;5498;2830;2668;94,3;32,1;29,8
2007;3509502;Campinas;1045405;505885;539520;106,6;33,6;1315,7
2007;3509601;Campo Limpo Paulista;70926;35028;35898;102,5;30,9;893,2
2007;3509700;Campos do Jordão;47044;23146;23898;103,2;30,5;162,2
2007;3509809;Campos Novos Paulista;4434;2280;2154;94,5;33,1;9,2
2007;3509908;Cananéia;12285;6172;6113;99;31,3;9,9
2007;3509957;Canas;4123;2107;2016;95,7;30;77,4
2007;3510005;Cândido Mota;29779;14698;15081;102,6;33,8;50
2007;3510104;Cândido Rodrigues;2655;1307;1348;103,1;37,5;37,5
2007;3510153;Canitar;4145;2108;2037;96,6;29,2;72,1
2007;3510203;Capão Bonito;46808;23405;23403;100;30,9;28,5
2007;3510302;Capela do Alto;16553;8519;8034;94,3;30,6;97,4
2007;3510401;Capivari;46443;23231;23212;99,9;31,7;143,8
2007;3510500;Caraguatatuba;94099;46873;47226;100,8;31,4;194
2007;3510609;Carapicuíba;362319;176432;185887;105,4;29,7;10488,1
2007;3510708;Cardoso;11814;5839;5975;102,3;35,5;18,5
2007;3510807;Casa Branca;27838;14725;13113;89,1;34,2;32,2
2007;3510906;Cássia dos Coqueiros;2730;1402;1328;94,7;34,1;14,2
2007;3511003;Castilho;17032;8500;8532;100,4;33,1;16
2007;3511102;Catanduva;110733;53914;56819;105,4;35,2;381,1
2007;3511201;Catiguá;6948;3548;3400;95,8;33,4;46,8
2007;3511300;Cedral;7587;3798;3789;99,8;36,2;38,3
2007;3511409;Cerqueira César;16854;8366;8488;101,5;32,8;32,9
2007;3511508;Cerquilho;36440;18117;18323;101,1;32,7;285,1
2007;3511607;Cesário Lange;14729;7667;7062;92,1;32,2;77,4
2007;3511706;Charqueada;14433;7327;7106;97;31,8;82,1
2007;3511904;Clementina;6488;3360;3128;93,1;31,6;38,5
2007;3512001;Colina;17215;8572;8643;100,8;33,3;40,8
2007;3512100;Colômbia;5993;3078;2915;94,7;31,3;8,2
2007;3512209;Conchal;24502;12378;12124;97,9;30,5;134
2007;3512308;Conchas;15867;8016;7851;97,9;33,9;34
2007;3512407;Cordeirópolis;20013;10045;9968;99,2;32,3;145,5
2007;3512506;Coroados;4995;2500;2495;99,8;33,3;20,2
2007;3512605;Coronel Macedo;5191;2664;2527;94,9;32,5;17,1
2007;3512704;Corumbataí;3852;1980;1872;94,5;32,7;13,8
2007;3512803;Cosmópolis;54306;27166;27140;99,9;31,1;351,1
2007;3512902;Cosmorama;7288;3685;3603;97,8;37,2;16,5
2007;3513009;Cotia;185079;90936;94143;103,5;30,1;571,2
2007;3513108;Cravinhos;30791;15509;15282;98,5;32,1;98,9
2007;3513207;Cristais Paulista;7288;3733;3555;95,2;32;18,9
2007;3513306;Cruzália;2397;1178;1219;103,5;35;16,1
2007;3513405;Cruzeiro;76133;37135;38998;105;32,9;249
2007;3513504;Cubatão;115882;57991;57891;99,8;30;811
2007;3513603;Cunha;22401;11495;10906;94,9;32,7;15,9
2007;3513702;Descalvado;30436;15072;15364;101,9;34;40,4
2007;3513801;Diadema;378254;183900;194354;105,7;29,9;12308,1
2007;3513850;Dirce Reis;1670;859;811;94,4;36,5;18,9
2007;3513900;Divinolândia;11545;5801;5744;99;35,1;51,6
2007;3514007;Dobrada;7624;3982;3642;91,5;29,7;50,9
2007;3514106;Dois Córregos;23992;12037;11955;99,3;33,2;37,9
2007;3514205;Dolcinópolis;2123;1109;1014;91,4;36,6;27,2
2007;3514304;Dourado;8626;4390;4236;96,5;35,2;41,9
2007;3514403;Dracena;42487;20921;21566;103,1;36,2;87,1
2007;3514502;Duartina;12395;6059;6336;104,6;35,6;46,9
2007;3514601;Dumont;7599;3846;3753;97,6;31,6;68,2
2007;3514700;Echaporã;6501;3219;3282;102;33,5;12,6
2007;3514809;Eldorado;14621;7508;7113;94,7;29,9;8,8
2007;3514908;Elias Fausto;15230;7875;7355;93,4;30,9;75,3
2007;3514924;Elisiário;2957;1561;1396;89,4;34,5;31,5
2007;3514957;Embaúba;2444;1272;1172;92,1;34,6;29,4
2007;3515004;Embu das Artes;230299;112426;117873;104,8;28,7;3271,4
2007;3515103;Embu-Guaçu;61127;30470;30657;100,6;30,2;392,7
2007;3515129;Emilianópolis;3001;1514;1487;98,2;35,4;13,3
2007;3515152;Engenheiro Coelho;13907;7262;6645;91,5;28,8;126,5
2007;3515186;Espírito Santo do Pinhal;41628;20455;21173;103,5;34,5;106,9
2007;3515194;Espírito Santo do Turvo;4077;2069;2008;97,1;30;21,1
2007;3515202;Estrela d'Oeste;8248;4168;4080;97,9;35,3;27,8
2007;3515301;Estrela do Norte;2638;1367;1271;93;32,1;10
2007;3515350;Euclides da Cunha Paulista;9841;4968;4873;98,1;30,7;17,1
2007;3515400;Fartura;15220;7449;7771;104,3;33,8;35,5
2007;3515509;Fernandópolis;63969;31270;32699;104,6;35,6;116,4
2007;3515608;Fernando Prestes;5506;2725;2781;102,1;36,9;32,4
2007;3515657;Fernão;1538;784;754;96,2;34,2;15,3
2007;3515707;Ferraz de Vasconcelos;160591;78663;81928;104,2;28,8;5435
2007;3515806;Flora Rica;1908;960;948;98,8;36,8;8,5
2007;3515905;Floreal;3091;1537;1554;101,1;38,9;15,1
2007;3516002;Flórida Paulista;12302;6550;5752;87,8;34;23,5
2007;3516101;Florínea;2930;1427;1503;105,3;34,2;13
2007;3516200;Franca;309996;151846;158150;104,2;32,2;511,8
2007;3516309;Francisco Morato;148327;73747;74580;101,1;27,7;3027
2007;3516408;Franco da Rocha;124557;64071;60486;94,4;29,6;938,1
2007;3516507;Gabriel Monteiro;2713;1383;1330;96,2;36,5;19,6
2007;3516606;Gália;7298;3671;3627;98,8;34,9;20,5
2007;3516705;Garça;43240;21115;22125;104,8;34,2;77,8
2007;3516804;Gastão Vidigal;3984;2112;1872;88,6;33,3;22,1
2007;3516853;Gavião Peixoto;4333;2265;2068;91,3;31;17,8
2007;3516903;General Salgado;10707;5401;5306;98,2;35,2;21,7
2007;3517000;Getulina;10670;5781;4889;84,6;33,6;15,8
2007;3517109;Glicério;4533;2278;2255;99;33,5;16,6
2007;3517208;Guaiçara;10198;5123;5075;99,1;31,9;36,8
2007;3517307;Guaimbê;5395;2694;2701;100,3;32,7;24,8
2007;3517406;Guaíra;36642;18232;18410;101;32,9;29,1
2007;3517505;Guapiaçu;16655;8429;8226;97,6;33,7;51,2
2007;3517604;Guapiara;18734;9562;9172;95,9;30,9;45,9
2007;3517703;Guará;19630;9789;9841;100,5;31,1;54,2
2007;3517802;Guaraçaí;8603;4299;4304;100,1;35,8;15,1
2007;3517901;Guaraci;9606;4894;4712;96,3;32,5;15
2007;3518008;Guarani d'Oeste;1984;984;1000;101,6;35,8;23,2
2007;3518107;Guarantã;6394;3229;3165;98;31,4;13,8
2007;3518206;Guararapes;30090;14874;15216;102,3;34,5;31,5
2007;3518305;Guararema;24726;12482;12244;98,1;31,8;91,3
2007;3518404;Guaratinguetá;110004;53197;56807;106,8;33,5;146,2
2007;3518503;Guareí;13240;7712;5528;71,7;31,9;23,3
2007;3518602;Guariba;34107;17229;16878;98;30,4;126,2
2007;3518701;Guarujá;283414;138771;144643;104,2;30,4;1957,4
2007;3518800;Guarulhos;1177792;575587;602205;104,6;30;3695,9
2007;3518859;Guatapará;6818;3508;3310;94,4;31,6;16,5
2007;3518909;Guzolândia;4623;2376;2247;94,6;32,9;18,3
2007;3519006;Herculândia;8544;4287;4257;99,3;32,9;23,5
2007;3519055;Holambra;10033;5111;4922;96,3;31,3;153
2007;3519071;Hortolândia;180412;90984;89428;98,3;29,7;2890,5
2007;3519105;Iacanga;9470;4851;4619;95,2;33,9;17,3
2007;3519204;Iacri;6524;3302;3222;97,6;34,5;20,3
2007;3519253;Iaras;5333;3316;2017;60,8;31,1;13,3
2007;3519303;Ibaté;29451;15106;14345;95;30,1;101,2
2007;3519402;Ibirá;10450;5170;5280;102,1;35,3;38,4
2007;3519501;Ibirarema;6410;3247;3163;97,4;33,3;28,1
2007;3519600;Ibitinga;51045;25190;25855;102,6;33,5;74
2007;3519709;Ibiúna;69522;35509;34013;95,8;30,9;65,7
2007;3519808;Icém;7260;3687;3573;96,9;32,3;20
2007;3519907;Iepê;7532;3736;3796;101,6;34,5;12,7
2007;3520004;Igaraçu do Tietê;23177;11589;11588;100;31,6;237,1
2007;3520103;Igarapava;27327;13506;13821;102,3;33,4;58,3
2007;3520202;Igaratá;8744;4506;4238;94,1;32,1;29,8
2007;3520301;Iguape;28658;14439;14219;98,5;33,1;14,5
2007;3520400;Ilhabela;25905;13276;12629;95,1;29,8;74,8
2007;3520426;Ilha Comprida;8289;4138;4151;100,3;34,4;42,2
2007;3520442;Ilha Solteira;24798;12130;12668;104,4;34,4;38
2007;3520509;Indaiatuba;184663;91925;92738;100,9;32;592,7
2007;3520608;Indiana;4865;2448;2417;98,7;34,4;37,6
2007;3520707;Indiaporã;3954;1953;2001;102,5;37;14,1
2007;3520806;Inúbia Paulista;3544;1784;1760;98,7;34,5;40,7
2007;3520905;Ipaussu;13362;6725;6637;98,7;32,5;63,8
2007;3521002;Iperó;25187;13516;11671;86,3;30;147,9
2007;3521101;Ipeúna;5487;2838;2649;93,3;31,1;28,9
2007;3521150;Ipiguá;4142;2108;2034;96,5;34,4;30,4
2007;3521200;Iporanga;4403;2242;2161;96,4;30,1;3,8
2007;3521309;Ipuã;13510;6893;6617;96;31;29
2007;3521408;Iracemápolis;18604;9351;9253;99;32,2;161,6
2007;3521507;Irapuã;7077;3685;3392;92;33,6;27,5
2007;3521606;Irapuru;7727;4287;3440;80,2;36,1;36
2007;3521705;Itaberá;18269;9250;9019;97,5;31,8;16,6
2007;3521804;Itaí;23160;12171;10989;90,3;31,4;21,2
2007;3521903;Itajobi;14484;7320;7164;97,9;36,3;28,8
2007;3522000;Itaju;3079;1609;1470;91,4;33,9;13,4
2007;3522109;Itanhaém;82610;40375;42235;104,6;32,7;137,3
2007;3522158;Itaoca;3267;1692;1575;93,1;33;17,9
2007;3522208;Itapecerica da Serra;146470;73003;73467;100,6;28,8;971,7
2007;3522307;Itapetininga;139055;69561;69494;99,9;31,7;77,7
2007;3522406;Itapeva;86966;42922;44044;102,6;30,4;47,6
2007;3522505;Itapevi;188964;93175;95789;102,8;27,9;2286,1
2007;3522604;Itapira;67137;33382;33755;101,1;34,8;129,5
2007;3522653;Itapirapuã Paulista;3842;1993;1849;92,8;29,3;9,5
2007;3522703;Itápolis;39490;19620;19870;101,3;34,7;39,6
2007;3522802;Itaporanga;14544;7294;7250;99,4;32,9;28,6
2007;3522901;Itapuí;11626;5908;5718;96,8;32,6;83
2007;3523008;Itapura;4173;2159;2014;93,3;32,6;13,8
2007;3523107;Itaquaquecetuba;307045;151957;155088;102,1;27,8;3716,3
2007;3523206;Itararé;47852;23554;24298;103,2;31,4;47,7
2007;3523305;Itariri;14909;7549;7360;97,5;29,8;54,5
2007;3523404;Itatiba;95324;47232;48092;101,8;32,7;295,8
2007;3523503;Itatinga;17304;8850;8454;95,5;29,8;17,7
2007;3523602;Itirapina;14742;8553;6189;72,4;31,8;26,1
2007;3523701;Itirapuã;5785;2971;2814;94,7;31,7;35,9
2007;3523800;Itobi;7547;3919;3628;92,6;32,9;54,3
2007;3523909;Itu;148619;73708;74911;101,6;31,9;232
2007;3524006;Itupeva;38752;19742;19010;96,3;30;192,9
2007;3524105;Ituverava;38175;18698;19477;104,2;34;54,2
2007;3524204;Jaborandi;6521;3318;3203;96,5;33,1;23,8
2007;3524303;Jaboticabal;70627;34405;36222;105,3;33,9;100
2007;3524402;Jacareí;205570;100792;104778;104;32,1;442,8
2007;3524501;Jaci;5166;2651;2515;94,9;32,4;35,6
2007;3524600;Jacupiranga;17238;8810;8428;95,7;30,9;24,5
2007;3524709;Jaguariúna;39705;19821;19884;100,3;32;280,8
2007;3524808;Jales;46873;23015;23858;103,7;35,5;127,2
2007;3524907;Jambeiro;4950;2569;2381;92,7;32,3;26,8
2007;3525003;Jandira;103527;50937;52590;103,2;28,7;5933,1
2007;3525102;Jardinópolis;35508;17878;17630;98,6;31,9;70,8
2007;3525201;Jarinu;21749;11042;10707;97;31,3;104,8
2007;3525300;Jaú;125364;61615;63749;103,5;33,8;182,5
2007;3525409;Jeriquara;3208;1662;1546;93;30,6;22,6
2007;3525508;Joanópolis;11372;5754;5618;97,6;34,2;30,4
2007;3525607;João Ramalho;4042;2047;1995;97,5;31,2;9,7
2007;3525706;José Bonifácio;31563;15766;15797;100,2;33,3;36,7
2007;3525805;Júlio Mesquita;4370;2159;2211;102,4;32,5;34,1
2007;3525854;Jumirim;2617;1363;1254;92;32,4;46,2
2007;3525904;Jundiaí;355627;173470;182157;105;34,2;824,7
2007;3526001;Junqueirópolis;18189;9600;8589;89,5;35,8;31,2
2007;3526100;Juquiá;19841;10079;9762;96,9;31,3;24,4
2007;3526209;Juquitiba;28302;14306;13996;97,8;29,9;54,2
2007;3526308;Lagoinha;4879;2514;2365;94,1;35,1;19,1
2007;3526407;Laranjal Paulista;24367;12071;12296;101,9;34;63,4
2007;3526506;Lavínia;7665;4852;2813;58;34,1;14,3
2007;3526605;Lavrinhas;6433;3260;3173;97,3;29,7;38,5
2007;3526704;Leme;88568;44542;44026;98,8;31,6;219,8
2007;3526803;Lençóis Paulista;59578;29661;29917;100,9;31,8;73,6
2007;3526902;Limeira;268419;132361;136058;102,8;32,9;462,2
2007;3527009;Lindóia;6275;3132;3143;100,4;33,9;128,7
2007;3527108;Lins;69815;33887;35928;106;34,6;122,5
2007;3527207;Lorena;81224;39329;41895;106,5;32,7;196,1
2007;3527256;Lourdes;2094;1081;1013;93,7;35,5;18,4
2007;3527306;Louveira;32789;16611;16178;97,4;30;588,3
2007;3527405;Lucélia;19459;10251;9208;89,8;34,5;61,8
2007;3527504;Lucianópolis;2231;1128;1103;97,8;33,8;11,8
2007;3527603;Luís Antônio;10009;5161;4848;93,9;29,1;16,7
2007;3527702;Luiziânia;4794;2468;2326;94,2;33,5;28,8
2007;3527801;Lupércio;4335;2136;2199;102,9;32,3;27,9
2007;3527900;Lutécia;2785;1396;1389;99,5;33,8;5,9
2007;3528007;Macatuba;16127;8103;8024;99;31,7;71,8
2007;3528106;Macaubal;7568;3840;3728;97,1;36,7;30,5
2007;3528205;Macedônia;3712;1866;1846;98,9;36;11,3
2007;3528304;Magda;3243;1679;1564;93,2;36,5;10,4
2007;3528403;Mairinque;42184;21059;21125;100,3;30,9;200,7
2007;3528502;Mairiporã;74591;37678;36913;98;31,3;232,6
2007;3528601;Manduri;8782;4429;4353;98,3;33,7;38,3
2007;3528700;Marabá Paulista;4478;2652;1826;68,9;32,5;4,9
2007;3528809;Maracaí;13251;6669;6582;98,7;32,9;24,8
2007;3528858;Marapoama;2519;1293;1226;94,8;35,1;22,6
2007;3528908;Mariápolis;3888;1994;1894;95;34,8;20,8
2007;3529005;Marília;211119;102432;108687;106,1;33,9;180,4
2007;3529104;Marinópolis;2167;1100;1067;97;34,2;27,8
2007;3529203;Martinópolis;23637;12244;11393;93;33,8;18,9
2007;3529302;Matão;75613;37573;38040;101,2;32,9;144,1
2007;3529401;Mauá;402085;197218;204867;103,9;30,3;6491,8
2007;3529500;Mendonça;4360;2219;2141;96,5;35,7;22,3
2007;3529609;Meridiano;3931;1959;1972;100,7;35,3;17,2
2007;3529658;Mesópolis;1904;973;931;95,7;34,9;12,8
2007;3529708;Miguelópolis;20051;10035;10016;99,8;31,7;24,4
2007;3529807;Mineiros do Tietê;11878;5936;5942;100,1;32,6;55,7
2007;3529906;Miracatu;21304;10844;10460;96,5;30,1;21,3
2007;3530003;Mira Estrela;2767;1404;1363;97,1;36;12,8
2007;3530102;Mirandópolis;27033;14676;12357;84,2;35,4;29,5
2007;3530201;Mirante do Paranapanema;16802;8544;8258;96,7;33,9;13,6
2007;3530300;Mirassol;52135;25640;26495;103,3;34,4;214,3
2007;3530409;Mirassolândia;4109;2100;2009;95,7;34,4;24,7
2007;3530508;Mococa;66347;33208;33139;99,8;33,9;77,6
2007;3530607;Mogi das Cruzes;370678;181209;189469;104,6;31,3;520,2
2007;3530706;Mogi Guaçu;133497;66521;66976;100,7;32,7;164,3
2007;3530805;Mogi Mirim;85006;42068;42938;102,1;33,8;170,8
2007;3530904;Mombuca;3226;1645;1581;96,1;31,2;24,1
2007;3531001;Monções;2110;1091;1019;93,4;37;20,2
2007;3531100;Mongaguá;42920;21615;21305;98,6;32,9;300,7
2007;3531209;Monte Alegre do Sul;6886;3458;3428;99,1;35,5;62,4
2007;3531308;Monte Alto;45836;22696;23140;102;34,8;132,1
2007;3531407;Monte Aprazível;20654;10260;10394;101,3;35,7;41,7
2007;3531506;Monte Azul Paulista;19226;9665;9561;98,9;33,7;73
2007;3531605;Monte Castelo;4084;2034;2050;100,8;36,6;17,5
2007;3531704;Monteiro Lobato;3954;2060;1894;91,9;33,4;11,9
2007;3531803;Monte Mor;45349;22717;22632;99,6;30,3;188,5
2007;3531902;Morro Agudo;27958;14286;13672;95,7;30,2;20,1
2007;3532009;Morungaba;11209;5635;5574;98,9;32;76,4
2007;3532058;Motuca;4171;2124;2047;96,4;31,8;18,2
2007;3532108;Murutinga do Sul;4123;2071;2052;99,1;37,7;16,4
2007;3532157;Nantes;2574;1302;1272;97,7;30,5;9
2007;3532207;Narandiba;4101;2075;2026;97,6;31,4;11,5
2007;3532306;Natividade da Serra;6772;3544;3228;91,1;35;8,1
2007;3532405;Nazaré Paulista;15849;8167;7682;94,1;33,1;48,6
2007;3532504;Neves Paulista;8843;4415;4428;100,3;37,4;40,4
2007;3532603;Nhandeara;10570;5201;5369;103,2;37,6;24,2
2007;3532702;Nipoã;3938;2064;1874;90,8;32,9;28,6
2007;3532801;Nova Aliança;5538;2746;2792;101,7;35,5;25,5
2007;3532827;Nova Campina;8220;4226;3994;94,5;27,7;21,3
2007;3532843;Nova Canaã Paulista;2243;1149;1094;95,2;38,7;18
2007;3532868;Nova Castilho;1070;533;537;100,8;34,3;5,8
2007;3532900;Nova Europa;8646;4346;4300;98,9;31,6;54
2007;3533007;Nova Granada;18466;9288;9178;98,8;33,7;34,7
2007;3533106;Nova Guataporanga;2171;1110;1061;95,6;36,9;63,6
2007;3533205;Nova Independência;2740;1367;1373;100,4;32,4;10,3
2007;3533254;Novais;4114;2203;1911;86,7;30,5;34,9
2007;3533304;Nova Luzitânia;3209;1687;1522;90,2;32,9;43,5
2007;3533403;Nova Odessa;48548;24043;24505;101,9;32,6;657,9
2007;3533502;Novo Horizonte;35303;17599;17704;100,6;34,4;37,9
2007;3533601;Nuporanga;6665;3348;3317;99,1;33,8;19,1
2007;3533700;Ocauçu;4158;2147;2011;93,7;33,5;13,8
2007;3533809;Óleo;2777;1404;1373;97,8;35,5;14
2007;3533908;Olímpia;48852;24145;24707;102,3;34,4;60,9
2007;3534005;Onda Verde;3752;1920;1832;95,4;32,4;15,4
2007;3534104;Oriente;6045;2969;3076;103,6;35;27,6
2007;3534203;Orindiúva;5194;2656;2538;95,6;30,3;21
2007;3534302;Orlândia;38760;19071;19689;103,2;32,8;132,8
2007;3534401;Osasco;664228;320624;343604;107,2;31,3;10226,1
2007;3534500;Oscar Bressane;2524;1217;1307;107,4;37,2;11,4
2007;3534609;Osvaldo Cruz;30663;15324;15339;100,1;36,2;123,6
2007;3534708;Ourinhos;100350;48867;51483;105,4;33,3;339,2
2007;3534757;Ouroeste;7721;3857;3864;100,2;33,7;26,7
2007;3534807;Ouro Verde;7618;3792;3826;100,9;33;28,6
2007;3534906;Pacaembu;13024;7400;5624;76;35,8;38,4
2007;3535002;Palestina;10420;5243;5177;98,7;35,9;14,9
2007;3535101;Palmares Paulista;10170;5366;4804;89,5;29,3;123,8
2007;3535200;Palmeira d'Oeste;9838;4958;4880;98,4;36,9;30,9
2007;3535309;Palmital;21084;10345;10739;103,8;35,4;38,4
2007;3535408;Panorama;14343;7232;7111;98,3;31,5;40,3
2007;3535507;Paraguaçu Paulista;41559;20801;20758;99,8;32,9;41,5
2007;3535606;Paraibuna;17356;8847;8509;96,2;32,3;21,4
2007;3535705;Paraíso;5748;2949;2799;94,9;34;37
2007;3535804;Paranapanema;17158;8794;8364;95,1;30,7;16,8
2007;3535903;Paranapuã;3781;1930;1851;95,9;35;26,9
2007;3536000;Parapuã;10986;5602;5384;96,1;35,7;30
2007;3536109;Pardinho;5314;2728;2586;94,8;31,5;25,3
2007;3536208;Pariquera-Açu;18244;9089;9155;100,7;31,5;50,8
2007;3536257;Parisi;2006;1036;970;93,6;36,2;23,7
2007;3536307;Patrocínio Paulista;12510;6362;6148;96,6;32,1;20,8
2007;3536406;Paulicéia;6029;3134;2895;92,4;31,3;16,1
2007;3536505;Paulínia;72468;36016;36452;101,2;31;522,2
2007;3536570;Paulistânia;1793;942;851;90,3;33;7
2007;3536604;Paulo de Faria;8595;4306;4289;99,6;33,3;11,6
2007;3536703;Pederneiras;40059;20166;19893;98,6;32;55,1
2007;3536802;Pedra Bela;5729;3008;2721;90,5;34;36,1
2007;3536901;Pedranópolis;2622;1351;1271;94,1;36,7;10,1
2007;3537008;Pedregulho;15510;7905;7605;96,2;31,8;21,8
2007;3537107;Pedreira;39726;19701;20025;101,6;33,1;365,1
2007;3537156;Pedrinhas Paulista;2931;1465;1466;100,1;33,9;19,2
2007;3537206;Pedro de Toledo;9978;5051;4927;97,5;31,6;14,9
2007;3537305;Penápolis;57364;28023;29341;104,7;34,7;80,6
2007;3537404;Pereira Barreto;24981;12304;12677;103;34;25,6
2007;3537503;Pereiras;7031;3581;3450;96,3;33,6;31,5
2007;3537602;Peruíbe;57373;28177;29196;103,6;32,8;175,9
2007;3537701;Piacatu;5067;2553;2514;98,5;34,3;21,8
2007;3537800;Piedade;51706;26592;25114;94,4;32,3;69,2
2007;3537909;Pilar do Sul;25803;13167;12636;96;31,3;37,9
2007;3538006;Pindamonhangaba;140881;69608;71273;102,4;31,3;192,6
2007;3538105;Pindorama;14476;7387;7089;96;35,3;78,3
2007;3538204;Pinhalzinho;12459;6326;6133;96,9;34,6;80,6
2007;3538303;Piquerobi;3530;1763;1767;100,2;34,8;7,3
2007;3538501;Piquete;14478;7019;7459;106,3;34,3;82,3
2007;3538600;Piracaia;24671;12368;12303;99,5;33,1;64
2007;3538709;Piracicaba;354214;173773;180441;103,8;33,3;257
2007;3538808;Piraju;28516;13889;14627;105,3;34,2;56,5
2007;3538907;Pirajuí;21977;12028;9949;82,7;34,3;26,7
2007;3539004;Pirangi;10456;5319;5137;96,6;35,6;48,5
2007;3539103;Pirapora do Bom Jesus;14786;7367;7419;100,7;28,2;136,3
2007;3539202;Pirapozinho;23958;11722;12236;104,4;33,1;50,2
2007;3539301;Pirassununga;68502;33619;34883;103,8;34,2;94,2
2007;3539400;Piratininga;11665;5820;5845;100,4;34,4;29
2007;3539509;Pitangueiras;34182;17463;16719;95,7;30,2;79,4
2007;3539608;Planalto;4192;2164;2028;93,7;32,1;14,5
2007;3539707;Platina;3099;1613;1486;92,1;32,5;9,5
2007;3539806;Poá;102888;50009;52879;105,7;30,4;5959,8
2007;3539905;Poloni;5169;2536;2633;103,8;36,7;38,3
2007;3540002;Pompéia;19462;9589;9873;103;33,9;24,8
2007;3540101;Pongaí;3555;1840;1715;93,2;36,8;19,4
2007;3540200;Pontal;36924;19202;17722;92,3;29;103,6
2007;3540259;Pontalinda;3892;2060;1832;88,9;32,2;18,6
2007;3540309;Pontes Gestal;2502;1242;1260;101,4;35,3;11,5
2007;3540408;Populina;4297;2187;2110;96,5;36,1;13,6
2007;3540507;Porangaba;7848;4073;3775;92,7;34,7;29,5
2007;3540606;Porto Feliz;47941;24064;23877;99,2;32,4;86,1
2007;3540705;Porto Ferreira;50289;24992;25297;101,2;33,1;205,3
2007;3540754;Potim;17568;9594;7974;83,1;29,2;393,5
2007;3540804;Potirendaba;14817;7554;7263;96,1;35,6;43,3
2007;3540853;Pracinha;2429;1588;841;53;32,6;38,5
2007;3540903;Pradópolis;15950;8128;7822;96,2;31,1;95,3
2007;3541000;Praia Grande;240918;116418;124500;106,9;32,2;1609,9
2007;3541059;Pratânia;4419;2290;2129;93;30,5;25,2
2007;3541109;Presidente Alves;4166;2082;2084;100,1;34;14,5
2007;3541208;Presidente Bernardes;13983;7010;6973;99,5;36,1;18,7
2007;3541307;Presidente Epitácio;40764;20058;20706;103,2;32,5;32,3
2007;3541406;Presidente Prudente;202480;97737;104743;107,2;34;361,2
2007;3541505;Presidente Venceslau;37895;18930;18965;100,2;35;50,2
2007;3541604;Promissão;34313;17156;17157;100;33;44
2007;3541653;Quadra;3044;1614;1430;88,6;33,5;14,8
2007;3541703;Quatá;12396;6183;6213;100,5;32,3;19
2007;3541802;Queiroz;2631;1339;1292;96,5;31,2;11,2
2007;3541901;Queluz;10678;5389;5289;98,1;31,3;42,8
2007;3542008;Quintana;5833;2905;2928;100,8;33,8;18,3
2007;3542107;Rafard;8540;4241;4299;101,4;32,8;70,2
2007;3542206;Rancharia;28938;14266;14672;102,8;33,6;18,2
2007;3542305;Redenção da Serra;3935;2070;1865;90,1;33,9;12,7
2007;3542404;Regente Feijó;18090;9011;9079;100,8;33,9;68,7
2007;3542503;Reginópolis;6547;3874;2673;69;33;16
2007;3542602;Registro;54380;26856;27524;102,5;31,3;75,3
2007;3542701;Restinga;6283;3165;3118;98,5;29,8;25,6
2007;3542800;Ribeira;3444;1794;1650;92;33,1;10,3
2007;3542909;Ribeirão Bonito;11874;5993;5881;98,1;32;25,2
2007;3543006;Ribeirão Branco;19508;10086;9422;93,4;28,2;28
2007;3543105;Ribeirão Corrente;4153;2162;1991;92,1;30,7;28
2007;3543204;Ribeirão do Sul;4464;2252;2212;98,2;34,7;22
2007;3543238;Ribeirão dos Índios;2206;1102;1104;100,2;36,4;11,2
2007;3543253;Ribeirão Grande;7449;3820;3629;95;31,3;22,3
2007;3543303;Ribeirão Pires;110920;54457;56463;103,7;32,3;1120,7
2007;3543402;Ribeirão Preto;574315;275869;298446;108,2;33,5;882,3
2007;3543501;Riversul;6525;3260;3265;100,2;33,6;16,9
2007;3543600;Rifaina;3427;1727;1700;98,4;34,4;21,1
2007;3543709;Rincão;10443;5267;5176;98,3;31,7;33
2007;3543808;Rinópolis;10045;5117;4928;96,3;36,1;28
2007;3543907;Rio Claro;180672;88081;92591;105,1;34;362,5
2007;3544004;Rio das Pedras;27613;13989;13624;97,4;30,9;121,8
2007;3544103;Rio Grande da Serra;42075;20899;21176;101,3;29,4;1157,8
2007;3544202;Riolândia;9916;5610;4306;76,8;31,9;15,7
2007;3544251;Rosana;21247;10647;10600;99,6;30,6;28,6
2007;3544301;Roseira;9282;4701;4581;97,4;31,1;71,5
2007;3544400;Rubiácea;2593;1326;1267;95,6;32,3;11
2007;3544509;Rubinéia;2795;1378;1417;102,8;37,1;11,5
2007;3544608;Sabino;5115;2568;2547;99,2;35,1;16,8
2007;3544707;Sagres;2398;1200;1198;99,8;34,3;16,2
2007;3544806;Sales;5159;2640;2519;95,4;34,6;16,7
2007;3544905;Sales Oliveira;10189;5070;5119;101;33,7;33,3
2007;3545001;Salesópolis;15330;7759;7571;97,6;31,9;36,1
2007;3545100;Salmourão;4698;2407;2291;95,2;33,9;27,2
2007;3545159;Saltinho;6648;3328;3320;99,8;34,5;66,7
2007;3545209;Salto;101814;50518;51296;101,5;32;765,2
2007;3545308;Salto de Pirapora;38671;19285;19386;100,5;31,7;137,9
2007;3545407;Salto Grande;8716;4344;4372;100,6;33,8;46,3
2007;3545506;Sandovalina;3525;1772;1753;98,9;30,7;7,7
2007;3545605;Santa Adélia;14124;7079;7045;99,5;33,9;42,8
2007;3545704;Santa Albertina;5698;2880;2818;97,8;37,3;20,9
2007;3545803;Santa Bárbara d'Oeste;177202;88117;89085;101,1;32,7;653,8
2007;3546009;Santa Branca;13584;6817;6767;99,3;32,9;49,9
2007;3546108;Santa Clara d'Oeste;2105;1071;1034;96,5;36;11,5
2007;3546207;Santa Cruz da Conceição;3869;1932;1937;100,3;34,7;25,8
2007;3546256;Santa Cruz da Esperança;1909;956;953;99,7;32,6;12,9
2007;3546306;Santa Cruz das Palmeiras;28621;14526;14095;97;31,7;96,9
2007;3546405;Santa Cruz do Rio Pardo;43089;21176;21913;103,5;33,8;38,7
2007;3546504;Santa Ernestina;5646;2948;2698;91,5;30,5;42
2007;3546603;Santa Fé do Sul;28469;13764;14705;106,8;35,7;137,8
2007;3546702;Santa Gertrudes;19835;10068;9767;97;30,2;201,8
2007;3546801;Santa Isabel;48596;24401;24195;99,2;31,4;133,8
2007;3546900;Santa Lúcia;8103;4094;4009;97,9;30,5;52,7
2007;3547007;Santa Maria da Serra;5174;2651;2523;95,2;31,1;20,5
2007;3547106;Santa Mercedes;2841;1428;1413;98,9;34;17
2007;3547205;Santana da Ponte Pensa;1713;877;836;95,3;39,4;13,2
2007;3547304;Santana de Parnaíba;97937;48499;49438;101,9;29,6;544,2
2007;3547403;Santa Rita d'Oeste;2598;1301;1297;99,7;38,9;12,4
2007;3547502;Santa Rita do Passa Quatro;26452;12832;13620;106,1;37;35,1
2007;3547601;Santa Rosa de Viterbo;23094;11441;11653;101,9;33,7;80
2007;3547650;Santa Salete;1439;740;699;94,5;38,4;18,2
2007;3547700;Santo Anastácio;20637;10082;10555;104,7;35;37,3
2007;3547809;Santo André;669504;322024;347480;107,9;34,3;3808,7
2007;3547908;Santo Antônio da Alegria;6170;3200;2970;92,8;34,3;19,9
2007;3548005;Santo Antônio de Posse;19879;10019;9860;98,4;31,7;129
2007;3548054;Santo Antônio do Aracanguá;7420;3806;3614;95;32,6;5,7
2007;3548104;Santo Antônio do Jardim;6017;3105;2912;93,8;34,4;54,7
2007;3548203;Santo Antônio do Pinhal;6453;3274;3179;97,1;31,9;48,5
2007;3548302;Santo Expedito;2726;1383;1343;97,1;35,5;28,9
2007;3548401;Santópolis do Aguapeí;4132;2093;2039;97,4;31,9;32,3
2007;3548500;Santos;420107;192928;227179;117,8;37,8;1494,9
2007;3548609;São Bento do Sapucaí;10451;5267;5184;98,4;34,4;41,4
2007;3548708;São Bernardo do Campo;747011;361762;385249;106,5;32,1;1824,1
2007;3548807;São Caetano do Sul;146437;67867;78570;115,8;38,4;9551,9
2007;3548906;São Carlos;213169;104933;108236;103,1;33,8;187,5
2007;3549003;São Francisco;2828;1423;1405;98,7;36,3;37,4
2007;3549102;São João da Boa Vista;81984;39936;42048;105,3;35;158,8
2007;3549201;São João das Duas Pontes;2610;1323;1287;97,3;34,6;20,2
2007;3549250;São João de Iracema;1748;880;868;98,6;34,6;9,8
2007;3549300;São João do Pau d'Alho;2122;1072;1050;97,9;38;18
2007;3549409;São Joaquim da Barra;45074;22134;22940;103,6;33,1;109,7
2007;3549508;São José da Bela Vista;8329;4264;4065;95,3;30,4;30,1
2007;3549607;São José do Barreiro;4115;2091;2024;96,8;32,7;7,2
2007;3549706;São José do Rio Pardo;51470;25394;26076;102,7;34,3;122,6
2007;3549805;São José do Rio Preto;392682;189030;203652;107,7;34,6;909,1
2007;3549904;São José dos Campos;602004;295859;306145;103,5;31,5;547,6
2007;3549953;São Lourenço da Serra;13454;6828;6626;97;30,7;72,2
2007;3550001;São Luiz do Paraitinga;10476;5387;5089;94,5;34,3;17
2007;3550100;São Manuel;37927;18648;19279;103,4;32,9;58,3
2007;3550209;São Miguel Arcanjo;31366;15981;15385;96,3;30,8;33,7
2007;3550308;São Paulo;11019484;5230094;5789390;110,7;32,9;7243,9
2007;3550407;São Pedro;30559;14947;15612;104,4;34,4;50
2007;3550506;São Pedro do Turvo;7139;3632;3507;96,6;32,8;9,8
2007;3550605;São Roque;75359;37215;38144;102,5;33,1;245,5
2007;3550704;São Sebastião;69024;34612;34412;99,4;29,9;171,5
2007;3550803;São Sebastião da Grama;12252;6248;6004;96,1;33,2;48,5
2007;3550902;São Simão;14172;7007;7165;102,3;33,6;23
2007;3551009;São Vicente;324003;156170;167833;107,5;32;2187
2007;3551108;Sarapuí;8714;4463;4251;95,2;31,9;24,7
2007;3551207;Sarutaiá;3654;1831;1823;99,6;33;25,8
2007;3551306;Sebastianópolis do Sul;2867;1450;1417;97,7;36,2;17,1
2007;3551405;Serra Azul;10123;5834;4289;73,5;31,1;35,8
2007;3551504;Serrana;36947;18547;18400;99,2;29,6;293,1
2007;3551603;Serra Negra;25671;12568;13103;104,3;35,9;126
2007;3551702;Sertãozinho;105194;52453;52741;100,5;31,7;261
2007;3551801;Sete Barras;13284;6869;6415;93,4;30,9;12,5
2007;3551900;Severínia;14936;7761;7175;92,4;30,8;106,3
2007;3552007;Silveiras;5711;2906;2805;96,5;32,4;13,8
2007;3552106;Socorro;35520;17666;17854;101,1;35,9;79,1
2007;3552205;Sorocaba;558377;273713;284664;104;32,3;1241,2
2007;3552304;Sud Mennucci;7365;3715;3650;98,3;32,6;12,4
2007;3552403;Sumaré;227305;113319;113986;100,6;30,4;1481,1
2007;3552502;Suzano;252938;124458;128480;103,2;30;1226,5
2007;3552551;Suzanápolis;3194;1650;1544;93,6;34,1;9,7
2007;3552601;Tabapuã;11102;5620;5482;97,5;35,3;32,1
2007;3552700;Tabatinga;14245;7304;6941;95;32,4;38,6
2007;3552809;Taboão da Serra;230482;110582;119900;108,4;29,9;11304,9
2007;3552908;Taciba;5574;2802;2772;98,9;32,9;9,2
2007;3553005;Taguaí;9761;4876;4885;100,2;31,1;67,2
2007;3553104;Taiaçu;5838;2949;2889;98;33,4;54,5
2007;3553203;Taiúva;5475;2723;2752;101,1;35,8;41,3
2007;3553302;Tambaú;22443;11241;11202;99,7;33,3;39,9
2007;3553401;Tanabi;23588;11771;11817;100,4;35,7;31,6
2007;3553500;Tapiraí;8266;4194;4072;97,1;30,3;10,9
2007;3553609;Tapiratiba;12835;6382;6453;101,1;33,2;57,8
2007;3553658;Taquaral;2747;1394;1353;97,1;33,3;51
2007;3553708;Taquaritinga;53602;26671;26931;101;33,6;90,2
2007;3553807;Taquarituba;22257;11104;11153;100,4;32,3;49,6
2007;3553856;Taquarivaí;4964;2503;2461;98,3;28,2;21,4
2007;3553906;Tarabai;6357;3197;3160;98,8;31,5;31,6
2007;3553955;Tarumã;12180;6227;5953;95,6;30,8;40,2
2007;3554003;Tatuí;103231;51143;52088;101,8;32;197,1
2007;3554102;Taubaté;268360;131869;136491;103,5;32,5;429,4
2007;3554201;Tejupá;5017;2590;2427;93,7;30,4;16,9
2007;3554300;Teodoro Sampaio;21037;10514;10523;100,1;30,8;13,5
2007;3554409;Terra Roxa;8277;4202;4075;97;33;37,4
2007;3554508;Tietê;35215;17461;17754;101,7;33,4;87,1
2007;3554607;Timburi;2689;1389;1300;93,6;35,4;13,7
2007;3554656;Torre de Pedra;2234;1174;1060;90,3;35,2;31,3
2007;3554706;Torrinha;9180;4641;4539;97,8;35,1;29,1
2007;3554755;Trabiju;1493;751;742;98,8;32;23,5
2007;3554805;Tremembé;39137;20599;18538;90;31,7;204,8
2007;3554904;Três Fronteiras;5349;2682;2667;99,4;36,6;35,3
2007;3554953;Tuiuti;5637;2884;2753;95,5;35,6;44,5
2007;3555000;Tupã;63652;30890;32762;106,1;36,1;101,4
2007;3555109;Tupi Paulista;13998;7262;6736;92,8;38;57,2
2007;3555208;Turiúba;1924;996;928;93,2;37,7;12,6
2007;3555307;Turmalina;2111;1052;1059;100,7;38,4;14,3
2007;3555356;Ubarana;4968;2564;2404;93,8;30,5;23,7
2007;3555406;Ubatuba;75484;37758;37726;99,9;30,4;106,6
2007;3555505;Ubirajara;4334;2225;2109;94,8;33,3;15,4
2007;3555604;Uchoa;9341;4659;4682;100,5;35,8;37
2007;3555703;União Paulista;1533;805;728;90,4;33,8;19,4
2007;3555802;Urânia;8872;4422;4450;100,6;36,1;42,4
2007;3555901;Uru;1291;669;622;93;36;8,8
2007;3556008;Urupês;12487;6227;6260;100,5;36,4;38,6
2007;3556107;Valentim Gentil;10276;5186;5090;98,1;33,3;68,6
2007;3556206;Valinhos;99572;49297;50275;102;33,9;670,3
2007;3556305;Valparaíso;21243;11503;9740;84,7;32,1;24,8
2007;3556354;Vargem;8234;4227;4007;94,8;33,9;57,7
2007;3556404;Vargem Grande do Sul;38400;19096;19304;101,1;33,1;143,7
2007;3556453;Vargem Grande Paulista;39832;19843;19989;100,7;30,1;937,5
2007;3556503;Várzea Paulista;102575;51287;51288;100;29,9;2920,7
2007;3556602;Vera Cruz;10909;5386;5523;102,5;34,7;44
2007;3556701;Vinhedo;58435;28989;29446;101,6;33,2;721,9
2007;3556800;Viradouro;16895;8527;8368;98,1;32,6;77,6
2007;3556909;Vista Alegre do Alto;6212;3175;3037;95,7;32,4;65,1
2007;3556958;Vitória Brasil;1721;884;837;94,7;34,6;34,5
2007;3557006;Votorantim;105210;52336;52874;101;30,9;571,2
2007;3557105;Votuporanga;81953;40071;41882;104,5;35,2;194,8
2007;3557154;Zacarias;2208;1117;1091;97,7;35;6,9
2007;3557204;Chavantes;12143;6046;6097;100,8;32,8;64,3
2007;3557303;Estiva Gerbi;9689;4925;4764;96,7;31,6;130,7
2008;3500105;Adamantina;33781;16397;17384;106;36,9;82
2008;3500204;Adolfo;3604;1818;1786;98,2;35,6;17,1
2008;3500303;Aguaí;31367;15803;15564;98,5;32,4;66,1
2008;3500402;Águas da Prata;7479;3709;3770;101,6;37,1;52,4
2008;3500501;Águas de Lindóia;17091;8396;8695;103,6;35;284,3
2008;3500550;Águas de Santa Bárbara;5552;2770;2782;100,4;34,1;13,7
2008;3500600;Águas de São Pedro;2527;1176;1351;114,9;40,6;699,6
2008;3500709;Agudos;34177;16921;17256;102;32,2;35,4
2008;3500758;Alambari;4620;2338;2282;97,6;31,7;28,9
2008;3500808;Alfredo Marcondes;3874;1978;1896;95,9;37,7;32,6
2008;3500907;Altair;3758;2019;1739;86,1;31,3;12
2008;3501004;Altinópolis;15675;7859;7816;99,5;34,2;16,9
2008;3501103;Alto Alegre;4129;2128;2001;94;37,6;13
2008;3501152;Alumínio;16549;8349;8200;98,2;30,3;197,9
2008;3501202;Álvares Florence;3994;2054;1940;94,4;38,9;11
2008;3501301;Álvares Machado;23472;11656;11816;101,4;33,5;67,5
2008;3501400;Álvaro de Carvalho;4548;2846;1702;59,8;32;29,6
2008;3501509;Alvinlândia;2948;1464;1484;101,4;32,5;34,7
2008;3501608;Americana;205091;100666;104425;103,7;34,6;1531,5
2008;3501707;Américo Brasiliense;33128;16702;16426;98,3;30,1;269,4
2008;3501806;Américo de Campos;5675;2848;2827;99,3;36,5;22,4
2008;3501905;Amparo;64757;32000;32757;102,4;34,9;145,4
2008;3502002;Analândia;4151;2131;2020;94,8;33,6;12,7
2008;3502101;Andradina;55359;27232;28127;103,3;35,3;57,4
2008;3502200;Angatuba;21626;10995;10631;96,7;32,6;21,1
2008;3502309;Anhembi;5416;2793;2623;93,9;32,1;7,4
2008;3502408;Anhumas;3676;1839;1837;99,9;33,6;11,5
2008;3502507;Aparecida;34973;16944;18029;106,4;33,3;289,3
2008;3502606;Aparecida d'Oeste;4559;2235;2324;104;37,4;25,5
2008;3502705;Apiaí;25771;12899;12872;99,8;30,6;26,5
2008;3502754;Araçariguama;15869;8099;7770;95,9;29;109,3
2008;3502804;Araçatuba;179186;86309;92877;107,6;35,2;153,5
2008;3502903;Araçoiaba da Serra;25732;12855;12877;100,2;33,3;100,8
2008;3503000;Aramina;5046;2545;2501;98,3;34,6;24,9
2008;3503109;Arandu;6157;3109;3048;98;32,2;21,5
2008;3503158;Arapeí;2521;1260;1261;100,1;33,6;16,1
2008;3503208;Araraquara;203128;98171;104957;106,9;35;202,4
2008;3503307;Araras;115661;57272;58389;102;33,8;179,4
2008;3503356;Arco-Íris;1990;1013;977;96,4;36,1;7,5
2008;3503406;Arealva;7717;3938;3779;96;36,7;15,2
2008;3503505;Areias;3691;1841;1850;100,5;31,8;12,1
2008;3503604;Areiópolis;10546;5439;5107;93,9;29,8;122,8
2008;3503703;Ariranha;8328;4256;4072;95,7;34;62,8
2008;3503802;Artur Nogueira;41910;20966;20944;99,9;31,3;235,4
2008;3503901;Arujá;71659;35440;36219;102,2;30,3;745,2
2008;3503950;Aspásia;1822;914;908;99,3;36,7;26,3
2008;3504008;Assis;93444;45487;47957;105,4;34,8;202,9
2008;3504107;Atibaia;123585;60913;62672;102,9;33,2;258,3
2008;3504206;Auriflama;14092;7059;7033;99,6;35,3;32,4
2008;3504305;Avaí;4886;2486;2400;96,5;32,5;9
2008;3504404;Avanhandava;10799;5832;4967;85,2;31,2;31,9
2008;3504503;Avaré;81609;40552;41057;101,2;33,3;67,3
2008;3504602;Bady Bassitt;13946;6947;6999;100,7;33,5;126,4
2008;3504701;Balbinos;3210;2390;820;34,3;33,6;35
2008;3504800;Bálsamo;7987;3928;4059;103,3;36,5;53,3
2008;3504909;Bananal;10161;5036;5125;101,8;33,7;16,5
2008;3505005;Barão de Antonina;3013;1543;1470;95,3;34;19,7
2008;3505104;Barbosa;6443;3244;3199;98,6;32,7;31,4
2008;3505203;Bariri;30932;15494;15438;99,6;34,9;69,6
2008;3505302;Barra Bonita;35354;17386;17968;103,3;35;235,5
2008;3505351;Barra do Chapéu;5192;2756;2436;88,4;30,7;12,8
2008;3505401;Barra do Turvo;7837;4116;3721;90,4;31,1;7,8
2008;3505500;Barretos;110260;53384;56876;106,5;34,3;70,4
2008;3505609;Barrinha;27580;13894;13686;98,5;29,2;188,9
2008;3505708;Barueri;233919;114167;119752;104,9;29,7;3560,4
2008;3505807;Bastos;20571;10124;10447;103,2;33,2;120,4
2008;3505906;Batatais;55412;27274;28138;103,2;34,3;65,2
2008;3506003;Bauru;338648;164423;174225;106;34;507,2
2008;3506102;Bebedouro;75155;36697;38458;104,8;34,2;110
2008;3506201;Bento de Abreu;2600;1323;1277;96,5;33,1;8,6
2008;3506300;Bernardino de Campos;10778;5274;5504;104,4;35,7;44,1
2008;3506359;Bertioga;43847;22086;21761;98,5;29,2;89,2
2008;3506409;Bilac;6870;3406;3464;101,7;36,3;43,5
2008;3506508;Birigui;105701;51712;53989;104,4;34,1;199,4
2008;3506607;Biritiba Mirim;27807;14046;13761;98;31,1;87,6
2008;3506706;Boa Esperança do Sul;13438;6781;6657;98,2;31,4;19,5
2008;3506805;Bocaina;10576;5269;5307;100,7;33,5;29,1
2008;3506904;Bofete;9131;4682;4449;95;33,3;14
2008;3507001;Boituva;45284;22822;22462;98,4;31,6;181,9
2008;3507100;Bom Jesus dos Perdões;18352;9235;9117;98,7;31,4;169,4
2008;3507159;Bom Sucesso de Itararé;3506;1788;1718;96,1;28;26,2
2008;3507209;Borá;811;412;399;96,8;32,8;6,8
2008;3507308;Boracéia;4158;2123;2035;95,9;32,8;34,1
2008;3507407;Borborema;14269;7225;7044;97,5;35;25,8
2008;3507456;Borebi;2226;1115;1111;99,6;31,4;6,4
2008;3507506;Botucatu;123447;59964;63483;105,9;33,9;83,3
2008;3507605;Bragança Paulista;142382;70076;72306;103,2;33,6;277,8
2008;3507704;Braúna;4864;2471;2393;96,8;35,3;24,9
2008;3507753;Brejo Alegre;2530;1303;1227;94,2;33,3;23,9
2008;3507803;Brodowski;20349;10120;10229;101,1;33,2;73,1
2008;3507902;Brotas;21064;10497;10567;100,7;33,3;19,1
2008;3508009;Buri;18394;9470;8924;94,2;30;15,4
2008;3508108;Buritama;15064;7546;7518;99,6;34,7;46,1
2008;3508207;Buritizal;3988;2037;1951;95,8;34,9;15
2008;3508306;Cabrália Paulista;4436;2256;2180;96,6;32;18,5
2008;3508405;Cabreúva;39782;20215;19567;96,8;29,5;152,9
2008;3508504;Caçapava;82933;41122;41811;101,7;32,6;224,8
2008;3508603;Cachoeira Paulista;29546;14519;15027;103,5;33,3;102,6
2008;3508702;Caconde;18611;9354;9257;99;33,5;39,7
2008;3508801;Cafelândia;16456;8114;8342;102,8;34,7;17,9
2008;3508900;Caiabu;4081;2088;1993;95,5;34,8;16,1
2008;3509007;Caieiras;83354;40893;42461;103,8;30,5;853,7
2008;3509106;Caiuá;4854;2553;2301;90,1;34,2;8,8
2008;3509205;Cajamar;61326;30689;30637;99,8;29,2;466,8
2008;3509254;Cajati;28729;14582;14147;97;29,9;63,2
2008;3509304;Cajobi;9668;4982;4686;94,1;34,2;54,6
2008;3509403;Cajuru;22852;11476;11376;99,1;32,5;34,6
2008;3509452;Campina do Monte Alegre;5523;2843;2680;94,3;32,5;29,9
2008;3509502;Campinas;1056274;510588;545686;106,9;33,9;1329,4
2008;3509601;Campo Limpo Paulista;71971;35487;36484;102,8;31,3;906,4
2008;3509700;Campos do Jordão;47286;23228;24058;103,6;30,9;163,1
2008;3509809;Campos Novos Paulista;4470;2298;2172;94,5;33,3;9,2
2008;3509908;Cananéia;12269;6161;6108;99,1;31,7;9,9
2008;3509957;Canas;4199;2138;2061;96,4;30,2;78,8
2008;3510005;Cândido Mota;29819;14689;15130;103;34,2;50
2008;3510104;Cândido Rodrigues;2659;1307;1352;103,4;37,8;37,5
2008;3510153;Canitar;4225;2149;2076;96,6;29,5;73,5
2008;3510203;Capão Bonito;46571;23267;23304;100,2;31,3;28,4
2008;3510302;Capela do Alto;16872;8685;8187;94,3;30,9;99,3
2008;3510401;Capivari;47119;23587;23532;99,8;32;145,9
2008;3510500;Caraguatatuba;96213;47845;48368;101,1;31,8;198,4
2008;3510609;Carapicuíba;364579;177326;187253;105,6;30,1;10553,5
2008;3510708;Cardoso;11814;5837;5977;102,4;35,9;18,5
2008;3510807;Casa Branca;27981;14806;13175;89;34,5;32,4
2008;3510906;Cássia dos Coqueiros;2700;1383;1317;95,2;34,5;14,1
2008;3511003;Castilho;17340;8652;8688;100,4;33,3;16,3
2008;3511102;Catanduva;111370;54175;57195;105,6;35,5;383,2
2008;3511201;Catiguá;7001;3574;3427;95,9;33,7;47,2
2008;3511300;Cedral;7722;3861;3861;100;36,5;39
2008;3511409;Cerqueira César;17060;8458;8602;101,7;33;33,3
2008;3511508;Cerquilho;37449;18601;18848;101,3;33;293
2008;3511607;Cesário Lange;14984;7792;7192;92,3;32,5;78,7
2008;3511706;Charqueada;14639;7438;7201;96,8;32,1;83,2
2008;3511904;Clementina;6658;3442;3216;93,4;31,8;39,5
2008;3512001;Colina;17277;8592;8685;101,1;33,6;40,9
2008;3512100;Colômbia;5988;3072;2916;94,9;31,7;8,2
2008;3512209;Conchal;24710;12487;12223;97,9;30,9;135,2
2008;3512308;Conchas;16011;8073;7938;98,3;34,2;34,3
2008;3512407;Cordeirópolis;20359;10226;10133;99,1;32,6;148
2008;3512506;Coroados;5080;2537;2543;100,2;33,7;20,6
2008;3512605;Coronel Macedo;5119;2628;2491;94,8;32,9;16,8
2008;3512704;Corumbataí;3862;1978;1884;95,2;33;13,9
2008;3512803;Cosmópolis;55751;27882;27869;100;31,3;360,5
2008;3512902;Cosmorama;7272;3675;3597;97,9;37,6;16,5
2008;3513009;Cotia;190151;93317;96834;103,8;30,4;586,9
2008;3513108;Cravinhos;31107;15647;15460;98,8;32,4;99,9
2008;3513207;Cristais Paulista;7397;3783;3614;95,5;32,4;19,2
2008;3513306;Cruzália;2357;1156;1201;103,9;35,4;15,8
2008;3513405;Cruzeiro;76448;37264;39184;105,2;33,2;250,1
2008;3513504;Cubatão;116838;58410;58428;100;30,3;817,7
2008;3513603;Cunha;22245;11394;10851;95,2;33,2;15,8
2008;3513702;Descalvado;30640;15157;15483;102,2;34,4;40,7
2008;3513801;Diadema;380853;184884;195969;106;30,3;12392,7
2008;3513850;Dirce Reis;1673;861;812;94,3;36,8;19
2008;3513900;Divinolândia;11447;5740;5707;99,4;35,6;51,2
2008;3514007;Dobrada;7714;4018;3696;92;30;51,5
2008;3514106;Dois Córregos;24230;12155;12075;99,3;33,3;38,3
2008;3514205;Dolcinópolis;2111;1100;1011;91,9;37,2;27,1
2008;3514304;Dourado;8617;4379;4238;96,8;35,6;41,9
2008;3514403;Dracena;42739;21077;21662;102,8;36,6;87,6
2008;3514502;Duartina;12355;6033;6322;104,8;35,9;46,7
2008;3514601;Dumont;7774;3928;3846;97,9;31,9;69,8
2008;3514700;Echaporã;6437;3183;3254;102,2;34;12,5
2008;3514809;Eldorado;14628;7500;7128;95;30,3;8,8
2008;3514908;Elias Fausto;15387;7961;7426;93,3;31,2;76
2008;3514924;Elisiário;3008;1586;1422;89,7;34,8;32
2008;3514957;Embaúba;2436;1268;1168;92,1;34,9;29,3
2008;3515004;Embu das Artes;233498;113825;119673;105,1;29;3316,8
2008;3515103;Embu-Guaçu;61674;30714;30960;100,8;30,6;396,3
2008;3515129;Emilianópolis;3004;1512;1492;98,7;35,7;13,3
2008;3515152;Engenheiro Coelho;14479;7567;6912;91,3;29;131,7
2008;3515186;Espírito Santo do Pinhal;41683;20458;21225;103,7;34,8;107,1
2008;3515194;Espírito Santo do Turvo;4126;2086;2040;97,8;30,4;21,3
2008;3515202;Estrela d'Oeste;8234;4158;4076;98;35,7;27,8
2008;3515301;Estrela do Norte;2644;1368;1276;93,3;32,5;10
2008;3515350;Euclides da Cunha Paulista;9757;4924;4833;98,2;31,2;17
2008;3515400;Fartura;15258;7447;7811;104,9;34,1;35,6
2008;3515509;Fernandópolis;64227;31362;32865;104,8;36;116,8
2008;3515608;Fernando Prestes;5509;2724;2785;102,2;37,2;32,4
2008;3515657;Fernão;1545;786;759;96,6;34,6;15,4
2008;3515707;Ferraz de Vasconcelos;163117;79810;83307;104,4;29,1;5520,5
2008;3515806;Flora Rica;1865;939;926;98,6;37,4;8,3
2008;3515905;Floreal;3057;1526;1531;100,3;39,2;15
2008;3516002;Flórida Paulista;12476;6705;5771;86,1;34,2;23,8
2008;3516101;Florínea;2894;1408;1486;105,5;34,7;12,8
2008;3516200;Franca;312900;153072;159828;104,4;32,5;516,6
2008;3516309;Francisco Morato;150331;74695;75636;101,3;28,1;3067,9
2008;3516408;Franco da Rocha;126751;65129;61622;94,6;29,9;954,6
2008;3516507;Gabriel Monteiro;2719;1381;1338;96,9;37;19,6
2008;3516606;Gália;7207;3618;3589;99,2;35,4;20,2
2008;3516705;Garça;43163;21052;22111;105;34,5;77,7
2008;3516804;Gastão Vidigal;4058;2172;1886;86,8;33,5;22,5
2008;3516853;Gavião Peixoto;4362;2276;2086;91,7;31,3;17,9
2008;3516903;General Salgado;10699;5388;5311;98,6;35,6;21,6
2008;3517000;Getulina;10711;5816;4895;84,2;33,9;15,8
2008;3517109;Glicério;4546;2284;2262;99;33,8;16,7
2008;3517208;Guaiçara;10353;5210;5143;98,7;32,2;37,4
2008;3517307;Guaimbê;5410;2701;2709;100,3;33;24,8
2008;3517406;Guaíra;36899;18331;18568;101,3;33,3;29,3
2008;3517505;Guapiaçu;17047;8619;8428;97,8;34;52,4
2008;3517604;Guapiara;18518;9440;9078;96,2;31,4;45,4
2008;3517703;Guará;19735;9835;9900;100,7;31,4;54,5
2008;3517802;Guaraçaí;8548;4265;4283;100,4;36,2;15
2008;3517901;Guaraci;9733;4959;4774;96,3;32,8;15,2
2008;3518008;Guarani d'Oeste;1979;975;1004;103;36,1;23,1
2008;3518107;Guarantã;6395;3223;3172;98,4;31,8;13,8
2008;3518206;Guararapes;30231;14933;15298;102,4;34,8;31,6
2008;3518305;Guararema;25103;12660;12443;98,3;32,2;92,7
2008;3518404;Guaratinguetá;110708;53458;57250;107,1;33,9;147,1
2008;3518503;Guareí;13677;8097;5580;68,9;32,2;24,1
2008;3518602;Guariba;34545;17448;17097;98;30,7;127,8
2008;3518701;Guarujá;285948;139807;146141;104,5;30,8;1974,9
2008;3518800;Guarulhos;1191968;581869;610099;104,9;30,4;3740,4
2008;3518859;Guatapará;6876;3537;3339;94,4;32;16,6
2008;3518909;Guzolândia;4668;2394;2274;95;33,2;18,5
2008;3519006;Herculândia;8592;4306;4286;99,5;33,2;23,6
2008;3519055;Holambra;10436;5308;5128;96,6;31,7;159,1
2008;3519071;Hortolândia;184356;93059;91297;98,1;30,1;2953,7
2008;3519105;Iacanga;9651;4954;4697;94,8;34,1;17,6
2008;3519204;Iacri;6485;3288;3197;97,2;34,9;20,1
2008;3519253;Iaras;5656;3587;2069;57,7;31,6;14,1
2008;3519303;Ibaté;29850;15326;14524;94,8;30,4;102,6
2008;3519402;Ibirá;10601;5248;5353;102;35,5;39
2008;3519501;Ibirarema;6509;3298;3211;97,4;33,6;28,5
2008;3519600;Ibitinga;51716;25515;26201;102,7;33,8;75
2008;3519709;Ibiúna;70147;35783;34364;96;31,3;66,3
2008;3519808;Icém;7338;3728;3610;96,8;32,5;20,3
2008;3519907;Iepê;7553;3743;3810;101,8;34,8;12,7
2008;3520004;Igaraçu do Tietê;23229;11606;11623;100,1;32;237,6
2008;3520103;Igarapava;27537;13617;13920;102,2;33,6;58,8
2008;3520202;Igaratá;8780;4517;4263;94,4;32,5;30
2008;3520301;Iguape;28727;14451;14276;98,8;33,5;14,5
2008;3520400;Ilhabela;26640;13619;13021;95,6;30,2;76,9
2008;3520426;Ilha Comprida;8535;4249;4286;100,9;35;43,4
2008;3520442;Ilha Solteira;24872;12149;12723;104,7;34,9;38,1
2008;3520509;Indaiatuba;190036;94547;95489;101;32,4;610
2008;3520608;Indiana;4855;2440;2415;99;34,8;37,5
2008;3520707;Indiaporã;3936;1936;2000;103,3;37,5;14,1
2008;3520806;Inúbia Paulista;3559;1791;1768;98,7;34,7;40,9
2008;3520905;Ipaussu;13469;6783;6686;98,6;32,8;64,3
2008;3521002;Iperó;26168;14048;12120;86,3;30,3;153,7
2008;3521101;Ipeúna;5645;2919;2726;93,4;31,3;29,7
2008;3521150;Ipiguá;4246;2162;2084;96,4;34,8;31,2
2008;3521200;Iporanga;4378;2223;2155;96,9;30,5;3,8
2008;3521309;Ipuã;13728;7002;6726;96,1;31,2;29,4
2008;3521408;Iracemápolis;19084;9584;9500;99,1;32,5;165,8
2008;3521507;Irapuã;7150;3731;3419;91,6;33,8;27,8
2008;3521606;Irapuru;7744;4359;3385;77,7;36,3;36,1
2008;3521705;Itaberá;18136;9176;8960;97,6;32,3;16,5
2008;3521804;Itaí;23440;12364;11076;89,6;31,8;21,4
2008;3521903;Itajobi;14497;7328;7169;97,8;36,7;28,9
2008;3522000;Itaju;3138;1646;1492;90,6;33,9;13,6
2008;3522109;Itanhaém;84073;40977;43096;105,2;33,1;139,7
2008;3522158;Itaoca;3251;1685;1566;92,9;33,5;17,8
2008;3522208;Itapecerica da Serra;148541;74107;74434;100,4;29,2;985,4
2008;3522307;Itapetininga;140826;70430;70396;100;32;78,7
2008;3522406;Itapeva;87256;43043;44213;102,7;30,8;47,8
2008;3522505;Itapevi;192755;94974;97781;103;28,3;2332
2008;3522604;Itapira;67581;33564;34017;101,3;35,1;130,4
2008;3522653;Itapirapuã Paulista;3867;2001;1866;93,3;29,6;9,5
2008;3522703;Itápolis;39686;19705;19981;101,4;35;39,8
2008;3522802;Itaporanga;14551;7291;7260;99,6;33,3;28,6
2008;3522901;Itapuí;11812;5996;5816;97;32,8;84,4
2008;3523008;Itapura;4225;2181;2044;93,7;33;14
2008;3523107;Itaquaquecetuba;311869;154131;157738;102,3;28,2;3774,7
2008;3523206;Itararé;47906;23558;24348;103,4;31,8;47,7
2008;3523305;Itariri;15093;7628;7465;97,9;30,1;55,2
2008;3523404;Itatiba;97269;48158;49111;102;33;301,8
2008;3523503;Itatinga;17565;8980;8585;95,6;30,1;17,9
2008;3523602;Itirapina;14990;8747;6243;71,4;32;26,5
2008;3523701;Itirapuã;5833;2988;2845;95,2;32;36,2
2008;3523800;Itobi;7557;3920;3637;92,8;33,2;54,4
2008;3523909;Itu;150390;74520;75870;101,8;32,2;234,7
2008;3524006;Itupeva;40648;20688;19960;96,5;30,3;202,4
2008;3524105;Ituverava;38351;18756;19595;104,5;34,3;54,4
2008;3524204;Jaborandi;6533;3313;3220;97,2;33,4;23,9
2008;3524303;Jaboticabal;70976;34540;36436;105,5;34,3;100,4
2008;3524402;Jacareí;207389;101537;105852;104,2;32,5;446,7
2008;3524501;Jaci;5331;2734;2597;95;32,6;36,7
2008;3524600;Jacupiranga;17230;8801;8429;95,8;31,3;24,5
2008;3524709;Jaguariúna;41161;20512;20649;100,7;32,3;291,1
2008;3524808;Jales;46932;23015;23917;103,9;35,9;127,3
2008;3524907;Jambeiro;5074;2630;2444;92,9;32,6;27,5
2008;3525003;Jandira;105048;51613;53435;103,5;29,1;6020,2
2008;3525102;Jardinópolis;36188;18214;17974;98,7;32,2;72,1
2008;3525201;Jarinu;22438;11357;11081;97,6;31,7;108,1
2008;3525300;Jaú;127209;62467;64742;103,6;34,1;185,1
2008;3525409;Jeriquara;3183;1642;1541;93,8;31;22,4
2008;3525508;Joanópolis;11509;5815;5694;97,9;34,5;30,7
2008;3525607;João Ramalho;4064;2055;2009;97,8;31,5;9,8
2008;3525706;José Bonifácio;31932;15948;15984;100,2;33,6;37,1
2008;3525805;Júlio Mesquita;4383;2168;2215;102,2;32,8;34,2
2008;3525854;Jumirim;2677;1391;1286;92,5;32,5;47,2
2008;3525904;Jundiaí;360195;175547;184648;105,2;34,5;835,3
2008;3526001;Junqueirópolis;18364;9704;8660;89,2;36;31,5
2008;3526100;Juquiá;19638;9961;9677;97,1;31,8;24,2
2008;3526209;Juquitiba;28454;14391;14063;97,7;30,3;54,5
2008;3526308;Lagoinha;4865;2500;2365;94,6;35,6;19
2008;3526407;Laranjal Paulista;24646;12192;12454;102,1;34,3;64,1
2008;3526506;Lavínia;8015;5257;2758;52,5;34,2;14,9
2008;3526605;Lavrinhas;6485;3282;3203;97,6;30;38,8
2008;3526704;Leme;89652;45054;44598;99;31,9;222,5
2008;3526803;Lençóis Paulista;60163;29926;30237;101;32,2;74,3
2008;3526902;Limeira;270870;133420;137450;103;33,3;466,4
2008;3527009;Lindóia;6417;3195;3222;100,8;34,1;131,6
2008;3527108;Lins;70302;34124;36178;106;34,9;123,3
2008;3527207;Lorena;81648;39501;42147;106,7;33;197,1
2008;3527256;Lourdes;2105;1091;1014;92,9;35,9;18,5
2008;3527306;Louveira;34191;17318;16873;97,4;30,2;613,4
2008;3527405;Lucélia;19603;10354;9249;89,3;34,8;62,3
2008;3527504;Lucianópolis;2230;1123;1107;98,6;34,1;11,8
2008;3527603;Luís Antônio;10418;5376;5042;93,8;29,4;17,4
2008;3527702;Luiziânia;4871;2517;2354;93,5;33,7;29,2
2008;3527801;Lupércio;4345;2134;2211;103,6;32,7;28
2008;3527900;Lutécia;2758;1382;1376;99,6;34,1;5,8
2008;3528007;Macatuba;16173;8122;8051;99,1;32,1;72
2008;3528106;Macaubal;7606;3857;3749;97,2;37;30,7
2008;3528205;Macedônia;3694;1856;1838;99;36,4;11,3
2008;3528304;Magda;3227;1670;1557;93,2;36,9;10,3
2008;3528403;Mairinque;42555;21234;21321;100,4;31,3;202,5
2008;3528502;Mairiporã;76656;38743;37913;97,9;31,6;239
2008;3528601;Manduri;8837;4451;4386;98,5;34;38,6
2008;3528700;Marabá Paulista;4577;2770;1807;65,2;32,7;5
2008;3528809;Maracaí;13277;6666;6611;99,2;33,3;24,9
2008;3528858;Marapoama;2548;1307;1241;95;35,5;22,9
2008;3528908;Mariápolis;3893;1995;1898;95,1;35;20,9
2008;3529005;Marília;212849;103138;109711;106,4;34,3;181,8
2008;3529104;Marinópolis;2153;1096;1057;96,4;34,6;27,7
2008;3529203;Martinópolis;23828;12361;11467;92,8;34,1;19
2008;3529302;Matão;75986;37723;38263;101,4;33,4;144,8
2008;3529401;Mauá;407099;199535;207564;104;30,6;6572,8
2008;3529500;Mendonça;4453;2262;2191;96,9;35,8;22,8
2008;3529609;Meridiano;3907;1941;1966;101,3;35,7;17,1
2008;3529658;Mesópolis;1894;963;931;96,7;35,3;12,7
2008;3529708;Miguelópolis;20173;10084;10089;100;32;24,6
2008;3529807;Mineiros do Tietê;11908;5943;5965;100,4;33;55,8
2008;3529906;Miracatu;21112;10723;10389;96,9;30,5;21,1
2008;3530003;Mira Estrela;2785;1411;1374;97,4;36,3;12,8
2008;3530102;Mirandópolis;27167;14790;12377;83,7;35,8;29,6
2008;3530201;Mirante do Paranapanema;16886;8583;8303;96,7;34,2;13,6
2008;3530300;Mirassol;52675;25891;26784;103,4;34,7;216,6
2008;3530409;Mirassolândia;4168;2135;2033;95,2;34,8;25,1
2008;3530508;Mococa;66341;33165;33176;100;34,2;77,6
2008;3530607;Mogi das Cruzes;376257;183715;192542;104,8;31,6;528
2008;3530706;Mogi Guaçu;134741;67049;67692;101;33,1;165,8
2008;3530805;Mogi Mirim;85505;42247;43258;102,4;34,2;171,8
2008;3530904;Mombuca;3235;1647;1588;96,4;31,6;24,2
2008;3531001;Monções;2115;1095;1020;93,2;37,5;20,3
2008;3531100;Mongaguá;44053;22122;21931;99,1;33,4;308,6
2008;3531209;Monte Alegre do Sul;6964;3492;3472;99,4;35,8;63,1
2008;3531308;Monte Alto;46091;22783;23308;102,3;35,2;132,8
2008;3531407;Monte Aprazível;21020;10444;10576;101,3;35,9;42,4
2008;3531506;Monte Azul Paulista;19144;9617;9527;99,1;34,2;72,7
2008;3531605;Monte Castelo;4079;2034;2045;100,5;36,9;17,5
2008;3531704;Monteiro Lobato;4010;2092;1918;91,7;33,9;12,1
2008;3531803;Monte Mor;46486;23273;23213;99,7;30,6;193,2
2008;3531902;Morro Agudo;28339;14481;13858;95,7;30,5;20,4
2008;3532009;Morungaba;11403;5730;5673;99;32,3;77,7
2008;3532058;Motuca;4214;2142;2072;96,7;32,2;18,4
2008;3532108;Murutinga do Sul;4138;2085;2053;98,5;37,9;16,5
2008;3532157;Nantes;2613;1317;1296;98,4;30,8;9,1
2008;3532207;Narandiba;4163;2107;2056;97,6;31,6;11,7
2008;3532306;Natividade da Serra;6737;3522;3215;91,3;35,5;8,1
2008;3532405;Nazaré Paulista;16038;8264;7774;94,1;33,4;49,2
2008;3532504;Neves Paulista;8817;4397;4420;100,5;37,8;40,3
2008;3532603;Nhandeara;10612;5220;5392;103,3;37,9;24,3
2008;3532702;Nipoã;4047;2127;1920;90,3;33;29,4
2008;3532801;Nova Aliança;5649;2799;2850;101,8;35,7;26
2008;3532827;Nova Campina;8333;4272;4061;95,1;28;21,6
2008;3532843;Nova Canaã Paulista;2201;1127;1074;95,3;39,1;17,7
2008;3532868;Nova Castilho;1089;540;549;101,7;34,5;5,9
2008;3532900;Nova Europa;8851;4442;4409;99,3;31,8;55,2
2008;3533007;Nova Granada;18695;9407;9288;98,7;34;35,2
2008;3533106;Nova Guataporanga;2175;1112;1063;95,6;37,2;63,7
2008;3533205;Nova Independência;2841;1418;1423;100,4;32,3;10,7
2008;3533254;Novais;4259;2286;1973;86,3;30,6;36,2
2008;3533304;Nova Luzitânia;3286;1731;1555;89,8;33,2;44,5
2008;3533403;Nova Odessa;49408;24462;24946;102;32,9;669,6
2008;3533502;Novo Horizonte;35719;17816;17903;100,5;34,7;38,3
2008;3533601;Nuporanga;6709;3368;3341;99,2;34,1;19,3
2008;3533700;Ocauçu;4152;2135;2017;94,5;33,9;13,8
2008;3533809;Óleo;2748;1387;1361;98,1;36;13,8
2008;3533908;Olímpia;49229;24321;24908;102,4;34,7;61,3
2008;3534005;Onda Verde;3789;1946;1843;94,7;32,7;15,6
2008;3534104;Oriente;6057;2971;3086;103,9;35,3;27,7
2008;3534203;Orindiúva;5361;2736;2625;95,9;30,6;21,7
2008;3534302;Orlândia;39142;19234;19908;103,5;33,1;134,2
2008;3534401;Osasco;665160;320633;344527;107,5;31,7;10240,5
2008;3534500;Oscar Bressane;2526;1215;1311;107,9;37,7;11,4
2008;3534609;Osvaldo Cruz;30743;15396;15347;99,7;36,6;123,9
2008;3534708;Ourinhos;101127;49185;51942;105,6;33,7;341,9
2008;3534757;Ouroeste;7923;3954;3969;100,4;34;27,4
2008;3534807;Ouro Verde;7677;3813;3864;101,3;33,4;28,8
2008;3534906;Pacaembu;13106;7518;5588;74,3;36;38,6
2008;3535002;Palestina;10623;5356;5267;98,3;36,1;15,2
2008;3535101;Palmares Paulista;10424;5527;4897;88,6;29,5;126,9
2008;3535200;Palmeira d'Oeste;9748;4907;4841;98,7;37,3;30,6
2008;3535309;Palmital;21127;10350;10777;104,1;35,8;38,5
2008;3535408;Panorama;14416;7254;7162;98,7;31,8;40,5
2008;3535507;Paraguaçu Paulista;41823;20967;20856;99,5;33,2;41,8
2008;3535606;Paraibuna;17363;8842;8521;96,4;32,7;21,4
2008;3535705;Paraíso;5793;2965;2828;95,4;34,3;37,3
2008;3535804;Paranapanema;17372;8883;8489;95,6;31;17,1
2008;3535903;Paranapuã;3790;1934;1856;96;35,3;27
2008;3536000;Parapuã;10952;5587;5365;96;36,1;29,9
2008;3536109;Pardinho;5396;2767;2629;95;31,9;25,7
2008;3536208;Pariquera-Açu;18292;9097;9195;101,1;31,9;50,9
2008;3536257;Parisi;2016;1040;976;93,8;36,6;23,8
2008;3536307;Patrocínio Paulista;12657;6431;6226;96,8;32,4;21
2008;3536406;Paulicéia;6123;3181;2942;92,5;31,7;16,4
2008;3536505;Paulínia;75548;37502;38046;101,5;31,3;544,4
2008;3536570;Paulistânia;1792;941;851;90,4;33,4;7
2008;3536604;Paulo de Faria;8600;4305;4295;99,8;33,6;11,7
2008;3536703;Pederneiras;40525;20391;20134;98,7;32,3;55,7
2008;3536802;Pedra Bela;5746;3013;2733;90,7;34,4;36,2
2008;3536901;Pedranópolis;2598;1334;1264;94,8;37,1;10
2008;3537008;Pedregulho;15573;7931;7642;96,4;32,2;21,9
2008;3537107;Pedreira;40315;19993;20322;101,6;33,4;370,5
2008;3537156;Pedrinhas Paulista;2934;1464;1470;100,4;34,3;19,3
2008;3537206;Pedro de Toledo;10043;5079;4964;97,7;32,1;15
2008;3537305;Penápolis;57742;28203;29539;104,7;35,1;81,2
2008;3537404;Pereira Barreto;24992;12302;12690;103,2;34,4;25,7
2008;3537503;Pereiras;7169;3644;3525;96,7;33,8;32,1
2008;3537602;Peruíbe;58141;28488;29653;104,1;33,2;178,2
2008;3537701;Piacatu;5128;2589;2539;98,1;34,6;22,1
2008;3537800;Piedade;51835;26581;25254;95;32,7;69,4
2008;3537909;Pilar do Sul;25999;13245;12754;96,3;31,7;38,2
2008;3538006;Pindamonhangaba;142833;70466;72367;102,7;31,7;195,3
2008;3538105;Pindorama;14653;7483;7170;95,8;35,6;79,3
2008;3538204;Pinhalzinho;12682;6416;6266;97,7;34,9;82,1
2008;3538303;Piquerobi;3542;1765;1777;100,7;35,2;7,3
2008;3538501;Piquete;14367;6959;7408;106,5;34,7;81,6
2008;3538600;Piracaia;24823;12420;12403;99,9;33,5;64,4
2008;3538709;Piracicaba;357499;175230;182269;104;33,6;259,4
2008;3538808;Piraju;28520;13873;14647;105,6;34,6;56,5
2008;3538907;Pirajuí;22218;12204;10014;82,1;34,5;27
2008;3539004;Pirangi;10521;5346;5175;96,8;35,9;48,8
2008;3539103;Pirapora do Bom Jesus;15102;7517;7585;100,9;28,5;139,2
2008;3539202;Pirapozinho;24185;11834;12351;104,4;33,5;50,6
2008;3539301;Pirassununga;68992;33831;35161;103,9;34,6;94,9
2008;3539400;Piratininga;11792;5871;5921;100,9;34,8;29,3
2008;3539509;Pitangueiras;34562;17645;16917;95,9;30,5;80,3
2008;3539608;Planalto;4278;2213;2065;93,3;32,3;14,8
2008;3539707;Platina;3123;1628;1495;91,8;32,8;9,5
2008;3539806;Poá;103953;50451;53502;106;30,8;6021,5
2008;3539905;Poloni;5244;2576;2668;103,6;36,8;38,8
2008;3540002;Pompéia;19606;9647;9959;103,2;34,3;25
2008;3540101;Pongaí;3527;1819;1708;93,9;37,3;19,2
2008;3540200;Pontal;37997;19836;18161;91,6;29,2;106,6
2008;3540259;Pontalinda;3946;2090;1856;88,8;32,5;18,8
2008;3540309;Pontes Gestal;2508;1247;1261;101,1;35,5;11,5
2008;3540408;Populina;4268;2168;2100;96,9;36,5;13,5
2008;3540507;Porangaba;8010;4143;3867;93,3;35,1;30,1
2008;3540606;Porto Feliz;48246;24215;24031;99,2;32,8;86,7
2008;3540705;Porto Ferreira;50664;25162;25502;101,4;33,5;206,9
2008;3540754;Potim;18155;10028;8127;81;29,4;406,7
2008;3540804;Potirendaba;14995;7639;7356;96,3;35,8;43,8
2008;3540853;Pracinha;2566;1743;823;47,2;32,4;40,7
2008;3540903;Pradópolis;16407;8371;8036;96;31,4;98
2008;3541000;Praia Grande;247798;119534;128264;107,3;32,5;1655,8
2008;3541059;Pratânia;4484;2319;2165;93,4;30,8;25,6
2008;3541109;Presidente Alves;4151;2067;2084;100,8;34,5;14,5
2008;3541208;Presidente Bernardes;13855;6909;6946;100,5;36,6;18,5
2008;3541307;Presidente Epitácio;40952;20113;20839;103,6;32,8;32,5
2008;3541406;Presidente Prudente;204165;98454;105711;107,4;34,4;364,2
2008;3541505;Presidente Venceslau;37916;18935;18981;100,2;35,4;50,2
2008;3541604;Promissão;34742;17343;17399;100,3;33,3;44,6
2008;3541653;Quadra;3102;1642;1460;88,9;33,9;15,1
2008;3541703;Quatá;12507;6241;6266;100,4;32,6;19,2
2008;3541802;Queiroz;2690;1364;1326;97,2;31,4;11,5
2008;3541901;Queluz;10892;5510;5382;97,7;31,6;43,7
2008;3542008;Quintana;5890;2927;2963;101,2;34,2;18,5
2008;3542107;Rafard;8560;4246;4314;101,6;33,1;70,4
2008;3542206;Rancharia;28888;14227;14661;103,1;34;18,2
2008;3542305;Redenção da Serra;3915;2053;1862;90,7;34,2;12,7
2008;3542404;Regente Feijó;18224;9076;9148;100,8;34,2;69,2
2008;3542503;Reginópolis;6806;4127;2679;64,9;32,9;16,6
2008;3542602;Registro;54314;26776;27538;102,8;31,8;75,2
2008;3542701;Restinga;6384;3212;3172;98,8;30,1;26
2008;3542800;Ribeira;3413;1777;1636;92,1;33,5;10,2
2008;3542909;Ribeirão Bonito;11958;6030;5928;98,3;32,3;25,4
2008;3543006;Ribeirão Branco;19116;9865;9251;93,8;28,7;27,4
2008;3543105;Ribeirão Corrente;4185;2176;2009;92,3;30,9;28,2
2008;3543204;Ribeirão do Sul;4459;2245;2214;98,6;35,1;21,9
2008;3543238;Ribeirão dos Índios;2196;1090;1106;101,5;36,8;11,2
2008;3543253;Ribeirão Grande;7441;3810;3631;95,3;31,8;22,3
2008;3543303;Ribeirão Pires;111634;54749;56885;103,9;32,8;1127,9
2008;3543402;Ribeirão Preto;583910;280391;303519;108,2;33,8;897,1
2008;3543501;Riversul;6404;3189;3215;100,8;34;16,6
2008;3543600;Rifaina;3436;1729;1707;98,7;34,7;21,1
2008;3543709;Rincão;10439;5265;5174;98,3;32,1;33
2008;3543808;Rinópolis;10015;5099;4916;96,4;36,3;27,9
2008;3543907;Rio Claro;182418;88901;93517;105,2;34,3;366
2008;3544004;Rio das Pedras;28241;14299;13942;97,5;31,1;124,6
2008;3544103;Rio Grande da Serra;42734;21216;21518;101,4;29,7;1175,9
2008;3544202;Riolândia;10140;5752;4388;76,3;32,1;16
2008;3544251;Rosana;20733;10362;10371;100,1;31,3;27,9
2008;3544301;Roseira;9394;4753;4641;97,6;31,5;72,3
2008;3544400;Rubiácea;2638;1351;1287;95,3;32,5;11,2
2008;3544509;Rubinéia;2811;1383;1428;103,3;37,7;11,6
2008;3544608;Sabino;5149;2586;2563;99,1;35,5;16,9
2008;3544707;Sagres;2394;1190;1204;101,2;34,9;16,2
2008;3544806;Sales;5241;2681;2560;95,5;35;17
2008;3544905;Sales Oliveira;10325;5132;5193;101,2;34,1;33,8
2008;3545001;Salesópolis;15462;7823;7639;97,6;32,3;36,4
2008;3545100;Salmourão;4742;2429;2313;95,2;34,2;27,4
2008;3545159;Saltinho;6783;3394;3389;99,9;34,8;68
2008;3545209;Salto;102973;51027;51946;101,8;32,4;773,9
2008;3545308;Salto de Pirapora;39136;19496;19640;100,7;32,1;139,6
2008;3545407;Salto Grande;8734;4347;4387;100,9;34,1;46,3
2008;3545506;Sandovalina;3586;1809;1777;98,2;31,1;7,9
2008;3545605;Santa Adélia;14205;7109;7096;99,8;34,2;43
2008;3545704;Santa Albertina;5708;2889;2819;97,6;37,6;20,9
2008;3545803;Santa Bárbara d'Oeste;178060;88459;89601;101,3;33,1;657
2008;3546009;Santa Branca;13636;6836;6800;99,5;33,3;50,1
2008;3546108;Santa Clara d'Oeste;2108;1076;1032;95,9;36,4;11,5
2008;3546207;Santa Cruz da Conceição;3915;1948;1967;101;35,1;26,1
2008;3546256;Santa Cruz da Esperança;1925;961;964;100,3;32,9;13
2008;3546306;Santa Cruz das Palmeiras;29054;14756;14298;96,9;31,9;98,4
2008;3546405;Santa Cruz do Rio Pardo;43332;21270;22062;103,7;34,2;38,9
2008;3546504;Santa Ernestina;5615;2912;2703;92,8;30,8;41,8
2008;3546603;Santa Fé do Sul;28694;13855;14839;107,1;36,1;138,9
2008;3546702;Santa Gertrudes;20423;10359;10064;97,2;30,4;207,8
2008;3546801;Santa Isabel;49218;24688;24530;99,4;31,8;135,5
2008;3546900;Santa Lúcia;8145;4105;4040;98,4;30,8;52,9
2008;3547007;Santa Maria da Serra;5252;2683;2569;95,8;31,4;20,8
2008;3547106;Santa Mercedes;2833;1423;1410;99,1;34,2;17
2008;3547205;Santana da Ponte Pensa;1687;858;829;96,6;40,2;13
2008;3547304;Santana de Parnaíba;101364;50135;51229;102,2;30,1;563,3
2008;3547403;Santa Rita d'Oeste;2574;1296;1278;98,6;39,1;12,3
2008;3547502;Santa Rita do Passa Quatro;26447;12817;13630;106,3;37,4;35,1
2008;3547601;Santa Rosa de Viterbo;23337;11548;11789;102,1;34;80,9
2008;3547650;Santa Salete;1441;737;704;95,5;38,8;18,2
2008;3547700;Santo Anastácio;20591;10054;10537;104,8;35,4;37,2
2008;3547809;Santo André;671568;322743;348825;108,1;34,7;3820,5
2008;3547908;Santo Antônio da Alegria;6222;3222;3000;93,1;34,7;20,1
2008;3548005;Santo Antônio de Posse;20098;10132;9966;98,4;32;130,4
2008;3548054;Santo Antônio do Aracanguá;7486;3831;3655;95,4;33;5,7
2008;3548104;Santo Antônio do Jardim;5992;3083;2909;94,4;34,8;54,5
2008;3548203;Santo Antônio do Pinhal;6469;3273;3196;97,6;32,4;48,6
2008;3548302;Santo Expedito;2752;1391;1361;97,8;35,9;29,1
2008;3548401;Santópolis do Aguapeí;4182;2118;2064;97,5;32,1;32,7
2008;3548500;Santos;420206;192757;227449;118;38,1;1495,2
2008;3548609;São Bento do Sapucaí;10458;5269;5189;98,5;34,8;41,4
2008;3548708;São Bernardo do Campo;753108;364390;388718;106,7;32,5;1838,9
2008;3548807;São Caetano do Sul;147310;68171;79139;116,1;38,7;9608,8
2008;3548906;São Carlos;216013;106228;109785;103,3;34,2;190
2008;3549003;São Francisco;2821;1418;1403;98,9;36,8;37,3
2008;3549102;São João da Boa Vista;82559;40155;42404;105,6;35,4;159,9
2008;3549201;São João das Duas Pontes;2590;1308;1282;98;35;20
2008;3549250;São João de Iracema;1760;883;877;99,3;35;9,9
2008;3549300;São João do Pau d'Alho;2115;1070;1045;97,7;38,4;18
2008;3549409;São Joaquim da Barra;45553;22354;23199;103,8;33,4;110,9
2008;3549508;São José da Bela Vista;8362;4280;4082;95,4;30,6;30,2
2008;3549607;São José do Barreiro;4100;2077;2023;97,4;33;7,2
2008;3549706;São José do Rio Pardo;51603;25442;26161;102,8;34,8;123
2008;3549805;São José do Rio Preto;397490;191185;206305;107,9;35;920,2
2008;3549904;São José dos Campos;610852;299921;310931;103,7;31,9;555,6
2008;3549953;São Lourenço da Serra;13619;6912;6707;97;31,2;73
2008;3550001;São Luiz do Paraitinga;10473;5380;5093;94,7;34,7;17
2008;3550100;São Manuel;38046;18681;19365;103,7;33,2;58,5
2008;3550209;São Miguel Arcanjo;31413;15994;15419;96,4;31,2;33,8
2008;3550308;São Paulo;11093746;5261397;5832349;110,9;33,2;7292,8
2008;3550407;São Pedro;30896;15092;15804;104,7;34,7;50,5
2008;3550506;São Pedro do Turvo;7162;3645;3517;96,5;33,1;9,8
2008;3550605;São Roque;76464;37710;38754;102,8;33,5;249,1
2008;3550704;São Sebastião;70618;35353;35265;99,8;30,2;175,5
2008;3550803;São Sebastião da Grama;12196;6218;5978;96,1;33,6;48,3
2008;3550902;São Simão;14239;7029;7210;102,6;34;23,1
2008;3551009;São Vicente;326868;157379;169489;107,7;32,3;2206,3
2008;3551108;Sarapuí;8809;4499;4310;95,8;32,2;25
2008;3551207;Sarutaiá;3646;1830;1816;99,2;33,3;25,7
2008;3551306;Sebastianópolis do Sul;2927;1480;1447;97,8;36,4;17,4
2008;3551405;Serra Azul;10496;6164;4332;70,3;31,4;37,1
2008;3551504;Serrana;37557;18844;18713;99,3;29,9;298
2008;3551603;Serra Negra;25918;12674;13244;104,5;36,3;127,2
2008;3551702;Sertãozinho;106705;53150;53555;100,8;32;264,7
2008;3551801;Sete Barras;13203;6815;6388;93,7;31,3;12,4
2008;3551900;Severínia;15135;7859;7276;92,6;31,1;107,8
2008;3552007;Silveiras;5741;2917;2824;96,8;32,7;13,8
2008;3552106;Socorro;35883;17832;18051;101,2;36,3;79,9
2008;3552205;Sorocaba;567469;278004;289465;104,1;32,7;1261,4
2008;3552304;Sud Mennucci;7376;3721;3655;98,2;33;12,4
2008;3552403;Sumaré;231827;115439;116388;100,8;30,7;1510,6
2008;3552502;Suzano;256046;125849;130197;103,5;30,4;1241,5
2008;3552551;Suzanápolis;3254;1681;1573;93,6;34,4;9,8
2008;3552601;Tabapuã;11190;5664;5526;97,6;35,6;32,4
2008;3552700;Tabatinga;14386;7390;6996;94,7;32,7;39
2008;3552809;Taboão da Serra;234971;112613;122358;108,7;30,3;11525,1
2008;3552908;Taciba;5615;2824;2791;98,8;33,2;9,2
2008;3553005;Taguaí;10109;5040;5069;100,6;31,3;69,6
2008;3553104;Taiaçu;5852;2951;2901;98,3;33,8;54,7
2008;3553203;Taiúva;5460;2712;2748;101,3;36,2;41,2
2008;3553302;Tambaú;22428;11214;11214;100;33,7;39,9
2008;3553401;Tanabi;23735;11854;11881;100,2;36;31,8
2008;3553500;Tapiraí;8193;4150;4043;97,4;30,6;10,9
2008;3553609;Tapiratiba;12799;6364;6435;101,1;33,7;57,7
2008;3553658;Taquaral;2740;1390;1350;97,1;33,6;50,8
2008;3553708;Taquaritinga;53780;26695;27085;101,5;33,9;90,5
2008;3553807;Taquarituba;22258;11096;11162;100,6;32,7;49,6
2008;3553856;Taquarivaí;5023;2529;2494;98,6;28,6;21,7
2008;3553906;Tarabai;6426;3227;3199;99,1;31,8;31,9
2008;3553955;Tarumã;12412;6342;6070;95,7;31,1;41
2008;3554003;Tatuí;104506;51732;52774;102;32,4;199,5
2008;3554102;Taubaté;271615;133408;138207;103,6;32,8;434,6
2008;3554201;Tejupá;4951;2551;2400;94,1;30,8;16,7
2008;3554300;Teodoro Sampaio;21130;10554;10576;100,2;31,1;13,6
2008;3554409;Terra Roxa;8354;4238;4116;97,1;33,3;37,7
2008;3554508;Tietê;35743;17716;18027;101,8;33,7;88,4
2008;3554607;Timburi;2681;1385;1296;93,6;35,7;13,6
2008;3554656;Torre de Pedra;2248;1184;1064;89,9;35,5;31,5
2008;3554706;Torrinha;9230;4666;4564;97,8;35,5;29,3
2008;3554755;Trabiju;1511;756;755;99,9;32,3;23,8
2008;3554805;Tremembé;39720;20934;18786;89,7;32;207,9
2008;3554904;Três Fronteiras;5358;2683;2675;99,7;37;35,3
2008;3554953;Tuiuti;5724;2927;2797;95,6;36;45,2
2008;3555000;Tupã;63585;30832;32753;106,2;36,5;101,3
2008;3555109;Tupi Paulista;14080;7361;6719;91,3;38,3;57,5
2008;3555208;Turiúba;1925;1001;924;92,3;37,9;12,6
2008;3555307;Turmalina;2065;1027;1038;101,1;39;14
2008;3555356;Ubarana;5070;2612;2458;94,1;30,7;24,2
2008;3555406;Ubatuba;76604;38245;38359;100,3;30,9;108,2
2008;3555505;Ubirajara;4359;2237;2122;94,9;33,6;15,4
2008;3555604;Uchoa;9381;4677;4704;100,6;36,1;37,2
2008;3555703;União Paulista;1554;819;735;89,7;33,9;19,7
2008;3555802;Urânia;8872;4423;4449;100,6;36,5;42,4
2008;3555901;Uru;1272;655;617;94,2;36,6;8,7
2008;3556008;Urupês;12563;6259;6304;100,7;36,7;38,8
2008;3556107;Valentim Gentil;10494;5288;5206;98,4;33,6;70,1
2008;3556206;Valinhos;101927;50407;51520;102,2;34,2;686,2
2008;3556305;Valparaíso;21654;11781;9873;83,8;32,4;25,2
2008;3556354;Vargem;8421;4323;4098;94,8;34,2;59,1
2008;3556404;Vargem Grande do Sul;38679;19220;19459;101,2;33,4;144,8
2008;3556453;Vargem Grande Paulista;40873;20341;20532;100,9;30,5;962
2008;3556503;Várzea Paulista;103987;51953;52034;100,2;30,3;2960,9
2008;3556602;Vera Cruz;10848;5347;5501;102,9;35;43,8
2008;3556701;Vinhedo;60055;29774;30281;101,7;33,5;741,9
2008;3556800;Viradouro;17013;8586;8427;98,1;33;78,1
2008;3556909;Vista Alegre do Alto;6424;3292;3132;95,1;32,6;67,3
2008;3556958;Vitória Brasil;1722;882;840;95,2;35,1;34,6
2008;3557006;Votorantim;106387;52889;53498;101,2;31,2;577,6
2008;3557105;Votuporanga;82825;40470;42355;104,7;35,5;196,9
2008;3557154;Zacarias;2252;1135;1117;98,4;35,4;7,1
2008;3557204;Chavantes;12110;6033;6077;100,7;33,1;64,2
2008;3557303;Estiva Gerbi;9797;4968;4829;97,2;32;132,1
2009;3500105;Adamantina;33765;16372;17393;106,2;37,3;82
2009;3500204;Adolfo;3581;1806;1775;98,3;36;17
2009;3500303;Aguaí;31730;15993;15737;98,4;32,7;66,9
2009;3500402;Águas da Prata;7534;3730;3804;102;37,5;52,8
2009;3500501;Águas de Lindóia;17185;8434;8751;103,8;35,4;285,8
2009;3500550;Águas de Santa Bárbara;5574;2775;2799;100,9;34,5;13,8
2009;3500600;Águas de São Pedro;2613;1216;1397;114,9;40,9;723,4
2009;3500709;Agudos;34338;16994;17344;102,1;32,6;35,5
2009;3500758;Alambari;4749;2402;2347;97,7;32;29,8
2009;3500808;Alfredo Marcondes;3876;1976;1900;96,2;38,2;32,6
2009;3500907;Altair;3786;2033;1753;86,2;31,6;12,1
2009;3501004;Altinópolis;15644;7836;7808;99,6;34,6;16,8
2009;3501103;Alto Alegre;4120;2121;1999;94,2;38;12,9
2009;3501152;Alumínio;16687;8418;8269;98,2;30,7;199,6
2009;3501202;Álvares Florence;3947;2023;1924;95,1;39,4;10,9
2009;3501301;Álvares Machado;23493;11646;11847;101,7;33,9;67,6
2009;3501400;Álvaro de Carvalho;4602;2896;1706;58,9;32,2;29,9
2009;3501509;Alvinlândia;2964;1467;1497;102;32,8;34,9
2009;3501608;Americana;207733;101860;105873;103,9;35;1551,3
2009;3501707;Américo Brasiliense;33757;16995;16762;98,6;30,4;274,5
2009;3501806;Américo de Campos;5685;2858;2827;98,9;36,9;22,5
2009;3501905;Amparo;65266;32213;33053;102,6;35,3;146,6
2009;3502002;Analândia;4221;2167;2054;94,8;34;12,9
2009;3502101;Andradina;55334;27207;28127;103,4;35,7;57,4
2009;3502200;Angatuba;21910;11120;10790;97;32,9;21,3
2009;3502309;Anhembi;5531;2847;2684;94,3;32,4;7,5
2009;3502408;Anhumas;3706;1847;1859;100,6;34;11,6
2009;3502507;Aparecida;34978;16913;18065;106,8;33,7;289,3
2009;3502606;Aparecida d'Oeste;4499;2201;2298;104,4;37,9;25,1
2009;3502705;Apiaí;25490;12741;12749;100,1;31,1;26,2
2009;3502754;Araçariguama;16454;8391;8063;96,1;29,3;113,3
2009;3502804;Araçatuba;180316;86788;93528;107,8;35,5;154,5
2009;3502903;Araçoiaba da Serra;26452;13196;13256;100,5;33,6;103,6
2009;3503000;Aramina;5081;2552;2529;99,1;35;25,1
2009;3503109;Arandu;6154;3104;3050;98,3;32,7;21,5
2009;3503158;Arapeí;2506;1257;1249;99,4;33,8;16
2009;3503208;Araraquara;205719;99332;106387;107,1;35,3;205
2009;3503307;Araras;117133;57926;59207;102,2;34,1;181,6
2009;3503356;Arco-Íris;1958;994;964;97;36,3;7,4
2009;3503406;Arealva;7780;3959;3821;96,5;37,1;15,4
2009;3503505;Areias;3687;1839;1848;100,5;32,1;12,1
2009;3503604;Areiópolis;10558;5448;5110;93,8;30,1;122,9
2009;3503703;Ariranha;8419;4300;4119;95,8;34,2;63,5
2009;3503802;Artur Nogueira;42988;21494;21494;100;31,7;241,5
2009;3503901;Arujá;73167;36136;37031;102,5;30,7;760,8
2009;3503950;Aspásia;1820;909;911;100,2;37,1;26,2
2009;3504008;Assis;94234;45873;48361;105,4;35,1;204,6
2009;3504107;Atibaia;124999;61523;63476;103,2;33,6;261,2
2009;3504206;Auriflama;14145;7081;7064;99,8;35,7;32,6
2009;3504305;Avaí;4914;2487;2427;97,6;32,9;9,1
2009;3504404;Avanhandava;11045;6030;5015;83,2;31,5;32,6
2009;3504503;Avaré;82237;40830;41407;101,4;33,7;67,8
2009;3504602;Bady Bassitt;14245;7079;7166;101,2;33,9;129,1
2009;3504701;Balbinos;3441;2672;769;28,8;33,3;37,6
2009;3504800;Bálsamo;8073;3960;4113;103,9;36,9;53,9
2009;3504909;Bananal;10199;5048;5151;102;34;16,5
2009;3505005;Barão de Antonina;3058;1567;1491;95,1;34,2;20
2009;3505104;Barbosa;6503;3273;3230;98,7;33;31,7
2009;3505203;Bariri;31227;15638;15589;99,7;35,1;70,3
2009;3505302;Barra Bonita;35289;17317;17972;103,8;35,5;235,1
2009;3505351;Barra do Chapéu;5220;2765;2455;88,8;31,1;12,9
2009;3505401;Barra do Turvo;7773;4082;3691;90,4;31,6;7,7
2009;3505500;Barretos;111084;53733;57351;106,7;34,7;70,9
2009;3505609;Barrinha;28001;14087;13914;98,8;29,5;191,8
2009;3505708;Barueri;236977;115444;121533;105,3;30,1;3606,9
2009;3505807;Bastos;20504;10079;10425;103,4;33,7;120
2009;3505906;Batatais;55931;27505;28426;103,3;34,6;65,8
2009;3506003;Bauru;341125;165463;175662;106,2;34,3;510,9
2009;3506102;Bebedouro;75096;36617;38479;105,1;34,6;109,9
2009;3506201;Bento de Abreu;2633;1339;1294;96,6;33,4;8,7
2009;3506300;Bernardino de Campos;10764;5259;5505;104,7;36;44,1
2009;3506359;Bertioga;45624;22903;22721;99,2;29,5;92,8
2009;3506409;Bilac;6959;3448;3511;101,8;36,7;44
2009;3506508;Birigui;107188;52387;54801;104,6;34,4;202,2
2009;3506607;Biritiba Mirim;28166;14217;13949;98,1;31,5;88,7
2009;3506706;Boa Esperança do Sul;13530;6819;6711;98,4;31,7;19,6
2009;3506805;Bocaina;10718;5338;5380;100,8;33,7;29,5
2009;3506904;Bofete;9364;4788;4576;95,6;33,7;14,3
2009;3507001;Boituva;46720;23529;23191;98,6;31,9;187,7
2009;3507100;Bom Jesus dos Perdões;18983;9553;9430;98,7;31,7;175,2
2009;3507159;Bom Sucesso de Itararé;3544;1805;1739;96,3;28,3;26,5
2009;3507209;Borá;813;413;400;96,9;33;6,8
2009;3507308;Boracéia;4209;2146;2063;96,1;33;34,5
2009;3507407;Borborema;14384;7284;7100;97,5;35,3;26
2009;3507456;Borebi;2255;1129;1126;99,7;31,6;6,5
2009;3507506;Botucatu;125320;60832;64488;106;34,2;84,5
2009;3507605;Bragança Paulista;144431;71020;73411;103,4;33,9;281,8
2009;3507704;Braúna;4941;2514;2427;96,5;35,5;25,3
2009;3507753;Brejo Alegre;2550;1311;1239;94,5;33,6;24,1
2009;3507803;Brodowski;20719;10290;10429;101,4;33,5;74,4
2009;3507902;Brotas;21311;10604;10707;101;33,5;19,3
2009;3508009;Buri;18459;9481;8978;94,7;30,3;15,4
2009;3508108;Buritama;15230;7635;7595;99,5;35,1;46,6
2009;3508207;Buritizal;4021;2052;1969;96;35,3;15,1
2009;3508306;Cabrália Paulista;4396;2240;2156;96,3;32,4;18,3
2009;3508405;Cabreúva;40648;20628;20020;97,1;29,9;156,2
2009;3508504;Caçapava;83747;41511;42236;101,7;33;227
2009;3508603;Cachoeira Paulista;29802;14623;15179;103,8;33,7;103,5
2009;3508702;Caconde;18577;9324;9253;99,2;33,9;39,7
2009;3508801;Cafelândia;16519;8140;8379;102,9;35;17,9
2009;3508900;Caiabu;4073;2082;1991;95,6;35,2;16,1
2009;3509007;Caieiras;84866;41564;43302;104,2;30,9;869,2
2009;3509106;Caiuá;4939;2599;2340;90;34,6;9
2009;3509205;Cajamar;62670;31324;31346;100,1;29,5;477
2009;3509254;Cajati;28572;14470;14102;97,5;30,3;62,9
2009;3509304;Cajobi;9712;5000;4712;94,2;34,6;54,9
2009;3509403;Cajuru;23114;11594;11520;99,4;32,8;35
2009;3509452;Campina do Monte Alegre;5540;2849;2691;94,5;32,8;30
2009;3509502;Campinas;1067421;515395;552026;107,1;34,2;1343,4
2009;3509601;Campo Limpo Paulista;73006;35936;37070;103,2;31,6;919,4
2009;3509700;Campos do Jordão;47509;23299;24210;103,9;31,2;163,8
2009;3509809;Campos Novos Paulista;4503;2315;2188;94,5;33,6;9,3
2009;3509908;Cananéia;12242;6143;6099;99,3;32,1;9,9
2009;3509957;Canas;4282;2174;2108;97;30,4;80,4
2009;3510005;Cândido Mota;29833;14666;15167;103,4;34,6;50,1
2009;3510104;Cândido Rodrigues;2667;1308;1359;103,9;38,1;37,6
2009;3510153;Canitar;4289;2183;2106;96,5;29,7;74,6
2009;3510203;Capão Bonito;46346;23132;23214;100,4;31,7;28,3
2009;3510302;Capela do Alto;17184;8850;8334;94,2;31,2;101,1
2009;3510401;Capivari;47795;23947;23848;99,6;32,2;148
2009;3510500;Caraguatatuba;98410;48851;49559;101,4;32,2;202,9
2009;3510609;Carapicuíba;366849;178209;188640;105,9;30,5;10619,2
2009;3510708;Cardoso;11809;5831;5978;102,5;36,3;18,5
2009;3510807;Casa Branca;28115;14884;13231;88,9;34,8;32,5
2009;3510906;Cássia dos Coqueiros;2671;1366;1305;95,5;35;13,9
2009;3511003;Castilho;17652;8805;8847;100,5;33,6;16,6
2009;3511102;Catanduva;112061;54461;57600;105,8;35,9;385,6
2009;3511201;Catiguá;7063;3603;3460;96;34;47,6
2009;3511300;Cedral;7848;3919;3929;100,3;36,8;39,7
2009;3511409;Cerqueira César;17277;8558;8719;101,9;33,3;33,8
2009;3511508;Cerquilho;38458;19080;19378;101,6;33,4;300,9
2009;3511607;Cesário Lange;15247;7924;7323;92,4;32,7;80,1
2009;3511706;Charqueada;14849;7554;7295;96,6;32,4;84,4
2009;3511904;Clementina;6852;3545;3307;93,3;31,9;40,6
2009;3512001;Colina;17316;8605;8711;101,2;34;41
2009;3512100;Colômbia;5987;3064;2923;95,4;32,1;8,2
2009;3512209;Conchal;24932;12604;12328;97,8;31,2;136,4
2009;3512308;Conchas;16138;8124;8014;98,6;34,5;34,6
2009;3512407;Cordeirópolis;20701;10401;10300;99;32,9;150,5
2009;3512506;Coroados;5160;2576;2584;100,3;34,1;20,9
2009;3512605;Coronel Macedo;5063;2594;2469;95,2;33,5;16,7
2009;3512704;Corumbataí;3868;1973;1895;96;33,3;13,9
2009;3512803;Cosmópolis;57220;28610;28610;100;31,6;370
2009;3512902;Cosmorama;7241;3660;3581;97,8;38;16,4
2009;3513009;Cotia;195329;95739;99590;104;30,8;602,9
2009;3513108;Cravinhos;31382;15762;15620;99,1;32,7;100,8
2009;3513207;Cristais Paulista;7496;3829;3667;95,8;32,8;19,5
2009;3513306;Cruzália;2319;1131;1188;105;36;15,5
2009;3513405;Cruzeiro;76767;37394;39373;105,3;33,6;251,1
2009;3513504;Cubatão;117768;58818;58950;100,2;30,6;824,2
2009;3513603;Cunha;22076;11290;10786;95,5;33,7;15,7
2009;3513702;Descalvado;30853;15246;15607;102,4;34,8;40,9
2009;3513801;Diadema;383428;185840;197588;106,3;30,6;12476,5
2009;3513850;Dirce Reis;1679;868;811;93,4;37;19,1
2009;3513900;Divinolândia;11352;5678;5674;99,9;36,1;50,7
2009;3514007;Dobrada;7818;4068;3750;92,2;30,2;52,2
2009;3514106;Dois Córregos;24479;12280;12199;99,3;33,5;38,7
2009;3514205;Dolcinópolis;2100;1093;1007;92,1;37,6;26,9
2009;3514304;Dourado;8607;4369;4238;97;35,9;41,8
2009;3514403;Dracena;42977;21226;21751;102,5;36,9;88,1
2009;3514502;Duartina;12301;6001;6300;105;36,3;46,5
2009;3514601;Dumont;7953;4009;3944;98,4;32,1;71,4
2009;3514700;Echaporã;6380;3146;3234;102,8;34,6;12,4
2009;3514809;Eldorado;14631;7487;7144;95,4;30,7;8,8
2009;3514908;Elias Fausto;15548;8048;7500;93,2;31,6;76,8
2009;3514924;Elisiário;3063;1616;1447;89,5;35;32,6
2009;3514957;Embaúba;2431;1265;1166;92,2;35,2;29,2
2009;3515004;Embu das Artes;236644;115182;121462;105,5;29,4;3361,5
2009;3515103;Embu-Guaçu;62190;30934;31256;101;31;399,6
2009;3515129;Emilianópolis;3010;1511;1499;99,2;36;13,4
2009;3515152;Engenheiro Coelho;15072;7887;7185;91,1;29,2;137,1
2009;3515186;Espírito Santo do Pinhal;41767;20473;21294;104;35,2;107,3
2009;3515194;Espírito Santo do Turvo;4180;2104;2076;98,7;30,7;21,6
2009;3515202;Estrela d'Oeste;8224;4147;4077;98,3;36,1;27,8
2009;3515301;Estrela do Norte;2651;1370;1281;93,5;32,8;10
2009;3515350;Euclides da Cunha Paulista;9670;4876;4794;98,3;31,7;16,8
2009;3515400;Fartura;15273;7428;7845;105,6;34,5;35,6
2009;3515509;Fernandópolis;64436;31433;33003;105;36,4;117,2
2009;3515608;Fernando Prestes;5517;2737;2780;101,6;37,5;32,5
2009;3515657;Fernão;1550;785;765;97,5;34,8;15,4
2009;3515707;Ferraz de Vasconcelos;165608;80932;84676;104,6;29,5;5604,8
2009;3515806;Flora Rica;1815;912;903;99;38;8,1
2009;3515905;Floreal;3024;1500;1524;101,6;39,9;14,8
2009;3516002;Flórida Paulista;12638;6859;5779;84,3;34,4;24,1
2009;3516101;Florínea;2862;1390;1472;105,9;35,2;12,7
2009;3516200;Franca;315639;154215;161424;104,7;32,9;521,1
2009;3516309;Francisco Morato;152317;75632;76685;101,4;28,5;3108,4
2009;3516408;Franco da Rocha;128972;66197;62775;94,8;30,2;971,4
2009;3516507;Gabriel Monteiro;2722;1384;1338;96,7;37,4;19,6
2009;3516606;Gália;7108;3564;3544;99,4;35,9;20
2009;3516705;Garça;43115;21005;22110;105,3;34,9;77,6
2009;3516804;Gastão Vidigal;4126;2234;1892;84,7;33,6;22,8
2009;3516853;Gavião Peixoto;4389;2285;2104;92,1;31,7;18
2009;3516903;General Salgado;10691;5374;5317;98,9;36;21,6
2009;3517000;Getulina;10742;5841;4901;83,9;34,2;15,9
2009;3517109;Glicério;4556;2285;2271;99,4;34,1;16,7
2009;3517208;Guaiçara;10504;5288;5216;98,6;32,5;37,9
2009;3517307;Guaimbê;5419;2702;2717;100,6;33,3;24,9
2009;3517406;Guaíra;37130;18414;18716;101,6;33,7;29,5
2009;3517505;Guapiaçu;17436;8810;8626;97,9;34,4;53,6
2009;3517604;Guapiara;18273;9306;8967;96,4;32;44,8
2009;3517703;Guará;19803;9862;9941;100,8;31,6;54,7
2009;3517802;Guaraçaí;8480;4229;4251;100,5;36,6;14,9
2009;3517901;Guaraci;9855;5025;4830;96,1;33;15,4
2009;3518008;Guarani d'Oeste;1975;968;1007;104;36,4;23
2009;3518107;Guarantã;6397;3221;3176;98,6;32,1;13,9
2009;3518206;Guararapes;30380;14996;15384;102,6;35,2;31,8
2009;3518305;Guararema;25461;12827;12634;98,5;32,5;94
2009;3518404;Guaratinguetá;111345;53687;57658;107,4;34,3;147,9
2009;3518503;Guareí;14100;8489;5611;66,1;32,4;24,8
2009;3518602;Guariba;34976;17661;17315;98;31;129,4
2009;3518701;Guarujá;288299;140747;147552;104,8;31,2;1991,1
2009;3518800;Guarulhos;1206138;588098;618040;105,1;30,7;3784,9
2009;3518859;Guatapará;6925;3557;3368;94,7;32,3;16,7
2009;3518909;Guzolândia;4707;2416;2291;94,8;33,4;18,6
2009;3519006;Herculândia;8634;4320;4314;99,9;33,6;23,7
2009;3519055;Holambra;10843;5507;5336;96,9;32,1;165,3
2009;3519071;Hortolândia;188291;95131;93160;97,9;30,5;3016,7
2009;3519105;Iacanga;9821;5052;4769;94,4;34,3;17,9
2009;3519204;Iacri;6449;3269;3180;97,3;35,4;20
2009;3519253;Iaras;5991;3868;2123;54,9;32,1;14,9
2009;3519303;Ibaté;30252;15548;14704;94,6;30,7;104
2009;3519402;Ibirá;10741;5324;5417;101,7;35,7;39,5
2009;3519501;Ibirarema;6612;3347;3265;97,6;33,8;29
2009;3519600;Ibitinga;52389;25839;26550;102,8;34,1;76
2009;3519709;Ibiúna;70676;36003;34673;96,3;31,7;66,8
2009;3519808;Icém;7404;3767;3637;96,5;32,7;20,4
2009;3519907;Iepê;7585;3761;3824;101,7;35,1;12,7
2009;3520004;Igaraçu do Tietê;23293;11627;11666;100,3;32,4;238,3
2009;3520103;Igarapava;27734;13722;14012;102,1;33,9;59,2
2009;3520202;Igaratá;8805;4521;4284;94,8;32,9;30,1
2009;3520301;Iguape;28795;14460;14335;99,1;34;14,6
2009;3520400;Ilhabela;27363;13948;13415;96,2;30,5;79
2009;3520426;Ilha Comprida;8770;4354;4416;101,4;35,6;44,6
2009;3520442;Ilha Solteira;24964;12174;12790;105,1;35,4;38,3
2009;3520509;Indaiatuba;195506;97211;98295;101,1;32,7;627,5
2009;3520608;Indiana;4839;2428;2411;99,3;35,1;37,4
2009;3520707;Indiaporã;3914;1929;1985;102,9;37,8;14
2009;3520806;Inúbia Paulista;3590;1799;1791;99,6;35,1;41,2
2009;3520905;Ipaussu;13557;6831;6726;98,5;33;64,7
2009;3521002;Iperó;27157;14582;12575;86,2;30,5;159,5
2009;3521101;Ipeúna;5819;3010;2809;93,3;31,5;30,6
2009;3521150;Ipiguá;4353;2210;2143;97;35,3;32
2009;3521200;Iporanga;4347;2202;2145;97,4;31;3,8
2009;3521309;Ipuã;13912;7095;6817;96,1;31,4;29,8
2009;3521408;Iracemápolis;19538;9806;9732;99,2;32,8;169,7
2009;3521507;Irapuã;7209;3767;3442;91,4;34;28
2009;3521606;Irapuru;7762;4436;3326;75;36,4;36,2
2009;3521705;Itaberá;18003;9101;8902;97,8;32,7;16,4
2009;3521804;Itaí;23713;12554;11159;88,9;32,2;21,7
2009;3521903;Itajobi;14510;7330;7180;98;37,1;28,9
2009;3522000;Itaju;3193;1674;1519;90,7;33,9;13,9
2009;3522109;Itanhaém;85477;41548;43929;105,7;33,6;142,1
2009;3522158;Itaoca;3239;1679;1560;92,9;34;17,7
2009;3522208;Itapecerica da Serra;150500;75146;75354;100,3;29,6;998,4
2009;3522307;Itapetininga;142519;71260;71259;100;32,3;79,6
2009;3522406;Itapeva;87491;43136;44355;102,8;31,1;47,9
2009;3522505;Itapevi;196544;96761;99783;103,1;28,6;2377,8
2009;3522604;Itapira;68029;33743;34286;101,6;35,5;131,2
2009;3522653;Itapirapuã Paulista;3877;2004;1873;93,5;29,9;9,5
2009;3522703;Itápolis;39836;19770;20066;101,5;35,3;40
2009;3522802;Itaporanga;14551;7286;7265;99,7;33,7;28,6
2009;3522901;Itapuí;11972;6065;5907;97,4;33,1;85,5
2009;3523008;Itapura;4286;2210;2076;93,9;33,3;14,2
2009;3523107;Itaquaquecetuba;316546;156218;160328;102,6;28,5;3831,3
2009;3523206;Itararé;47936;23552;24384;103,5;32,1;47,8
2009;3523305;Itariri;15275;7705;7570;98,2;30,5;55,8
2009;3523404;Itatiba;99225;49083;50142;102,2;33,3;307,9
2009;3523503;Itatinga;17799;9100;8699;95,6;30,4;18,2
2009;3523602;Itirapina;15229;8933;6296;70,5;32,2;27
2009;3523701;Itirapuã;5870;3002;2868;95,5;32,3;36,4
2009;3523800;Itobi;7555;3917;3638;92,9;33,6;54,4
2009;3523909;Itu;152123;75303;76820;102;32,6;237,4
2009;3524006;Itupeva;42593;21661;20932;96,6;30,5;212
2009;3524105;Ituverava;38499;18807;19692;104,7;34,7;54,6
2009;3524204;Jaborandi;6558;3320;3238;97,5;33,7;24
2009;3524303;Jaboticabal;71313;34667;36646;105,7;34,6;100,9
2009;3524402;Jacareí;209216;102279;106937;104,6;32,9;450,6
2009;3524501;Jaci;5485;2808;2677;95,3;32,9;37,8
2009;3524600;Jacupiranga;17210;8785;8425;95,9;31,7;24,4
2009;3524709;Jaguariúna;42634;21207;21427;101;32,6;301,5
2009;3524808;Jales;46990;23012;23978;104,2;36,4;127,5
2009;3524907;Jambeiro;5202;2694;2508;93,1;32,9;28,2
2009;3525003;Jandira;106608;52296;54312;103,9;29,5;6109,7
2009;3525102;Jardinópolis;36879;18558;18321;98,7;32,5;73,5
2009;3525201;Jarinu;23101;11660;11441;98,1;32;111,3
2009;3525300;Jaú;128964;63267;65697;103,8;34,4;187,7
2009;3525409;Jeriquara;3174;1632;1542;94,5;31,3;22,4
2009;3525508;Joanópolis;11638;5870;5768;98,3;34,9;31,1
2009;3525607;João Ramalho;4099;2071;2028;97,9;31,9;9,9
2009;3525706;José Bonifácio;32319;16133;16186;100,3;34;37,6
2009;3525805;Júlio Mesquita;4400;2175;2225;102,3;33,1;34,3
2009;3525854;Jumirim;2734;1417;1317;92,9;32,7;48,2
2009;3525904;Jundiaí;364817;177640;187177;105,4;34,9;846
2009;3526001;Junqueirópolis;18536;9807;8729;89;36,3;31,8
2009;3526100;Juquiá;19443;9851;9592;97,4;32,2;23,9
2009;3526209;Juquitiba;28577;14461;14116;97,6;30,7;54,7
2009;3526308;Lagoinha;4850;2495;2355;94,4;35,9;19
2009;3526407;Laranjal Paulista;24923;12314;12609;102,4;34,6;64,9
2009;3526506;Lavínia;8373;5683;2690;47,3;34,2;15,6
2009;3526605;Lavrinhas;6533;3304;3229;97,7;30,2;39,1
2009;3526704;Leme;90662;45522;45140;99,2;32,2;225
2009;3526803;Lençóis Paulista;60761;30196;30565;101,2;32,6;75,1
2009;3526902;Limeira;273297;134461;138836;103,3;33,6;470,6
2009;3527009;Lindóia;6558;3265;3293;100,9;34,3;134,5
2009;3527108;Lins;70860;34394;36466;106;35,2;124,3
2009;3527207;Lorena;82039;39653;42386;106,9;33,4;198,1
2009;3527256;Lourdes;2116;1098;1018;92,7;36,3;18,6
2009;3527306;Louveira;35586;18021;17565;97,5;30,4;638,4
2009;3527405;Lucélia;19737;10451;9286;88,9;35,1;62,7
2009;3527504;Lucianópolis;2236;1126;1110;98,6;34,4;11,8
2009;3527603;Luís Antônio;10820;5587;5233;93,7;29,7;18,1
2009;3527702;Luiziânia;4945;2569;2376;92,5;33,8;29,7
2009;3527801;Lupércio;4348;2130;2218;104,1;33,1;28
2009;3527900;Lutécia;2738;1366;1372;100,4;34,4;5,8
2009;3528007;Macatuba;16203;8128;8075;99,3;32,6;72,2
2009;3528106;Macaubal;7642;3875;3767;97,2;37,4;30,8
2009;3528205;Macedônia;3679;1843;1836;99,6;36,9;11,2
2009;3528304;Magda;3213;1663;1550;93,2;37,4;10,3
2009;3528403;Mairinque;42885;21387;21498;100,5;31,8;204,1
2009;3528502;Mairiporã;78703;39803;38900;97,7;32;245,4
2009;3528601;Manduri;8897;4471;4426;99;34,4;38,8
2009;3528700;Marabá Paulista;4687;2892;1795;62,1;33;5,1
2009;3528809;Maracaí;13300;6662;6638;99,6;33,7;24,9
2009;3528858;Marapoama;2587;1331;1256;94,4;35,8;23,3
2009;3528908;Mariápolis;3901;2006;1895;94,5;35,2;20,9
2009;3529005;Marília;214638;103862;110776;106,7;34,7;183,4
2009;3529104;Marinópolis;2134;1081;1053;97,4;35,1;27,4
2009;3529203;Martinópolis;24008;12472;11536;92,5;34,5;19,2
2009;3529302;Matão;76342;37860;38482;101,6;33,8;145,4
2009;3529401;Mauá;411784;201680;210104;104,2;31;6648,4
2009;3529500;Mendonça;4545;2308;2237;96,9;36;23,3
2009;3529609;Meridiano;3882;1918;1964;102,4;36,2;17
2009;3529658;Mesópolis;1889;959;930;97;35,7;12,7
2009;3529708;Miguelópolis;20308;10148;10160;100,1;32,3;24,7
2009;3529807;Mineiros do Tietê;11964;5969;5995;100,4;33,3;56,1
2009;3529906;Miracatu;20850;10564;10286;97,4;30,9;20,8
2009;3530003;Mira Estrela;2797;1405;1392;99,1;36,9;12,9
2009;3530102;Mirandópolis;27297;14909;12388;83,1;36,1;29,7
2009;3530201;Mirante do Paranapanema;16958;8614;8344;96,9;34,6;13,7
2009;3530300;Mirassol;53234;26150;27084;103,6;35,1;218,9
2009;3530409;Mirassolândia;4224;2160;2064;95,6;35,2;25,4
2009;3530508;Mococa;66297;33103;33194;100,3;34,6;77,5
2009;3530607;Mogi das Cruzes;381881;186234;195647;105,1;32;535,9
2009;3530706;Mogi Guaçu;135947;67554;68393;101,2;33,5;167,3
2009;3530805;Mogi Mirim;85974;42413;43561;102,7;34,6;172,7
2009;3530904;Mombuca;3243;1655;1588;96;31,9;24,3
2009;3531001;Monções;2125;1102;1023;92,8;37,8;20,4
2009;3531100;Mongaguá;45131;22596;22535;99,7;33,8;316,1
2009;3531209;Monte Alegre do Sul;7046;3524;3522;99,9;36,2;63,9
2009;3531308;Monte Alto;46324;22860;23464;102,6;35,6;133,5
2009;3531407;Monte Aprazível;21380;10626;10754;101,2;36,1;43,1
2009;3531506;Monte Azul Paulista;19035;9551;9484;99,3;34,6;72,2
2009;3531605;Monte Castelo;4064;2018;2046;101,4;37,4;17,4
2009;3531704;Monteiro Lobato;4062;2120;1942;91,6;34,3;12,2
2009;3531803;Monte Mor;47614;23822;23792;99,9;31;197,9
2009;3531902;Morro Agudo;28701;14665;14036;95,7;30,8;20,7
2009;3532009;Morungaba;11583;5809;5774;99,4;32,7;78,9
2009;3532058;Motuca;4253;2160;2093;96,9;32,6;18,6
2009;3532108;Murutinga do Sul;4152;2084;2068;99,2;38,3;16,6
2009;3532157;Nantes;2652;1337;1315;98,4;31;9,3
2009;3532207;Narandiba;4220;2132;2088;97,9;31,9;11,8
2009;3532306;Natividade da Serra;6706;3499;3207;91,7;36;8
2009;3532405;Nazaré Paulista;16211;8352;7859;94,1;33,8;49,7
2009;3532504;Neves Paulista;8792;4376;4416;100,9;38,2;40,1
2009;3532603;Nhandeara;10674;5250;5424;103,3;38,3;24,5
2009;3532702;Nipoã;4156;2194;1962;89,4;33,1;30,2
2009;3532801;Nova Aliança;5765;2858;2907;101,7;35,9;26,5
2009;3532827;Nova Campina;8423;4305;4118;95,7;28,4;21,9
2009;3532843;Nova Canaã Paulista;2160;1101;1059;96,2;39,7;17,4
2009;3532868;Nova Castilho;1105;544;561;103,1;34,8;6
2009;3532900;Nova Europa;9060;4538;4522;99,6;32,1;56,5
2009;3533007;Nova Granada;18936;9531;9405;98,7;34,3;35,6
2009;3533106;Nova Guataporanga;2177;1111;1066;95,9;37,7;63,7
2009;3533205;Nova Independência;2940;1459;1481;101,5;32,2;11,1
2009;3533254;Novais;4406;2370;2036;85,9;30,6;37,4
2009;3533304;Nova Luzitânia;3364;1776;1588;89,4;33,4;45,6
2009;3533403;Nova Odessa;50289;24886;25403;102,1;33,3;681,5
2009;3533502;Novo Horizonte;36126;18029;18097;100,4;34,9;38,8
2009;3533601;Nuporanga;6755;3383;3372;99,7;34,4;19,4
2009;3533700;Ocauçu;4153;2128;2025;95,2;34,3;13,8
2009;3533809;Óleo;2711;1371;1340;97,7;36,4;13,6
2009;3533908;Olímpia;49607;24497;25110;102,5;35;61,8
2009;3534005;Onda Verde;3835;1970;1865;94,7;33;15,8
2009;3534104;Oriente;6066;2974;3092;104;35,6;27,7
2009;3534203;Orindiúva;5519;2816;2703;96;30,8;22,3
2009;3534302;Orlândia;39446;19361;20085;103,7;33,5;135,2
2009;3534401;Osasco;665845;320508;345337;107,7;32,1;10251
2009;3534500;Oscar Bressane;2531;1215;1316;108,3;38,2;11,4
2009;3534609;Osvaldo Cruz;30835;15473;15362;99,3;36,9;124,3
2009;3534708;Ourinhos;101957;49525;52432;105,9;34;344,7
2009;3534757;Ouroeste;8130;4053;4077;100,6;34,2;28,2
2009;3534807;Ouro Verde;7740;3839;3901;101,6;33,7;29
2009;3534906;Pacaembu;13164;7627;5537;72,6;36,3;38,8
2009;3535002;Palestina;10816;5469;5347;97,8;36,2;15,5
2009;3535101;Palmares Paulista;10666;5684;4982;87,6;29,6;129,9
2009;3535200;Palmeira d'Oeste;9668;4859;4809;99;37,8;30,3
2009;3535309;Palmital;21147;10344;10803;104,4;36,2;38,6
2009;3535408;Panorama;14495;7285;7210;99;32,1;40,7
2009;3535507;Paraguaçu Paulista;42053;21111;20942;99,2;33,6;42
2009;3535606;Paraibuna;17371;8839;8532;96,5;33,1;21,5
2009;3535705;Paraíso;5843;2987;2856;95,6;34,7;37,7
2009;3535804;Paranapanema;17571;8967;8604;96;31,4;17,2
2009;3535903;Paranapuã;3804;1947;1857;95,4;35,7;27,1
2009;3536000;Parapuã;10907;5563;5344;96,1;36,5;29,7
2009;3536109;Pardinho;5478;2801;2677;95,6;32,2;26,1
2009;3536208;Pariquera-Açu;18347;9107;9240;101,5;32,3;51
2009;3536257;Parisi;2028;1044;984;94,3;37;23,9
2009;3536307;Patrocínio Paulista;12802;6506;6296;96,8;32,7;21,2
2009;3536406;Paulicéia;6224;3234;2990;92,5;32;16,6
2009;3536505;Paulínia;78641;38989;39652;101,7;31,6;566,7
2009;3536570;Paulistânia;1787;940;847;90,1;33,7;7
2009;3536604;Paulo de Faria;8605;4312;4293;99,6;33,9;11,7
2009;3536703;Pederneiras;40982;20614;20368;98,8;32,6;56,3
2009;3536802;Pedra Bela;5755;3019;2736;90,6;34,7;36,3
2009;3536901;Pedranópolis;2578;1323;1255;94,9;37,5;9,9
2009;3537008;Pedregulho;15643;7961;7682;96,5;32,5;22
2009;3537107;Pedreira;40911;20283;20628;101,7;33,8;376
2009;3537156;Pedrinhas Paulista;2941;1466;1475;100,6;34,8;19,3
2009;3537206;Pedro de Toledo;10123;5116;5007;97,9;32,5;15,1
2009;3537305;Penápolis;58118;28382;29736;104,8;35,4;81,7
2009;3537404;Pereira Barreto;24989;12297;12692;103,2;34,7;25,6
2009;3537503;Pereiras;7305;3708;3597;97;34;32,7
2009;3537602;Peruíbe;58906;28795;30111;104,6;33,7;180,6
2009;3537701;Piacatu;5198;2624;2574;98,1;34,9;22,4
2009;3537800;Piedade;51959;26566;25393;95,6;33,1;69,6
2009;3537909;Pilar do Sul;26182;13316;12866;96,6;32,1;38,4
2009;3538006;Pindamonhangaba;144755;71303;73452;103;32,1;197,9
2009;3538105;Pindorama;14828;7579;7249;95,6;35,8;80,2
2009;3538204;Pinhalzinho;12897;6504;6393;98,3;35,3;83,5
2009;3538303;Piquerobi;3543;1757;1786;101,7;35,6;7,3
2009;3538501;Piquete;14244;6895;7349;106,6;35,1;80,9
2009;3538600;Piracaia;24953;12461;12492;100,2;33,9;64,7
2009;3538709;Piracicaba;360845;176705;184140;104,2;33,9;261,8
2009;3538808;Piraju;28491;13847;14644;105,8;34,9;56,5
2009;3538907;Pirajuí;22439;12368;10071;81,4;34,8;27,2
2009;3539004;Pirangi;10569;5367;5202;96,9;36,2;49
2009;3539103;Pirapora do Bom Jesus;15413;7666;7747;101,1;28,8;142,1
2009;3539202;Pirapozinho;24410;11943;12467;104,4;33,9;51,1
2009;3539301;Pirassununga;69508;34057;35451;104,1;34,9;95,6
2009;3539400;Piratininga;11913;5918;5995;101,3;35,2;29,6
2009;3539509;Pitangueiras;34925;17824;17101;95,9;30,8;81,1
2009;3539608;Planalto;4354;2249;2105;93,6;32,6;15
2009;3539707;Platina;3154;1640;1514;92,3;33,2;9,6
2009;3539806;Poá;104939;50854;54085;106,4;31,1;6078,6
2009;3539905;Poloni;5322;2622;2700;103;36,9;39,4
2009;3540002;Pompéia;19763;9710;10053;103,5;34,7;25,2
2009;3540101;Pongaí;3507;1811;1696;93,6;37,7;19,1
2009;3540200;Pontal;39063;20469;18594;90,8;29,4;109,6
2009;3540259;Pontalinda;4004;2122;1882;88,7;32,8;19,1
2009;3540309;Pontes Gestal;2511;1249;1262;101;35,9;11,5
2009;3540408;Populina;4245;2156;2089;96,9;36,9;13,4
2009;3540507;Porangaba;8155;4202;3953;94,1;35,6;30,7
2009;3540606;Porto Feliz;48550;24364;24186;99,3;33,1;87,2
2009;3540705;Porto Ferreira;51014;25323;25691;101,5;33,9;208,3
2009;3540754;Potim;18745;10476;8269;78,9;29,7;419,9
2009;3540804;Potirendaba;15201;7731;7470;96,6;36;44,4
2009;3540853;Pracinha;2708;1905;803;42,2;32,1;42,9
2009;3540903;Pradópolis;16865;8611;8254;95,9;31,6;100,8
2009;3541000;Praia Grande;254564;122574;131990;107,7;32,9;1701
2009;3541059;Pratânia;4545;2345;2200;93,8;31,1;26
2009;3541109;Presidente Alves;4131;2046;2085;101,9;35;14,4
2009;3541208;Presidente Bernardes;13717;6797;6920;101,8;37;18,3
2009;3541307;Presidente Epitácio;41132;20163;20969;104;33,2;32,6
2009;3541406;Presidente Prudente;205783;99137;106646;107,6;34,8;367,1
2009;3541505;Presidente Venceslau;37910;18925;18985;100,3;35,8;50,2
2009;3541604;Promissão;35177;17538;17639;100,6;33,5;45,1
2009;3541653;Quadra;3165;1673;1492;89,2;34,2;15,4
2009;3541703;Quatá;12636;6310;6326;100,3;32,9;19,4
2009;3541802;Queiroz;2745;1392;1353;97,2;31,5;11,7
2009;3541901;Queluz;11103;5634;5469;97,1;31,9;44,5
2009;3542008;Quintana;5947;2956;2991;101,2;34,5;18,6
2009;3542107;Rafard;8577;4250;4327;101,8;33,4;70,5
2009;3542206;Rancharia;28836;14184;14652;103,3;34,4;18,2
2009;3542305;Redenção da Serra;3891;2039;1852;90,8;34,5;12,6
2009;3542404;Regente Feijó;18343;9124;9219;101;34,6;69,7
2009;3542503;Reginópolis;7054;4389;2665;60,7;32,8;17,2
2009;3542602;Registro;54258;26703;27555;103,2;32,2;75,1
2009;3542701;Restinga;6482;3258;3224;99;30,4;26,4
2009;3542800;Ribeira;3386;1761;1625;92,3;33,9;10,1
2009;3542909;Ribeirão Bonito;12033;6068;5965;98,3;32,5;25,5
2009;3543006;Ribeirão Branco;18713;9641;9072;94,1;29,2;26,8
2009;3543105;Ribeirão Corrente;4221;2184;2037;93,3;31,3;28,5
2009;3543204;Ribeirão do Sul;4453;2243;2210;98,5;35,5;21,9
2009;3543238;Ribeirão dos Índios;2188;1081;1107;102,4;37,2;11,1
2009;3543253;Ribeirão Grande;7437;3803;3634;95,6;32,3;22,3
2009;3543303;Ribeirão Pires;112318;55020;57298;104,1;33,2;1134,8
2009;3543402;Ribeirão Preto;593710;285006;308704;108,3;34,1;912,1
2009;3543501;Riversul;6283;3117;3166;101,6;34,5;16,3
2009;3543600;Rifaina;3446;1728;1718;99,4;35,1;21,2
2009;3543709;Rincão;10433;5258;5175;98,4;32,5;32,9
2009;3543808;Rinópolis;9969;5066;4903;96,8;36,6;27,8
2009;3543907;Rio Claro;184205;89733;94472;105,3;34,6;369,6
2009;3544004;Rio das Pedras;28844;14595;14249;97,6;31,4;127,3
2009;3544103;Rio Grande da Serra;43340;21506;21834;101,5;30,1;1192,6
2009;3544202;Riolândia;10355;5888;4467;75,9;32,3;16,4
2009;3544251;Rosana;20223;10077;10146;100,7;31,9;27,2
2009;3544301;Roseira;9485;4793;4692;97,9;31,9;73
2009;3544400;Rubiácea;2684;1371;1313;95,8;32,7;11,3
2009;3544509;Rubinéia;2832;1400;1432;102,3;38;11,7
2009;3544608;Sabino;5182;2601;2581;99,2;35,8;17
2009;3544707;Sagres;2393;1190;1203;101,1;35,2;16,2
2009;3544806;Sales;5333;2732;2601;95,2;35,4;17,3
2009;3544905;Sales Oliveira;10449;5188;5261;101,4;34,4;34,2
2009;3545001;Salesópolis;15569;7877;7692;97,7;32,6;36,6
2009;3545100;Salmourão;4774;2450;2324;94,9;34,4;27,6
2009;3545159;Saltinho;6915;3452;3463;100,3;35,2;69,3
2009;3545209;Salto;104152;51537;52615;102,1;32,8;782,8
2009;3545308;Salto de Pirapora;39569;19693;19876;100,9;32,5;141,1
2009;3545407;Salto Grande;8764;4355;4409;101,2;34,4;46,5
2009;3545506;Sandovalina;3641;1839;1802;98;31,5;8
2009;3545605;Santa Adélia;14268;7133;7135;100;34,5;43,2
2009;3545704;Santa Albertina;5713;2887;2826;97,9;37,9;21
2009;3545803;Santa Bárbara d'Oeste;178965;88815;90150;101,5;33,5;660,3
2009;3546009;Santa Branca;13683;6850;6833;99,8;33,7;50,3
2009;3546108;Santa Clara d'Oeste;2103;1076;1027;95,4;36,7;11,5
2009;3546207;Santa Cruz da Conceição;3954;1957;1997;102;35,6;26,3
2009;3546256;Santa Cruz da Esperança;1940;963;977;101,5;33,3;13,1
2009;3546306;Santa Cruz das Palmeiras;29467;14974;14493;96,8;32,2;99,8
2009;3546405;Santa Cruz do Rio Pardo;43604;21384;22220;103,9;34,5;39,1
2009;3546504;Santa Ernestina;5586;2881;2705;93,9;31,1;41,6
2009;3546603;Santa Fé do Sul;28944;13960;14984;107,3;36,5;140,1
2009;3546702;Santa Gertrudes;20993;10642;10351;97,3;30,5;213,6
2009;3546801;Santa Isabel;49798;24952;24846;99,6;32,2;137,1
2009;3546900;Santa Lúcia;8179;4111;4068;99;31,2;53,2
2009;3547007;Santa Maria da Serra;5322;2716;2606;95,9;31,7;21,1
2009;3547106;Santa Mercedes;2828;1422;1406;98,9;34,5;17
2009;3547205;Santana da Ponte Pensa;1663;842;821;97,5;40,9;12,8
2009;3547304;Santana de Parnaíba;104860;51794;53066;102,5;30,5;582,7
2009;3547403;Santa Rita d'Oeste;2564;1290;1274;98,8;39,6;12,2
2009;3547502;Santa Rita do Passa Quatro;26440;12804;13636;106,5;37,7;35,1
2009;3547601;Santa Rosa de Viterbo;23592;11661;11931;102,3;34,4;81,8
2009;3547650;Santa Salete;1445;737;708;96,1;39,2;18,2
2009;3547700;Santo Anastácio;20523;10014;10509;104,9;35,8;37,1
2009;3547809;Santo André;673638;323452;350186;108,3;35;3832,2
2009;3547908;Santo Antônio da Alegria;6261;3239;3022;93,3;35,1;20,2
2009;3548005;Santo Antônio de Posse;20352;10261;10091;98,3;32,3;132
2009;3548054;Santo Antônio do Aracanguá;7544;3853;3691;95,8;33,3;5,8
2009;3548104;Santo Antônio do Jardim;5970;3068;2902;94,6;35,1;54,3
2009;3548203;Santo Antônio do Pinhal;6482;3273;3209;98;32,8;48,7
2009;3548302;Santo Expedito;2774;1400;1374;98,1;36,2;29,4
2009;3548401;Santópolis do Aguapeí;4230;2142;2088;97,5;32,3;33
2009;3548500;Santos;419996;192437;227559;118,3;38,4;1494,5
2009;3548609;São Bento do Sapucaí;10467;5267;5200;98,7;35,2;41,4
2009;3548708;São Bernardo do Campo;759065;366927;392138;106,9;32,9;1853,5
2009;3548807;São Caetano do Sul;148223;68488;79735;116,4;39;9668,4
2009;3548906;São Carlos;218884;107532;111352;103,6;34,5;192,5
2009;3549003;São Francisco;2812;1410;1402;99,4;37,3;37,2
2009;3549102;São João da Boa Vista;83074;40343;42731;105,9;35,7;160,9
2009;3549201;São João das Duas Pontes;2577;1302;1275;97,9;35,5;19,9
2009;3549250;São João de Iracema;1769;887;882;99,4;35,3;9,9
2009;3549300;São João do Pau d'Alho;2109;1064;1045;98,2;39;17,9
2009;3549409;São Joaquim da Barra;46014;22564;23450;103,9;33,7;112
2009;3549508;São José da Bela Vista;8386;4294;4092;95,3;30,9;30,3
2009;3549607;São José do Barreiro;4090;2065;2025;98,1;33,3;7,2
2009;3549706;São José do Rio Pardo;51733;25489;26244;103;35,2;123,3
2009;3549805;São José do Rio Preto;402475;193419;209056;108,1;35,4;931,8
2009;3549904;São José dos Campos;619764;303993;315771;103,9;32,3;563,7
2009;3549953;São Lourenço da Serra;13786;6991;6795;97,2;31,6;73,9
2009;3550001;São Luiz do Paraitinga;10441;5355;5086;95;35,1;16,9
2009;3550100;São Manuel;38170;18712;19458;104;33,6;58,7
2009;3550209;São Miguel Arcanjo;31437;15995;15442;96,5;31,6;33,8
2009;3550308;São Paulo;11168194;5292556;5875638;111;33,6;7341,7
2009;3550407;São Pedro;31244;15239;16005;105;35,1;51,1
2009;3550506;São Pedro do Turvo;7181;3659;3522;96,3;33,4;9,8
2009;3550605;São Roque;77572;38203;39369;103,1;33,9;252,8
2009;3550704;São Sebastião;72205;36085;36120;100,1;30,6;179,4
2009;3550803;São Sebastião da Grama;12145;6192;5953;96,1;34;48,1
2009;3550902;São Simão;14292;7047;7245;102,8;34,3;23,2
2009;3551009;São Vicente;329626;158520;171106;107,9;32,7;2224,9
2009;3551108;Sarapuí;8904;4537;4367;96,3;32,5;25,3
2009;3551207;Sarutaiá;3635;1823;1812;99,4;33,7;25,7
2009;3551306;Sebastianópolis do Sul;2985;1508;1477;97,9;36,6;17,8
2009;3551405;Serra Azul;10851;6492;4359;67,1;31,8;38,3
2009;3551504;Serrana;38181;19148;19033;99,4;30,2;302,9
2009;3551603;Serra Negra;26146;12771;13375;104,7;36,7;128,3
2009;3551702;Sertãozinho;108257;53866;54391;101;32,4;268,6
2009;3551801;Sete Barras;13103;6753;6350;94;31,7;12,3
2009;3551900;Severínia;15301;7946;7355;92,6;31,4;108,9
2009;3552007;Silveiras;5768;2926;2842;97,1;33,1;13,9
2009;3552106;Socorro;36270;18016;18254;101,3;36,6;80,8
2009;3552205;Sorocaba;576440;282224;294216;104,2;33;1281,3
2009;3552304;Sud Mennucci;7396;3724;3672;98,6;33,5;12,4
2009;3552403;Sumaré;236329;117543;118786;101,1;31,1;1540
2009;3552502;Suzano;259024;127163;131861;103,7;30,8;1256
2009;3552551;Suzanápolis;3313;1710;1603;93,7;34,7;10
2009;3552601;Tabapuã;11270;5707;5563;97,5;35,9;32,6
2009;3552700;Tabatinga;14534;7475;7059;94,4;33;39,4
2009;3552809;Taboão da Serra;239453;114627;124826;108,9;30,6;11744,9
2009;3552908;Taciba;5663;2841;2822;99,3;33,6;9,3
2009;3553005;Taguaí;10448;5201;5247;100,9;31,5;71,9
2009;3553104;Taiaçu;5869;2961;2908;98,2;34,1;54,8
2009;3553203;Taiúva;5455;2704;2751;101,7;36,5;41,2
2009;3553302;Tambaú;22422;11197;11225;100,3;34,1;39,9
2009;3553401;Tanabi;23895;11948;11947;100;36,4;32
2009;3553500;Tapiraí;8102;4094;4008;97,9;31;10,7
2009;3553609;Tapiratiba;12767;6348;6419;101,1;34,1;57,5
2009;3553658;Taquaral;2734;1380;1354;98,1;34,1;50,7
2009;3553708;Taquaritinga;53907;26693;27214;102;34,3;90,7
2009;3553807;Taquarituba;22244;11075;11169;100,8;33,1;49,6
2009;3553856;Taquarivaí;5088;2553;2535;99,3;28,9;22
2009;3553906;Tarabai;6510;3260;3250;99,7;32,1;32,3
2009;3553955;Tarumã;12636;6451;6185;95,9;31,4;41,7
2009;3554003;Tatuí;105808;52331;53477;102,2;32,7;202
2009;3554102;Taubaté;274927;134971;139956;103,7;33,2;439,9
2009;3554201;Tejupá;4875;2505;2370;94,6;31,2;16,5
2009;3554300;Teodoro Sampaio;21249;10601;10648;100,4;31,5;13,7
2009;3554409;Terra Roxa;8439;4276;4163;97,4;33,6;38,1
2009;3554508;Tietê;36267;17971;18296;101,8;34;89,7
2009;3554607;Timburi;2664;1384;1280;92,5;36;13,5
2009;3554656;Torre de Pedra;2256;1193;1063;89,1;35,7;31,6
2009;3554706;Torrinha;9286;4694;4592;97,8;35,8;29,5
2009;3554755;Trabiju;1528;762;766;100,5;32,5;24,1
2009;3554805;Tremembé;40306;21275;19031;89,5;32,4;210,9
2009;3554904;Três Fronteiras;5387;2695;2692;99,9;37,4;35,5
2009;3554953;Tuiuti;5819;2969;2850;96;36,4;45,9
2009;3555000;Tupã;63539;30788;32751;106,4;36,8;101,2
2009;3555109;Tupi Paulista;14156;7457;6699;89,8;38,6;57,8
2009;3555208;Turiúba;1923;999;924;92,5;38,3;12,5
2009;3555307;Turmalina;2022;1005;1017;101,2;39,5;13,7
2009;3555356;Ubarana;5175;2664;2511;94,3;31;24,7
2009;3555406;Ubatuba;77648;38688;38960;100,7;31,3;109,7
2009;3555505;Ubirajara;4381;2253;2128;94,5;33,9;15,5
2009;3555604;Uchoa;9416;4686;4730;100,9;36,4;37,3
2009;3555703;União Paulista;1577;831;746;89,8;34,1;19,9
2009;3555802;Urânia;8861;4417;4444;100,6;36,9;42,3
2009;3555901;Uru;1257;649;608;93,7;36,7;8,6
2009;3556008;Urupês;12638;6286;6352;101;37,1;39
2009;3556107;Valentim Gentil;10726;5401;5325;98,6;33,9;71,6
2009;3556206;Valinhos;104244;51494;52750;102,4;34,6;701,8
2009;3556305;Valparaíso;22087;12080;10007;82,8;32,6;25,8
2009;3556354;Vargem;8601;4415;4186;94,8;34,5;60,3
2009;3556404;Vargem Grande do Sul;38950;19345;19605;101,3;33,7;145,8
2009;3556453;Vargem Grande Paulista;41879;20819;21060;101,2;30,9;985,6
2009;3556503;Várzea Paulista;105424;52630;52794;100,3;30,7;3001,8
2009;3556602;Vera Cruz;10804;5317;5487;103,2;35,4;43,6
2009;3556701;Vinhedo;61717;30575;31142;101,9;33,8;762,4
2009;3556800;Viradouro;17147;8645;8502;98,3;33,3;78,8
2009;3556909;Vista Alegre do Alto;6641;3410;3231;94,8;32,7;69,6
2009;3556958;Vitória Brasil;1725;888;837;94,3;35,4;34,6
2009;3557006;Votorantim;107522;53413;54109;101,3;31,6;583,8
2009;3557105;Votuporanga;83682;40859;42823;104,8;35,9;198,9
2009;3557154;Zacarias;2291;1156;1135;98,2;35,7;7,2
2009;3557204;Chavantes;12098;6015;6083;101,1;33,5;64,1
2009;3557303;Estiva Gerbi;9911;5018;4893;97,5;32,3;133,7
2010;3500105;Adamantina;33794;16374;17420;106,4;37,7;82
2010;3500204;Adolfo;3558;1788;1770;99;36,6;16,9
2010;3500303;Aguaí;32113;16198;15915;98,3;33;67,7
2010;3500402;Águas da Prata;7580;3746;3834;102,3;38;53,1
2010;3500501;Águas de Lindóia;17257;8453;8804;104,2;35,8;287
2010;3500550;Águas de Santa Bárbara;5598;2778;2820;101,5;35;13,8
2010;3500600;Águas de São Pedro;2699;1258;1441;114,5;41,2;747,2
2010;3500709;Agudos;34506;17068;17438;102,2;33;35,7
2010;3500758;Alambari;4872;2451;2421;98,8;32,2;30,5
2010;3500808;Alfredo Marcondes;3889;1980;1909;96,4;38,7;32,7
2010;3500907;Altair;3813;2050;1763;86;31,9;12,2
2010;3501004;Altinópolis;15606;7808;7798;99,9;35;16,8
2010;3501103;Alto Alegre;4103;2110;1993;94,5;38,3;12,9
2010;3501152;Alumínio;16825;8493;8332;98,1;31;201,2
2010;3501202;Álvares Florence;3900;2001;1899;94,9;39,9;10,8
2010;3501301;Álvares Machado;23506;11638;11868;102;34,3;67,6
2010;3501400;Álvaro de Carvalho;4645;2954;1691;57,2;32,6;30,2
2010;3501509;Alvinlândia;2999;1482;1517;102,4;33,2;35,3
2010;3501608;Americana;210387;103060;107327;104,1;35,3;1571,1
2010;3501707;Américo Brasiliense;34421;17306;17115;98,9;30,8;279,9
2010;3501806;Américo de Campos;5705;2862;2843;99,3;37,2;22,6
2010;3501905;Amparo;65782;32422;33360;102,9;35,7;147,7
2010;3502002;Analândia;4287;2200;2087;94,9;34,3;13,2
2010;3502101;Andradina;55333;27190;28143;103,5;36;57,4
2010;3502200;Angatuba;22184;11233;10951;97,5;33,2;21,6
2010;3502309;Anhembi;5643;2904;2739;94,3;32,6;7,7
2010;3502408;Anhumas;3735;1862;1873;100,6;34,3;11,6
2010;3502507;Aparecida;35006;16900;18106;107,1;34;289,6
2010;3502606;Aparecida d'Oeste;4454;2179;2275;104,4;38,4;24,9
2010;3502705;Apiaí;25207;12586;12621;100,3;31,6;25,9
2010;3502754;Araçariguama;17019;8667;8352;96,4;29,6;117,2
2010;3502804;Araçatuba;181473;87283;94190;107,9;35,9;155,5
2010;3502903;Araçoiaba da Serra;27226;13572;13654;100,6;34;106,6
2010;3503000;Aramina;5149;2588;2561;99;35,4;25,4
2010;3503109;Arandu;6123;3088;3035;98,3;33,2;21,4
2010;3503158;Arapeí;2494;1255;1239;98,7;34,4;15,9
2010;3503208;Araraquara;208429;100549;107880;107,3;35,6;207,7
2010;3503307;Araras;118713;58630;60083;102,5;34,5;184,1
2010;3503356;Arco-Íris;1927;972;955;98,3;37;7,3
2010;3503406;Arealva;7836;3995;3841;96,1;37,5;15,5
2010;3503505;Areias;3695;1831;1864;101,8;32,5;12,1
2010;3503604;Areiópolis;10577;5452;5125;94;30,5;123,1
2010;3503703;Ariranha;8537;4361;4176;95,8;34,4;64,4
2010;3503802;Artur Nogueira;44071;22023;22048;100,1;32,1;247,6
2010;3503901;Arujá;74758;36870;37888;102,8;31,1;777,4
2010;3503950;Aspásia;1809;907;902;99,4;37,5;26,1
2010;3504008;Assis;95075;46283;48792;105,4;35,5;206,4
2010;3504107;Atibaia;126467;62150;64317;103,5;34;264,3
2010;3504206;Auriflama;14196;7100;7096;99,9;36,2;32,7
2010;3504305;Avaí;4956;2505;2451;97,8;33,1;9,2
2010;3504404;Avanhandava;11287;6231;5056;81,1;31,6;33,4
2010;3504503;Avaré;82878;41110;41768;101,6;34;68,3
2010;3504602;Bady Bassitt;14574;7236;7338;101,4;34,3;132
2010;3504701;Balbinos;3670;2965;705;23,8;33,1;40,1
2010;3504800;Bálsamo;8153;3995;4158;104,1;37,3;54,4
2010;3504909;Bananal;10219;5049;5170;102,4;34,3;16,6
2010;3505005;Barão de Antonina;3113;1590;1523;95,8;34,6;20,3
2010;3505104;Barbosa;6586;3320;3266;98,4;33,4;32,1
2010;3505203;Bariri;31563;15801;15762;99,8;35,4;71
2010;3505302;Barra Bonita;35248;17256;17992;104,3;35,9;234,8
2010;3505351;Barra do Chapéu;5241;2769;2472;89,3;31,5;12,9
2010;3505401;Barra do Turvo;7732;4052;3680;90,8;32,1;7,7
2010;3505500;Barretos;112030;54139;57891;106,9;35;71,5
2010;3505609;Barrinha;28457;14303;14154;99;29,8;194,9
2010;3505708;Barueri;240459;116925;123534;105,7;30,5;3659,9
2010;3505807;Bastos;20446;10034;10412;103,8;34,1;119,6
2010;3505906;Batatais;56429;27723;28706;103,5;34,9;66,4
2010;3506003;Bauru;343695;166543;177152;106,4;34,7;514,8
2010;3506102;Bebedouro;75033;36532;38501;105,4;35;109,8
2010;3506201;Bento de Abreu;2672;1363;1309;96;33,7;8,9
2010;3506300;Bernardino de Campos;10775;5251;5524;105,2;36,3;44,1
2010;3506359;Bertioga;47462;23744;23718;99,9;29,8;96,6
2010;3506409;Bilac;7039;3487;3552;101,9;37;44,5
2010;3506508;Birigui;108599;53016;55583;104,8;34,8;204,9
2010;3506607;Biritiba Mirim;28540;14396;14144;98,2;31,9;89,9
2010;3506706;Boa Esperança do Sul;13636;6871;6765;98,5;32;19,7
2010;3506805;Bocaina;10846;5403;5443;100,7;33,9;29,8
2010;3506904;Bofete;9597;4896;4701;96;34,1;14,7
2010;3507001;Boituva;48177;24245;23932;98,7;32,1;193,5
2010;3507100;Bom Jesus dos Perdões;19644;9889;9755;98,6;31,9;181,3
2010;3507159;Bom Sucesso de Itararé;3568;1815;1753;96,6;28,8;26,7
2010;3507209;Borá;805;422;383;90,8;33,5;6,8
2010;3507308;Boracéia;4263;2176;2087;95,9;33,3;34,9
2010;3507407;Borborema;14517;7344;7173;97,7;35,5;26,3
2010;3507456;Borebi;2290;1142;1148;100,5;32,3;6,6
2010;3507506;Botucatu;127156;61681;65475;106,2;34,5;85,8
2010;3507605;Bragança Paulista;146548;71990;74558;103,6;34,3;285,9
2010;3507704;Braúna;5015;2549;2466;96,7;35,8;25,7
2010;3507753;Brejo Alegre;2571;1329;1242;93,5;34;24,3
2010;3507803;Brodowski;21070;10448;10622;101,7;33,8;75,7
2010;3507902;Brotas;21556;10701;10855;101,4;33,8;19,6
2010;3508009;Buri;18555;9499;9056;95,3;30,7;15,5
2010;3508108;Buritama;15404;7725;7679;99,4;35,4;47,1
2010;3508207;Buritizal;4050;2071;1979;95,6;35,5;15,2
2010;3508306;Cabrália Paulista;4367;2221;2146;96,6;32,8;18,2
2010;3508405;Cabreúva;41525;21042;20483;97,3;30,2;159,6
2010;3508504;Caçapava;84676;41959;42717;101,8;33,4;229,5
2010;3508603;Cachoeira Paulista;30066;14738;15328;104;34;104,4
2010;3508702;Caconde;18537;9285;9252;99,6;34,3;39,6
2010;3508801;Cafelândia;16600;8171;8429;103,2;35,4;18
2010;3508900;Caiabu;4072;2091;1981;94,7;35,6;16,1
2010;3509007;Caieiras;86389;42235;44154;104,5;31,3;884,8
2010;3509106;Caiuá;5031;2648;2383;90;35,1;9,1
2010;3509205;Cajamar;63989;31937;32052;100,4;29,9;487
2010;3509254;Cajati;28379;14334;14045;98;30,8;62,4
2010;3509304;Cajobi;9763;5022;4741;94,4;35;55,2
2010;3509403;Cajuru;23348;11689;11659;99,7;33,1;35,4
2010;3509452;Campina do Monte Alegre;5564;2851;2713;95,2;33,1;30,2
2010;3509502;Campinas;1079140;520439;558701;107,4;34,6;1358,1
2010;3509601;Campo Limpo Paulista;73981;36351;37630;103,5;32;931,7
2010;3509700;Campos do Jordão;47758;23381;24377;104,3;31,6;164,7
2010;3509809;Campos Novos Paulista;4536;2337;2199;94,1;34;9,4
2010;3509908;Cananéia;12227;6135;6092;99,3;32,6;9,9
2010;3509957;Canas;4378;2220;2158;97,2;30,6;82,2
2010;3510005;Cândido Mota;29879;14658;15221;103,8;35;50,1
2010;3510104;Cândido Rodrigues;2668;1315;1353;102,9;38,4;37,6
2010;3510153;Canitar;4361;2212;2149;97,2;29,9;75,9
2010;3510203;Capão Bonito;46183;23025;23158;100,6;32,1;28,2
2010;3510302;Capela do Alto;17502;9022;8480;94;31,6;103
2010;3510401;Capivari;48512;24319;24193;99,5;32,5;150,2
2010;3510500;Caraguatatuba;100634;49864;50770;101,8;32,6;207,5
2010;3510609;Carapicuíba;369368;179194;190174;106,1;30,9;10692,1
2010;3510708;Cardoso;11803;5829;5974;102,5;36,6;18,5
2010;3510807;Casa Branca;28294;14990;13304;88,8;35;32,7
2010;3510906;Cássia dos Coqueiros;2636;1348;1288;95,5;35,6;13,8
2010;3511003;Castilho;17975;8961;9014;100,6;33,9;16,9
2010;3511102;Catanduva;112760;54751;58009;106;36,2;388
2010;3511201;Catiguá;7122;3630;3492;96,2;34,4;48
2010;3511300;Cedral;7960;3972;3988;100,4;37,1;40,2
2010;3511409;Cerqueira César;17511;8663;8848;102,1;33,6;34,2
2010;3511508;Cerquilho;39520;19588;19932;101,8;33,7;309,2
2010;3511607;Cesário Lange;15516;8051;7465;92,7;33;81,5
2010;3511706;Charqueada;15067;7676;7391;96,3;32,7;85,7
2010;3511904;Clementina;7049;3653;3396;93;32;41,8
2010;3512001;Colina;17365;8624;8741;101,4;34,4;41,1
2010;3512100;Colômbia;5994;3066;2928;95,5;32,6;8,2
2010;3512209;Conchal;25207;12745;12462;97,8;31,5;137,9
2010;3512308;Conchas;16276;8186;8090;98,8;34,7;34,9
2010;3512407;Cordeirópolis;21048;10584;10464;98,9;33,2;153
2010;3512506;Coroados;5231;2606;2625;100,7;34,4;21,2
2010;3512605;Coronel Macedo;5006;2567;2439;95;34;16,5
2010;3512704;Corumbataí;3873;1974;1899;96,2;33,7;13,9
2010;3512803;Cosmópolis;58689;29341;29348;100;31,8;379,5
2010;3512902;Cosmorama;7215;3653;3562;97,5;38,3;16,3
2010;3513009;Cotia;200647;98217;102430;104,3;31,1;619,3
2010;3513108;Cravinhos;31662;15877;15785;99,4;33,1;101,7
2010;3513207;Cristais Paulista;7579;3870;3709;95,8;33,2;19,7
2010;3513306;Cruzália;2277;1112;1165;104,8;36,6;15,2
2010;3513405;Cruzeiro;77009;37492;39517;105,4;34;251,9
2010;3513504;Cubatão;118629;59188;59441;100,4;31;830,3
2010;3513603;Cunha;21876;11171;10705;95,8;34,2;15,5
2010;3513702;Descalvado;31038;15321;15717;102,6;35,2;41,2
2010;3513801;Diadema;385838;186702;199136;106,7;31;12554,9
2010;3513850;Dirce Reis;1688;875;813;92,9;37,9;19,2
2010;3513900;Divinolândia;11215;5591;5624;100,6;36,5;50,1
2010;3514007;Dobrada;7931;4112;3819;92,9;30,4;53
2010;3514106;Dois Córregos;24741;12407;12334;99,4;33,7;39,1
2010;3514205;Dolcinópolis;2096;1091;1005;92,1;38;26,9
2010;3514304;Dourado;8609;4364;4245;97,3;36,2;41,8
2010;3514403;Dracena;43234;21390;21844;102,1;37,2;88,7
2010;3514502;Duartina;12253;5971;6282;105,2;36,7;46,3
2010;3514601;Dumont;8126;4088;4038;98,8;32,4;73
2010;3514700;Echaporã;6322;3117;3205;102,8;35,1;12,3
2010;3514809;Eldorado;14637;7477;7160;95,8;31,1;8,8
2010;3514908;Elias Fausto;15758;8159;7599;93,1;32;77,9
2010;3514924;Elisiário;3115;1647;1468;89,1;35,3;33,1
2010;3514957;Embaúba;2423;1259;1164;92,5;35,8;29,1
2010;3515004;Embu das Artes;239939;116599;123340;105,8;29,8;3408,3
2010;3515103;Embu-Guaçu;62718;31163;31555;101,3;31,3;403
2010;3515129;Emilianópolis;3019;1517;1502;99;36,5;13,4
2010;3515152;Engenheiro Coelho;15662;8202;7460;91;29,4;142,5
2010;3515186;Espírito Santo do Pinhal;41895;20503;21392;104,3;35,6;107,6
2010;3515194;Espírito Santo do Turvo;4239;2143;2096;97,8;31,1;21,9
2010;3515202;Estrela d'Oeste;8208;4134;4074;98,5;36,5;27,7
2010;3515301;Estrela do Norte;2658;1370;1288;94;33,2;10
2010;3515350;Euclides da Cunha Paulista;9590;4835;4755;98,3;32,1;16,7
2010;3515400;Fartura;15317;7427;7890;106,2;34,9;35,7
2010;3515509;Fernandópolis;64670;31508;33162;105,2;36,8;117,6
2010;3515608;Fernando Prestes;5533;2726;2807;103;38;32,5
2010;3515657;Fernão;1562;794;768;96,7;35,5;15,5
2010;3515707;Ferraz de Vasconcelos;168072;82036;86036;104,9;29,9;5688,2
2010;3515806;Flora Rica;1755;882;873;99;38,6;7,8
2010;3515905;Floreal;3005;1497;1508;100,7;40,3;14,7
2010;3516002;Flórida Paulista;12832;7041;5791;82,2;34,6;24,5
2010;3516101;Florínea;2831;1384;1447;104,6;35,6;12,5
2010;3516200;Franca;318369;155348;163021;104,9;33,2;525,6
2010;3516309;Francisco Morato;154287;76547;77740;101,6;28,9;3148,6
2010;3516408;Franco da Rocha;131389;67357;64032;95,1;30,5;989,6
2010;3516507;Gabriel Monteiro;2708;1375;1333;96,9;38;19,5
2010;3516606;Gália;7018;3510;3508;99,9;36,4;19,7
2010;3516705;Garça;43115;20972;22143;105,6;35,2;77,6
2010;3516804;Gastão Vidigal;4188;2293;1895;82,6;33,7;23,2
2010;3516853;Gavião Peixoto;4416;2283;2133;93,4;32,1;18,1
2010;3516903;General Salgado;10670;5353;5317;99,3;36,4;21,6
2010;3517000;Getulina;10762;5859;4903;83,7;34,4;15,9
2010;3517109;Glicério;4564;2289;2275;99,4;34,5;16,7
2010;3517208;Guaiçara;10657;5360;5297;98,8;32,9;38,5
2010;3517307;Guaimbê;5423;2696;2727;101,1;33,7;24,9
2010;3517406;Guaíra;37380;18510;18870;101,9;34;29,7
2010;3517505;Guapiaçu;17834;9012;8822;97,9;34,7;54,9
2010;3517604;Guapiara;18012;9161;8851;96,6;32,5;44,1
2010;3517703;Guará;19850;9881;9969;100,9;31,9;54,8
2010;3517802;Guaraçaí;8439;4197;4242;101,1;37,1;14,8
2010;3517901;Guaraci;9966;5079;4887;96,2;33,3;15,5
2010;3518008;Guarani d'Oeste;1970;964;1006;104,4;36,8;23
2010;3518107;Guarantã;6403;3218;3185;99;32,5;13,9
2010;3518206;Guararapes;30582;15084;15498;102,7;35,6;32
2010;3518305;Guararema;25808;12981;12827;98,8;32,9;95,3
2010;3518404;Guaratinguetá;112004;53920;58084;107,7;34,7;148,8
2010;3518503;Guareí;14522;8889;5633;63,4;32,6;25,6
2010;3518602;Guariba;35447;17892;17555;98,1;31,3;131,1
2010;3518701;Guarujá;290526;141617;148909;105,1;31,6;2006,5
2010;3518800;Guarulhos;1220653;594446;626207;105,3;31,1;3830,4
2010;3518859;Guatapará;6961;3576;3385;94,7;32,6;16,8
2010;3518909;Guzolândia;4750;2434;2316;95,2;33,8;18,8
2010;3519006;Herculândia;8690;4348;4342;99,9;33,9;23,9
2010;3519055;Holambra;11257;5704;5553;97,4;32,4;171,7
2010;3519071;Hortolândia;192317;97241;95076;97,8;30,9;3081,2
2010;3519105;Iacanga;9997;5155;4842;93,9;34,5;18,3
2010;3519204;Iacri;6422;3250;3172;97,6;35,8;19,9
2010;3519253;Iaras;6337;4164;2173;52,2;32,6;15,8
2010;3519303;Ibaté;30696;15793;14903;94,4;31;105,5
2010;3519402;Ibirá;10883;5407;5476;101,3;35,9;40
2010;3519501;Ibirarema;6716;3390;3326;98,1;34,1;29,4
2010;3519600;Ibitinga;53100;26184;26916;102,8;34,4;77
2010;3519709;Ibiúna;71157;36189;34968;96,6;32,1;67,3
2010;3519808;Icém;7456;3792;3664;96,6;33;20,6
2010;3519907;Iepê;7625;3778;3847;101,8;35,5;12,8
2010;3520004;Igaraçu do Tietê;23356;11651;11705;100,5;32,8;238,9
2010;3520103;Igarapava;27934;13833;14101;101,9;34,2;59,6
2010;3520202;Igaratá;8826;4520;4306;95,3;33,3;30,1
2010;3520301;Iguape;28829;14458;14371;99,4;34,4;14,6
2010;3520400;Ilhabela;28125;14296;13829;96,7;30,8;81,2
2010;3520426;Ilha Comprida;9003;4465;4538;101,6;36,1;45,8
2010;3520442;Ilha Solteira;25055;12196;12859;105,4;36;38,4
2010;3520509;Indaiatuba;201089;99919;101170;101,3;33;645,5
2010;3520608;Indiana;4826;2424;2402;99,1;35,5;37,3
2010;3520707;Indiaporã;3904;1921;1983;103,2;38,4;14
2010;3520806;Inúbia Paulista;3627;1820;1807;99,3;35,4;41,6
2010;3520905;Ipaussu;13653;6888;6765;98,2;33,3;65,2
2010;3521002;Iperó;28198;15154;13044;86,1;30,8;165,6
2010;3521101;Ipeúna;6000;3102;2898;93,4;31,7;31,6
2010;3521150;Ipiguá;4454;2263;2191;96,8;35,6;32,7
2010;3521200;Iporanga;4301;2173;2128;97,9;31,4;3,7
2010;3521309;Ipuã;14127;7200;6927;96,2;31,7;30,3
2010;3521408;Iracemápolis;19987;10025;9962;99,4;33;173,6
2010;3521507;Irapuã;7270;3800;3470;91,3;34,2;28,2
2010;3521606;Irapuru;7786;4525;3261;72,1;36,6;36,3
2010;3521705;Itaberá;17867;9021;8846;98,1;33,1;16,2
2010;3521804;Itaí;23982;12743;11239;88,2;32,6;21,9
2010;3521903;Itajobi;14553;7348;7205;98,1;37,4;29
2010;3522000;Itaju;3240;1702;1538;90,4;34,1;14,1
2010;3522109;Itanhaém;86919;42134;44785;106,3;34;144,5
2010;3522158;Itaoca;3228;1687;1541;91,3;34,4;17,6
2010;3522208;Itapecerica da Serra;152407;76160;76247;100,1;29,9;1011
2010;3522307;Itapetininga;144209;72084;72125;100,1;32,6;80,6
2010;3522406;Itapeva;87711;43224;44487;102,9;31,5;48
2010;3522505;Itapevi;200415;98577;101838;103,3;29;2424,6
2010;3522604;Itapira;68492;33931;34561;101,9;35,8;132,1
2010;3522653;Itapirapuã Paulista;3877;2001;1876;93,8;30,1;9,5
2010;3522703;Itápolis;40031;19858;20173;101,6;35,6;40,2
2010;3522802;Itaporanga;14547;7280;7267;99,8;34,2;28,6
2010;3522901;Itapuí;12157;6143;6014;97,9;33,3;86,8
2010;3523008;Itapura;4352;2255;2097;93;33,6;14,4
2010;3523107;Itaquaquecetuba;321329;158342;162987;102,9;28,9;3889,2
2010;3523206;Itararé;47922;23519;24403;103,8;32,5;47,7
2010;3523305;Itariri;15455;7787;7668;98,5;30,8;56,5
2010;3523404;Itatiba;101283;50057;51226;102,3;33,6;314,3
2010;3523503;Itatinga;18029;9218;8811;95,6;30,7;18,4
2010;3523602;Itirapina;15499;9135;6364;69,7;32,5;27,5
2010;3523701;Itirapuã;5910;3011;2899;96,3;32,6;36,7
2010;3523800;Itobi;7545;3908;3637;93,1;33,9;54,3
2010;3523909;Itu;153980;76142;77838;102,2;32,9;240,3
2010;3524006;Itupeva;44658;22692;21966;96,8;30,8;222,3
2010;3524105;Ituverava;38674;18866;19808;105;35,1;54,9
2010;3524204;Jaborandi;6591;3338;3253;97,5;34;24,1
2010;3524303;Jaboticabal;71625;34779;36846;105,9;35;101,4
2010;3524402;Jacareí;211040;103018;108022;104,9;33,3;454,6
2010;3524501;Jaci;5642;2885;2757;95,6;33,2;38,9
2010;3524600;Jacupiranga;17207;8776;8431;96,1;32,1;24,4
2010;3524709;Jaguariúna;44162;21933;22229;101,3;32,9;312,3
2010;3524808;Jales;47005;22985;24020;104,5;36,9;127,5
2010;3524907;Jambeiro;5336;2762;2574;93,2;33,1;28,9
2010;3525003;Jandira;108195;52996;55199;104,2;29,9;6200,6
2010;3525102;Jardinópolis;37597;18917;18680;98,7;32,8;74,9
2010;3525201;Jarinu;23780;11974;11806;98,6;32,4;114,6
2010;3525300;Jaú;130870;64135;66735;104,1;34,6;190,5
2010;3525409;Jeriquara;3161;1623;1538;94,8;31,7;22,3
2010;3525508;Joanópolis;11756;5922;5834;98,5;35,2;31,4
2010;3525607;João Ramalho;4147;2097;2050;97,8;32,3;10
2010;3525706;José Bonifácio;32727;16333;16394;100,4;34,3;38
2010;3525805;Júlio Mesquita;4428;2178;2250;103,3;33,5;34,5
2010;3525854;Jumirim;2792;1441;1351;93,8;33;49,3
2010;3525904;Jundiaí;369710;179859;189851;105,6;35,2;857,4
2010;3526001;Junqueirópolis;18711;9912;8799;88,8;36,6;32,1
2010;3526100;Juquiá;19256;9746;9510;97,6;32,7;23,7
2010;3526209;Juquitiba;28717;14532;14185;97,6;31,1;55
2010;3526308;Lagoinha;4842;2480;2362;95,2;36,5;19
2010;3526407;Laranjal Paulista;25223;12453;12770;102,5;34,9;65,6
2010;3526506;Lavínia;8740;6138;2602;42,4;34,1;16,3
2010;3526605;Lavrinhas;6585;3318;3267;98,5;30,6;39,4
2010;3526704;Leme;91658;45984;45674;99,3;32,6;227,5
2010;3526803;Lençóis Paulista;61372;30472;30900;101,4;32,9;75,8
2010;3526902;Limeira;275786;135523;140263;103,5;34;474,9
2010;3527009;Lindóia;6699;3320;3379;101,8;34,6;137,4
2010;3527108;Lins;71385;34658;36727;106;35,5;125,2
2010;3527207;Lorena;82498;39842;42656;107,1;33,8;199,2
2010;3527256;Lourdes;2127;1106;1021;92,3;36,8;18,7
2010;3527306;Louveira;36989;18732;18257;97,5;30,6;663,6
2010;3527405;Lucélia;19868;10549;9319;88,3;35,4;63,1
2010;3527504;Lucianópolis;2248;1118;1130;101,1;34,9;11,9
2010;3527603;Luís Antônio;11243;5809;5434;93,5;30;18,8
2010;3527702;Luiziânia;5023;2608;2415;92,6;34,1;30,2
2010;3527801;Lupércio;4352;2121;2231;105,2;33,5;28
2010;3527900;Lutécia;2715;1355;1360;100,4;35;5,7
2010;3528007;Macatuba;16255;8150;8105;99,4;33;72,4
2010;3528106;Macaubal;7661;3879;3782;97,5;37,7;30,9
2010;3528205;Macedônia;3665;1838;1827;99,4;37,5;11,2
2010;3528304;Magda;3202;1652;1550;93,8;38;10,3
2010;3528403;Mairinque;43195;21525;21670;100,7;32,2;205,5
2010;3528502;Mairiporã;80755;40871;39884;97,6;32,4;251,8
2010;3528601;Manduri;8986;4516;4470;99;34,7;39,2
2010;3528700;Marabá Paulista;4801;3036;1765;58,1;33,1;5,2
2010;3528809;Maracaí;13329;6663;6666;100;34,1;25
2010;3528858;Marapoama;2629;1347;1282;95,2;36,1;23,6
2010;3528908;Mariápolis;3915;2021;1894;93,7;35,5;21
2010;3529005;Marília;216576;104655;111921;106,9;35,1;185
2010;3529104;Marinópolis;2114;1064;1050;98,7;35,7;27,2
2010;3529203;Martinópolis;24203;12591;11612;92,2;34,8;19,3
2010;3529302;Matão;76743;38015;38728;101,9;34,2;146,2
2010;3529401;Mauá;416585;203868;212717;104,3;31,4;6725,9
2010;3529500;Mendonça;4632;2353;2279;96,9;36,3;23,7
2010;3529609;Meridiano;3856;1893;1963;103,7;36,6;16,9
2010;3529658;Mesópolis;1886;957;929;97,1;35,9;12,7
2010;3529708;Miguelópolis;20439;10198;10241;100,4;32,6;24,9
2010;3529807;Mineiros do Tietê;12033;5990;6043;100,9;33,7;56,4
2010;3529906;Miracatu;20606;10421;10185;97,7;31,4;20,6
2010;3530003;Mira Estrela;2818;1401;1417;101,1;37,4;13
2010;3530102;Mirandópolis;27470;15044;12426;82,6;36,5;29,9
2010;3530201;Mirante do Paranapanema;17052;8660;8392;96,9;35;13,8
2010;3530300;Mirassol;53744;26380;27364;103,7;35,4;221
2010;3530409;Mirassolândia;4290;2191;2099;95,8;35,6;25,8
2010;3530508;Mococa;66284;33059;33225;100,5;35;77,5
2010;3530607;Mogi das Cruzes;387260;188622;198638;105,3;32,3;543,5
2010;3530706;Mogi Guaçu;137131;68045;69086;101,5;33,9;168,7
2010;3530805;Mogi Mirim;86462;42581;43881;103,1;35;173,7
2010;3530904;Mombuca;3265;1662;1603;96,5;32,4;24,4
2010;3531001;Monções;2131;1100;1031;93,7;38,5;20,4
2010;3531100;Mongaguá;46186;23050;23136;100,4;34,3;323,5
2010;3531209;Monte Alegre do Sul;7145;3578;3567;99,7;36,5;64,8
2010;3531308;Monte Alto;46616;22968;23648;103;36;134,4
2010;3531407;Monte Aprazível;21716;10799;10917;101,1;36,2;43,8
2010;3531506;Monte Azul Paulista;18936;9494;9442;99,5;35;71,9
2010;3531605;Monte Castelo;4063;2011;2052;102;37,8;17,4
2010;3531704;Monteiro Lobato;4116;2147;1969;91,7;34,8;12,4
2010;3531803;Monte Mor;48839;24418;24421;100;31,3;203
2010;3531902;Morro Agudo;29083;14862;14221;95,7;31;21
2010;3532009;Morungaba;11752;5887;5865;99,6;33,1;80,1
2010;3532058;Motuca;4286;2161;2125;98,3;33,1;18,7
2010;3532108;Murutinga do Sul;4184;2096;2088;99,6;38,7;16,7
2010;3532157;Nantes;2703;1355;1348;99,5;31,5;9,4
2010;3532207;Narandiba;4283;2167;2116;97,6;32,2;12
2010;3532306;Natividade da Serra;6680;3488;3192;91,5;36,4;8
2010;3532405;Nazaré Paulista;16396;8445;7951;94,2;34,3;50,3
2010;3532504;Neves Paulista;8773;4364;4409;101;38,6;40,1
2010;3532603;Nhandeara;10720;5279;5441;103,1;38,6;24,6
2010;3532702;Nipoã;4264;2256;2008;89;33,3;31
2010;3532801;Nova Aliança;5881;2917;2964;101,6;36,1;27
2010;3532827;Nova Campina;8504;4340;4164;95,9;28,8;22,1
2010;3532843;Nova Canaã Paulista;2117;1078;1039;96,4;40,2;17
2010;3532868;Nova Castilho;1124;556;568;102,2;35,3;6,1
2010;3532900;Nova Europa;9281;4640;4641;100;32,3;57,9
2010;3533007;Nova Granada;19161;9649;9512;98,6;34,6;36
2010;3533106;Nova Guataporanga;2176;1102;1074;97,5;38;63,7
2010;3533205;Nova Independência;3058;1520;1538;101,2;32,3;11,5
2010;3533254;Novais;4578;2471;2107;85,3;30,6;38,9
2010;3533304;Nova Luzitânia;3435;1816;1619;89,2;33,7;46,5
2010;3533403;Nova Odessa;51158;25304;25854;102,2;33,7;693,3
2010;3533502;Novo Horizonte;36556;18252;18304;100,3;35,2;39,2
2010;3533601;Nuporanga;6813;3408;3405;99,9;34,7;19,6
2010;3533700;Ocauçu;4163;2137;2026;94,8;34,7;13,8
2010;3533809;Óleo;2676;1345;1331;99;37;13,5
2010;3533908;Olímpia;49989;24669;25320;102,6;35,3;62,3
2010;3534005;Onda Verde;3880;1991;1889;94,9;33,4;16
2010;3534104;Oriente;6095;2985;3110;104,2;36;27,9
2010;3534203;Orindiúva;5660;2892;2768;95,7;31,1;22,9
2010;3534302;Orlândia;39748;19481;20267;104;33,8;136,2
2010;3534401;Osasco;666621;320412;346209;108,1;32,5;10263
2010;3534500;Oscar Bressane;2537;1217;1320;108,5;38,6;11,4
2010;3534609;Osvaldo Cruz;30906;15546;15360;98,8;37,3;124,6
2010;3534708;Ourinhos;102955;49947;53008;106,1;34,4;348
2010;3534757;Ouroeste;8385;4180;4205;100,6;34,5;29
2010;3534807;Ouro Verde;7794;3864;3930;101,7;34;29,2
2010;3534906;Pacaembu;13220;7734;5486;70,9;36,6;39
2010;3535002;Palestina;11033;5585;5448;97,5;36,4;15,8
2010;3535101;Palmares Paulista;10910;5846;5064;86,6;29,8;132,8
2010;3535200;Palmeira d'Oeste;9590;4809;4781;99,4;38,2;30,1
2010;3535309;Palmital;21182;10352;10830;104,6;36,5;38,6
2010;3535408;Panorama;14575;7309;7266;99,4;32,5;40,9
2010;3535507;Paraguaçu Paulista;42255;21245;21010;98,9;33,9;42,2
2010;3535606;Paraibuna;17385;8836;8549;96,8;33,5;21,5
2010;3535705;Paraíso;5894;3010;2884;95,8;35,1;38
2010;3535804;Paranapanema;17788;9053;8735;96,5;31,7;17,5
2010;3535903;Paranapuã;3813;1949;1864;95,6;36;27,2
2010;3536000;Parapuã;10846;5536;5310;95,9;36,9;29,6
2010;3536109;Pardinho;5574;2841;2733;96,2;32,6;26,6
2010;3536208;Pariquera-Açu;18439;9136;9303;101,8;32,7;51,3
2010;3536257;Parisi;2031;1044;987;94,5;37,4;24
2010;3536307;Patrocínio Paulista;12986;6589;6397;97,1;33;21,5
2010;3536406;Paulicéia;6330;3285;3045;92,7;32,3;16,9
2010;3536505;Paulínia;81825;40513;41312;102;31,9;589,6
2010;3536570;Paulistânia;1779;919;860;93,6;34,4;6,9
2010;3536604;Paulo de Faria;8588;4298;4290;99,8;34,2;11,6
2010;3536703;Pederneiras;41454;20840;20614;98,9;32,9;57
2010;3536802;Pedra Bela;5779;3029;2750;90,8;35,1;36,4
2010;3536901;Pedranópolis;2559;1315;1244;94,6;38;9,8
2010;3537008;Pedregulho;15694;7982;7712;96,6;32,8;22
2010;3537107;Pedreira;41501;20577;20924;101,7;34,1;381,4
2010;3537156;Pedrinhas Paulista;2939;1463;1476;100,9;35,2;19,3
2010;3537206;Pedro de Toledo;10195;5152;5043;97,9;32,9;15,2
2010;3537305;Penápolis;58477;28552;29925;104,8;35,8;82,2
2010;3537404;Pereira Barreto;24963;12271;12692;103,4;35,1;25,6
2010;3537503;Pereiras;7443;3781;3662;96,9;34,1;33,4
2010;3537602;Peruíbe;59698;29109;30589;105,1;34,1;183
2010;3537701;Piacatu;5281;2659;2622;98,6;35,3;22,7
2010;3537800;Piedade;52126;26576;25550;96,1;33,5;69,8
2010;3537909;Pilar do Sul;26385;13406;12979;96,8;32,6;38,7
2010;3538006;Pindamonhangaba;146807;72204;74603;103,3;32,5;200,7
2010;3538105;Pindorama;15022;7683;7339;95,5;36,1;81,3
2010;3538204;Pinhalzinho;13086;6585;6501;98,7;35,7;84,7
2010;3538303;Piquerobi;3537;1753;1784;101,8;35,9;7,3
2010;3538501;Piquete;14116;6822;7294;106,9;35,5;80,2
2010;3538600;Piracaia;25101;12508;12593;100,7;34,3;65,1
2010;3538709;Piracicaba;364261;178206;186055;104,4;34,3;264,3
2010;3538808;Piraju;28470;13825;14645;105,9;35,3;56,4
2010;3538907;Pirajuí;22681;12553;10128;80,7;35,1;27,5
2010;3539004;Pirangi;10618;5391;5227;97;36,5;49,2
2010;3539103;Pirapora do Bom Jesus;15702;7803;7899;101,2;29,1;144,7
2010;3539202;Pirapozinho;24671;12071;12600;104,4;34,3;51,6
2010;3539301;Pirassununga;70036;34277;35759;104,3;35,3;96,3
2010;3539400;Piratininga;12059;5980;6079;101,7;35,6;30
2010;3539509;Pitangueiras;35270;17991;17279;96;31,1;81,9
2010;3539608;Planalto;4456;2309;2147;93;32,7;15,4
2010;3539707;Platina;3189;1659;1530;92,2;33,7;9,7
2010;3539806;Poá;105924;51254;54670;106,7;31,5;6135,7
2010;3539905;Poloni;5390;2668;2722;102;37;39,9
2010;3540002;Pompéia;19948;9786;10162;103,8;35;25,4
2010;3540101;Pongaí;3483;1794;1689;94,1;38,3;19
2010;3540200;Pontal;40142;21115;19027;90,1;29,6;112,6
2010;3540259;Pontalinda;4069;2157;1912;88,6;33,3;19,4
2010;3540309;Pontes Gestal;2518;1256;1262;100,5;36,2;11,6
2010;3540408;Populina;4225;2140;2085;97,4;37,4;13,4
2010;3540507;Porangaba;8310;4269;4041;94,7;36;31,3
2010;3540606;Porto Feliz;48864;24520;24344;99,3;33,5;87,8
2010;3540705;Porto Ferreira;51366;25486;25880;101,5;34,2;209,7
2010;3540754;Potim;19340;10932;8408;76,9;30;433,2
2010;3540804;Potirendaba;15433;7845;7588;96,7;36,2;45,1
2010;3540853;Pracinha;2842;2062;780;37,8;31,9;45,1
2010;3540903;Pradópolis;17334;8860;8474;95,6;31,9;103,6
2010;3541000;Praia Grande;261391;125625;135766;108,1;33,2;1746,7
2010;3541059;Pratânia;4593;2376;2217;93,3;31,3;26,2
2010;3541109;Presidente Alves;4125;2039;2086;102,3;35,3;14,4
2010;3541208;Presidente Bernardes;13579;6690;6889;103;37,5;18,1
2010;3541307;Presidente Epitácio;41301;20211;21090;104,3;33,6;32,8
2010;3541406;Presidente Prudente;207449;99824;107625;107,8;35,1;370
2010;3541505;Presidente Venceslau;37905;18909;18996;100,5;36,2;50,2
2010;3541604;Promissão;35633;17738;17895;100,9;33,8;45,7
2010;3541653;Quadra;3231;1704;1527;89,6;34,4;15,7
2010;3541703;Quatá;12789;6388;6401;100,2;33,2;19,6
2010;3541802;Queiroz;2802;1421;1381;97,2;31,6;11,9
2010;3541901;Queluz;11289;5745;5544;96,5;32,3;45,3
2010;3542008;Quintana;5999;2967;3032;102,2;34,9;18,8
2010;3542107;Rafard;8610;4256;4354;102,3;33,8;70,8
2010;3542206;Rancharia;28804;14154;14650;103,5;34,8;18,1
2010;3542305;Redenção da Serra;3874;2018;1856;92;34,9;12,5
2010;3542404;Regente Feijó;18481;9182;9299;101,3;35;70,2
2010;3542503;Reginópolis;7297;4655;2642;56,8;32,5;17,8
2010;3542602;Registro;54257;26658;27599;103,5;32,7;75,1
2010;3542701;Restinga;6578;3292;3286;99,8;30,8;26,8
2010;3542800;Ribeira;3359;1744;1615;92,6;34,2;10
2010;3542909;Ribeirão Bonito;12127;6100;6027;98,8;32,8;25,7
2010;3543006;Ribeirão Branco;18292;9409;8883;94,4;29,7;26,2
2010;3543105;Ribeirão Corrente;4270;2217;2053;92,6;31,5;28,8
2010;3543204;Ribeirão do Sul;4446;2231;2215;99,3;36;21,9
2010;3543238;Ribeirão dos Índios;2187;1089;1098;100,8;37,7;11,1
2010;3543253;Ribeirão Grande;7422;3795;3627;95,6;32,8;22,3
2010;3543303;Ribeirão Pires;112994;55286;57708;104,4;33,6;1141,7
2010;3543402;Ribeirão Preto;603774;289743;314031;108,4;34,4;927,6
2010;3543501;Riversul;6171;3052;3119;102,2;34,9;16
2010;3543600;Rifaina;3435;1724;1711;99,2;35,5;21,1
2010;3543709;Rincão;10413;5244;5169;98,6;32,8;32,9
2010;3543808;Rinópolis;9938;5053;4885;96,7;36,9;27,7
2010;3543907;Rio Claro;186095;90613;95482;105,4;34,9;373,4
2010;3544004;Rio das Pedras;29445;14887;14558;97,8;31,7;129,9
2010;3544103;Rio Grande da Serra;43912;21774;22138;101,7;30,5;1208,3
2010;3544202;Riolândia;10556;6010;4546;75,6;32,4;16,7
2010;3544251;Rosana;19725;9799;9926;101,3;32,6;26,5
2010;3544301;Roseira;9590;4838;4752;98,2;32,3;73,9
2010;3544400;Rubiácea;2725;1390;1335;96;33,1;11,5
2010;3544509;Rubinéia;2860;1414;1446;102,3;38,7;11,8
2010;3544608;Sabino;5215;2622;2593;98,9;36,3;17,1
2010;3544707;Sagres;2395;1191;1204;101,1;35,5;16,2
2010;3544806;Sales;5443;2785;2658;95,4;35,8;17,6
2010;3544905;Sales Oliveira;10557;5236;5321;101,6;34,8;34,5
2010;3545001;Salesópolis;15624;7900;7724;97,8;33;36,8
2010;3545100;Salmourão;4814;2475;2339;94,5;34,7;27,8
2010;3545159;Saltinho;7047;3514;3533;100,5;35,5;70,7
2010;3545209;Salto;105407;52083;53324;102,4;33,2;792,2
2010;3545308;Salto de Pirapora;40087;19928;20159;101,2;32,9;143
2010;3545407;Salto Grande;8784;4352;4432;101,8;34,8;46,6
2010;3545506;Sandovalina;3693;1882;1811;96,2;31,9;8,1
2010;3545605;Santa Adélia;14325;7161;7164;100;34,7;43,4
2010;3545704;Santa Albertina;5722;2904;2818;97;38,2;21
2010;3545803;Santa Bárbara d'Oeste;179924;89185;90739;101,7;34;663,9
2010;3546009;Santa Branca;13757;6872;6885;100,2;34,1;50,5
2010;3546108;Santa Clara d'Oeste;2084;1073;1011;94,2;37,1;11,4
2010;3546207;Santa Cruz da Conceição;3998;1978;2020;102,1;36;26,6
2010;3546256;Santa Cruz da Esperança;1952;966;986;102,1;33,8;13,2
2010;3546306;Santa Cruz das Palmeiras;29893;15201;14692;96,7;32,4;101,2
2010;3546405;Santa Cruz do Rio Pardo;43895;21501;22394;104,2;34,9;39,4
2010;3546504;Santa Ernestina;5569;2854;2715;95,1;31,6;41,4
2010;3546603;Santa Fé do Sul;29215;14074;15141;107,6;36,9;141,5
2010;3546702;Santa Gertrudes;21579;10926;10653;97,5;30,7;219,5
2010;3546801;Santa Isabel;50393;25220;25173;99,8;32,6;138,7
2010;3546900;Santa Lúcia;8245;4129;4116;99,7;31,6;53,6
2010;3547007;Santa Maria da Serra;5406;2743;2663;97,1;32;21,4
2010;3547106;Santa Mercedes;2831;1423;1408;98,9;34,8;17
2010;3547205;Santana da Ponte Pensa;1643;842;801;95,1;41,2;12,6
2010;3547304;Santana de Parnaíba;108474;53508;54966;102,7;30,9;602,8
2010;3547403;Santa Rita d'Oeste;2544;1265;1279;101,1;40,2;12,1
2010;3547502;Santa Rita do Passa Quatro;26475;12812;13663;106,6;38,1;35,1
2010;3547601;Santa Rosa de Viterbo;23841;11771;12070;102,5;34,8;82,6
2010;3547650;Santa Salete;1446;743;703;94,6;39,3;18,3
2010;3547700;Santo Anastácio;20477;9983;10494;105,1;36,2;37
2010;3547809;Santo André;676177;324368;351809;108,5;35,4;3846,7
2010;3547908;Santo Antônio da Alegria;6299;3258;3041;93,3;35,5;20,3
2010;3548005;Santo Antônio de Posse;20628;10401;10227;98,3;32,5;133,8
2010;3548054;Santo Antônio do Aracanguá;7620;3877;3743;96,5;33,7;5,8
2010;3548104;Santo Antônio do Jardim;5945;3046;2899;95,2;35,6;54,1
2010;3548203;Santo Antônio do Pinhal;6485;3269;3216;98,4;33,3;48,8
2010;3548302;Santo Expedito;2801;1402;1399;99,8;36,7;29,7
2010;3548401;Santópolis do Aguapeí;4273;2165;2108;97,4;32,8;33,4
2010;3548500;Santos;419388;191923;227465;118,5;38,8;1492,3
2010;3548609;São Bento do Sapucaí;10467;5271;5196;98,6;35,6;41,4
2010;3548708;São Bernardo do Campo;764922;369388;395534;107,1;33,3;1867,8
2010;3548807;São Caetano do Sul;149185;68825;80360;116,8;39,3;9731,1
2010;3548906;São Carlos;221692;108796;112896;103,8;34,8;195
2010;3549003;São Francisco;2794;1400;1394;99,6;37,7;37
2010;3549102;São João da Boa Vista;83585;40525;43060;106,3;36,1;161,9
2010;3549201;São João das Duas Pontes;2567;1291;1276;98,8;35,9;19,8
2010;3549250;São João de Iracema;1779;898;881;98,1;35,8;10
2010;3549300;São João do Pau d'Alho;2104;1057;1047;99,1;39,7;17,9
2010;3549409;São Joaquim da Barra;46469;22772;23697;104,1;34;113,1
2010;3549508;São José da Bela Vista;8403;4310;4093;95;31,2;30,3
2010;3549607;São José do Barreiro;4078;2048;2030;99,1;33,6;7,1
2010;3549706;São José do Rio Pardo;51885;25541;26344;103,1;35,6;123,6
2010;3549805;São José do Rio Preto;407816;195817;211999;108,3;35,7;944,1
2010;3549904;São José dos Campos;629106;308247;320859;104,1;32,7;572,2
2010;3549953;São Lourenço da Serra;13957;7079;6878;97,2;32,1;74,9
2010;3550001;São Luiz do Paraitinga;10397;5319;5078;95,5;35,5;16,8
2010;3550100;São Manuel;38327;18761;19566;104,3;33,9;58,9
2010;3550209;São Miguel Arcanjo;31445;15993;15452;96,6;32,1;33,8
2010;3550308;São Paulo;11245983;5325004;5920979;111,2;33,9;7392,8
2010;3550407;São Pedro;31629;15408;16221;105,3;35,5;51,7
2010;3550506;São Pedro do Turvo;7195;3668;3527;96,2;33,8;9,8
2010;3550605;São Roque;78711;38712;39999;103,3;34,3;256,5
2010;3550704;São Sebastião;73793;36816;36977;100,4;30,9;183,4
2010;3550803;São Sebastião da Grama;12102;6167;5935;96,2;34,3;47,9
2010;3550902;São Simão;14340;7059;7281;103,1;34,7;23,2
2010;3551009;São Vicente;332193;159556;172637;108,2;33;2242,3
2010;3551108;Sarapuí;9016;4589;4427;96,5;32,8;25,6
2010;3551207;Sarutaiá;3623;1820;1803;99,1;34,1;25,6
2010;3551306;Sebastianópolis do Sul;3027;1523;1504;98,8;36,9;18
2010;3551405;Serra Azul;11217;6839;4378;64;32,1;39,6
2010;3551504;Serrana;38821;19458;19363;99,5;30,5;308
2010;3551603;Serra Negra;26365;12856;13509;105,1;37,1;129,4
2010;3551702;Sertãozinho;109936;54637;55299;101,2;32,7;272,7
2010;3551801;Sete Barras;13011;6685;6326;94,6;32,2;12,2
2010;3551900;Severínia;15484;8036;7448;92,7;31,7;110,2
2010;3552007;Silveiras;5788;2935;2853;97,2;33,4;14
2010;3552106;Socorro;36651;18189;18462;101,5;37;81,6
2010;3552205;Sorocaba;585780;286614;299166;104,4;33,4;1302,1
2010;3552304;Sud Mennucci;7434;3742;3692;98,7;33,8;12,5
2010;3552403;Sumaré;240901;119669;121232;101,3;31,4;1569,7
2010;3552502;Suzano;262179;128557;133622;103,9;31,2;1271,3
2010;3552551;Suzanápolis;3378;1745;1633;93,6;34,8;10,2
2010;3552601;Tabapuã;11355;5741;5614;97,8;36,2;32,8
2010;3552700;Tabatinga;14671;7556;7115;94,2;33,3;39,8
2010;3552809;Taboão da Serra;244095;116697;127398;109,2;31;11972,6
2010;3552908;Taciba;5710;2859;2851;99,7;34;9,4
2010;3553005;Taguaí;10795;5369;5426;101,1;31,6;74,3
2010;3553104;Taiaçu;5892;2971;2921;98,3;34,5;55
2010;3553203;Taiúva;5447;2697;2750;102;37;41,1
2010;3553302;Tambaú;22405;11174;11231;100,5;34,5;39,9
2010;3553401;Tanabi;24042;12035;12007;99,8;36,7;32,2
2010;3553500;Tapiraí;8016;4046;3970;98,1;31,4;10,6
2010;3553609;Tapiratiba;12739;6332;6407;101,2;34,6;57,4
2010;3553658;Taquaral;2726;1373;1353;98,5;34,6;50,6
2010;3553708;Taquaritinga;53972;26659;27313;102,5;34,7;90,8
2010;3553807;Taquarituba;22288;11092;11196;100,9;33,5;49,7
2010;3553856;Taquarivaí;5145;2575;2570;99,8;29,3;22,2
2010;3553906;Tarabai;6600;3290;3310;100,6;32,4;32,8
2010;3553955;Tarumã;12865;6573;6292;95,7;31,8;42,5
2010;3554003;Tatuí;107202;52976;54226;102,4;33;204,7
2010;3554102;Taubaté;278379;136606;141773;103,8;33,5;445,4
2010;3554201;Tejupá;4813;2470;2343;94,9;31,7;16,2
2010;3554300;Teodoro Sampaio;21374;10660;10714;100,5;31,9;13,7
2010;3554409;Terra Roxa;8498;4303;4195;97,5;33,9;38,4
2010;3554508;Tietê;36789;18227;18562;101,8;34,3;91
2010;3554607;Timburi;2647;1364;1283;94,1;36,6;13,5
2010;3554656;Torre de Pedra;2253;1187;1066;89,8;36,2;31,6
2010;3554706;Torrinha;9326;4705;4621;98,2;36,2;29,6
2010;3554755;Trabiju;1543;770;773;100,4;33;24,3
2010;3554805;Tremembé;40928;21631;19297;89,2;32,7;214,2
2010;3554904;Três Fronteiras;5425;2717;2708;99,7;37,7;35,8
2010;3554953;Tuiuti;5921;3018;2903;96,2;36,8;46,7
2010;3555000;Tupã;63475;30735;32740;106,5;37,2;101,1
2010;3555109;Tupi Paulista;14261;7571;6690;88,4;39;58,3
2010;3555208;Turiúba;1930;997;933;93,6;38,9;12,6
2010;3555307;Turmalina;1981;984;997;101,3;40,3;13,4
2010;3555356;Ubarana;5279;2710;2569;94,8;31,3;25,2
2010;3555406;Ubatuba;78693;39129;39564;101,1;31,8;111,1
2010;3555505;Ubirajara;4425;2283;2142;93,8;34,3;15,7
2010;3555604;Uchoa;9467;4706;4761;101,2;36,7;37,5
2010;3555703;União Paulista;1597;828;769;92,9;34,3;20,2
2010;3555802;Urânia;8836;4395;4441;101;37,3;42,2
2010;3555901;Uru;1252;642;610;95;37;8,5
2010;3556008;Urupês;12706;6318;6388;101,1;37,4;39,2
2010;3556107;Valentim Gentil;11013;5537;5476;98,9;34,2;73,5
2010;3556206;Valinhos;106569;52570;53999;102,7;34,9;717,5
2010;3556305;Valparaíso;22539;12388;10151;81,9;32,9;26,3
2010;3556354;Vargem;8784;4510;4274;94,8;34,8;61,6
2010;3556404;Vargem Grande do Sul;39240;19476;19764;101,5;34;146,9
2010;3556453;Vargem Grande Paulista;42899;21295;21604;101,5;31,4;1009,6
2010;3556503;Várzea Paulista;106961;53354;53607;100,5;31,1;3045,6
2010;3556602;Vera Cruz;10772;5300;5472;103,2;35,8;43,5
2010;3556701;Vinhedo;63453;31406;32047;102;34,1;783,9
2010;3556800;Viradouro;17285;8708;8577;98,5;33,7;79,4
2010;3556909;Vista Alegre do Alto;6865;3532;3333;94,4;32,8;71,9
2010;3556958;Vitória Brasil;1736;891;845;94,8;36;34,8
2010;3557006;Votorantim;108695;53959;54736;101,4;32;590,1
2010;3557105;Votuporanga;84612;41278;43334;105;36,2;201,1
2010;3557154;Zacarias;2331;1172;1159;98,9;36;7,3
2010;3557204;Chavantes;12115;6028;6087;101;33,9;64,2
2010;3557303;Estiva Gerbi;10033;5070;4963;97,9;32,8;135,3
2011;3500105;Adamantina;33908;16420;17488;106,5;38;82,3
2011;3500204;Adolfo;3614;1817;1797;98,9;36,8;17,1
2011;3500303;Aguaí;32153;16191;15962;98,6;33,3;67,8
2011;3500402;Águas da Prata;7574;3735;3839;102,8;38,3;53,1
2011;3500501;Águas de Lindóia;17354;8491;8863;104,4;36,2;288,6
2011;3500550;Águas de Santa Bárbara;5752;2855;2897;101,5;35,3;14,2
2011;3500600;Águas de São Pedro;2712;1263;1449;114,7;41,5;750,8
2011;3500709;Agudos;34797;17199;17598;102,3;33,3;36
2011;3500758;Alambari;4975;2502;2473;98,8;32,6;31,2
2011;3500808;Alfredo Marcondes;3939;2005;1934;96,5;38,9;33,1
2011;3500907;Altair;3790;2026;1764;87,1;32,3;12,1
2011;3501004;Altinópolis;15711;7853;7858;100,1;35,3;16,9
2011;3501103;Alto Alegre;4088;2093;1995;95,3;38,7;12,8
2011;3501152;Alumínio;16903;8524;8379;98,3;31,4;202,1
2011;3501202;Álvares Florence;3899;2003;1896;94,7;40,2;10,8
2011;3501301;Álvares Machado;23833;11774;12059;102,4;34,5;68,6
2011;3501400;Álvaro de Carvalho;4666;2977;1689;56,7;32,9;30,4
2011;3501509;Alvinlândia;2998;1478;1520;102,8;33,5;35,3
2011;3501608;Americana;212689;104054;108635;104,4;35,6;1588,3
2011;3501707;Américo Brasiliense;34366;17256;17110;99,2;31,1;279,5
2011;3501806;Américo de Campos;5730;2863;2867;100,1;37,6;22,7
2011;3501905;Amparo;66002;32490;33512;103,1;36;148,2
2011;3502002;Analândia;4313;2211;2102;95,1;34,5;13,2
2011;3502101;Andradina;55761;27429;28332;103,3;36,3;57,8
2011;3502200;Angatuba;22340;11302;11038;97,7;33,5;21,7
2011;3502309;Anhembi;5651;2899;2752;94,9;32,9;7,7
2011;3502408;Anhumas;3752;1868;1884;100,9;34,6;11,7
2011;3502507;Aparecida;34837;16811;18026;107,2;34,4;288,2
2011;3502606;Aparecida d'Oeste;4429;2171;2258;104;38,7;24,7
2011;3502705;Apiaí;25215;12594;12621;100,2;32;25,9
2011;3502754;Araçariguama;17399;8851;8548;96,6;29,9;119,8
2011;3502804;Araçatuba;183146;88000;95146;108,1;36,2;156,9
2011;3502903;Araçoiaba da Serra;27698;13808;13890;100,6;34,4;108,5
2011;3503000;Aramina;5187;2601;2586;99,4;35,7;25,6
2011;3503109;Arandu;6180;3120;3060;98,1;33,4;21,6
2011;3503158;Arapeí;2494;1255;1239;98,7;34,8;15,9
2011;3503208;Araraquara;211265;101862;109403;107,4;35,8;210,5
2011;3503307;Araras;119810;59072;60738;102,8;34,8;185,8
2011;3503356;Arco-Íris;1932;975;957;98,2;37,2;7,3
2011;3503406;Arealva;7874;4004;3870;96,7;37,8;15,6
2011;3503505;Areias;3699;1837;1862;101,4;32,9;12,1
2011;3503604;Areiópolis;10573;5439;5134;94,4;30,9;123,1
2011;3503703;Ariranha;8489;4323;4166;96,4;34,8;64
2011;3503802;Artur Nogueira;44722;22322;22400;100,3;32,4;251,2
2011;3503901;Arujá;75794;37340;38454;103;31,5;788,1
2011;3503950;Aspásia;1813;912;901;98,8;37,7;26,1
2011;3504008;Assis;95711;46552;49159;105,6;35,7;207,8
2011;3504107;Atibaia;129189;63407;65782;103,7;34,3;270
2011;3504206;Auriflama;14183;7085;7098;100,2;36,5;32,6
2011;3504305;Avaí;4915;2482;2433;98;33,4;9,1
2011;3504404;Avanhandava;11313;6250;5063;81;31,9;33,4
2011;3504503;Avaré;83711;41520;42191;101,6;34,3;69
2011;3504602;Bady Bassitt;15586;7726;7860;101,7;34,4;141,2
2011;3504701;Balbinos;3686;2986;700;23,4;33,5;40,2
2011;3504800;Bálsamo;8285;4053;4232;104,4;37,5;55,3
2011;3504909;Bananal;10218;5043;5175;102,6;34,7;16,6
2011;3505005;Barão de Antonina;3151;1608;1543;96;34,8;20,6
2011;3505104;Barbosa;6520;3277;3243;99;33,7;31,8
2011;3505203;Bariri;31571;15775;15796;100,1;35,6;71
2011;3505302;Barra Bonita;35271;17240;18031;104,6;36,3;235
2011;3505351;Barra do Chapéu;5247;2766;2481;89,7;31,8;12,9
2011;3505401;Barra do Turvo;7694;4024;3670;91,2;32,6;7,6
2011;3505500;Barretos;112950;54546;58404;107,1;35,2;72,1
2011;3505609;Barrinha;28797;14452;14345;99,3;30,1;197,2
2011;3505708;Barueri;247120;119982;127138;106;30,8;3761,3
2011;3505807;Bastos;20546;10080;10466;103,8;34,4;120,2
2011;3505906;Batatais;56599;27782;28817;103,7;35,2;66,6
2011;3506003;Bauru;346845;168042;178803;106,4;34,9;519,5
2011;3506102;Bebedouro;75213;36600;38613;105,5;35,3;110,1
2011;3506201;Bento de Abreu;2675;1360;1315;96,7;33,9;8,9
2011;3506300;Bernardino de Campos;10854;5323;5531;103,9;36,6;44,5
2011;3506359;Bertioga;48881;24445;24436;100;30,2;99,4
2011;3506409;Bilac;7074;3496;3578;102,3;37,3;44,8
2011;3506508;Birigui;109561;53449;56112;105;35,1;206,7
2011;3506607;Biritiba Mirim;28684;14456;14228;98,4;32,3;90,4
2011;3506706;Boa Esperança do Sul;13618;6847;6771;98,9;32,4;19,7
2011;3506805;Bocaina;10887;5415;5472;101,1;34,2;29,9
2011;3506904;Bofete;9683;4940;4743;96;34,5;14,8
2011;3507001;Boituva;49250;24741;24509;99,1;32,5;197,8
2011;3507100;Bom Jesus dos Perdões;19818;9968;9850;98,8;32,3;182,9
2011;3507159;Bom Sucesso de Itararé;3565;1817;1748;96,2;29;26,7
2011;3507209;Borá;811;424;387;91,3;33,9;6,8
2011;3507308;Boracéia;4303;2198;2105;95,8;33,5;35,2
2011;3507407;Borborema;14514;7327;7187;98,1;35,9;26,3
2011;3507456;Borebi;2329;1159;1170;100,9;32,4;6,7
2011;3507506;Botucatu;128713;62393;66320;106,3;34,8;86,8
2011;3507605;Bragança Paulista;149135;73179;75956;103,8;34,6;290,9
2011;3507704;Braúna;5028;2546;2482;97,5;36;25,8
2011;3507753;Brejo Alegre;2577;1328;1249;94,1;34,3;24,4
2011;3507803;Brodowski;21408;10605;10803;101,9;34;76,9
2011;3507902;Brotas;21766;10784;10982;101,8;34,2;19,8
2011;3508009;Buri;18739;9571;9168;95,8;31;15,7
2011;3508108;Buritama;15578;7790;7788;100;35,8;47,7
2011;3508207;Buritizal;4079;2081;1998;96;35,7;15,3
2011;3508306;Cabrália Paulista;4367;2219;2148;96,8;33,2;18,2
2011;3508405;Cabreúva;41980;21232;20748;97,7;30,5;161,3
2011;3508504;Caçapava;85775;42462;43313;102;33,7;232,5
2011;3508603;Cachoeira Paulista;30232;14801;15431;104,3;34,3;105
2011;3508702;Caconde;18444;9234;9210;99,7;34,7;39,4
2011;3508801;Cafelândia;16644;8178;8466;103,5;35,6;18,1
2011;3508900;Caiabu;4062;2080;1982;95,3;36;16
2011;3509007;Caieiras;87257;42629;44628;104,7;31,6;893,6
2011;3509106;Caiuá;5075;2697;2378;88,2;35,4;9,2
2011;3509205;Cajamar;66306;33049;33257;100,6;30,2;504,7
2011;3509254;Cajati;28442;14363;14079;98;31,1;62,6
2011;3509304;Cajobi;9726;4982;4744;95,2;35,4;55
2011;3509403;Cajuru;23406;11711;11695;99,9;33,5;35,5
2011;3509452;Campina do Monte Alegre;5593;2866;2727;95,2;33,5;30,3
2011;3509502;Campinas;1085001;522819;562182;107,5;34,9;1365,5
2011;3509601;Campo Limpo Paulista;74391;36539;37852;103,6;32,3;936,9
2011;3509700;Campos do Jordão;47765;23383;24382;104,3;32;164,7
2011;3509809;Campos Novos Paulista;4574;2353;2221;94,4;34,2;9,4
2011;3509908;Cananéia;12255;6136;6119;99,7;33;9,9
2011;3509957;Canas;4427;2235;2192;98,1;30,9;83,1
2011;3510005;Cândido Mota;29905;14656;15249;104;35,3;50,2
2011;3510104;Cândido Rodrigues;2693;1330;1363;102,5;38,6;38
2011;3510153;Canitar;4526;2286;2240;98;30,1;78,8
2011;3510203;Capão Bonito;46287;23071;23216;100,6;32,4;28,2
2011;3510302;Capela do Alto;17928;9287;8641;93;31,9;105,5
2011;3510401;Capivari;48661;24352;24309;99,8;32,9;150,7
2011;3510500;Caraguatatuba;103503;51208;52295;102,1;32,9;213,4
2011;3510609;Carapicuíba;371271;180007;191264;106,3;31,2;10747,2
2011;3510708;Cardoso;11796;5821;5975;102,6;37;18,5
2011;3510807;Casa Branca;28349;14989;13360;89,1;35,3;32,8
2011;3510906;Cássia dos Coqueiros;2650;1360;1290;94,9;36;13,8
2011;3511003;Castilho;18192;9060;9132;100,8;34,3;17,1
2011;3511102;Catanduva;113079;54836;58243;106,2;36,5;389,1
2011;3511201;Catiguá;7112;3614;3498;96,8;34,7;47,9
2011;3511300;Cedral;8340;4152;4188;100,9;37,2;42,2
2011;3511409;Cerqueira César;17845;8866;8979;101,3;33,8;34,9
2011;3511508;Cerquilho;39999;19801;20198;102;34;313
2011;3511607;Cesário Lange;15797;8188;7609;92,9;33,2;83
2011;3511706;Charqueada;15122;7689;7433;96,7;33,1;86
2011;3511904;Clementina;7062;3645;3417;93,7;32,3;41,9
2011;3512001;Colina;17476;8656;8820;101,9;34,6;41,4
2011;3512100;Colômbia;6070;3098;2972;95,9;32,9;8,3
2011;3512209;Conchal;25469;12864;12605;98;31,8;139,3
2011;3512308;Conchas;16233;8156;8077;99;35,1;34,8
2011;3512407;Cordeirópolis;21344;10716;10628;99,2;33,4;155,1
2011;3512506;Coroados;5252;2614;2638;100,9;34,7;21,3
2011;3512605;Coronel Macedo;4959;2542;2417;95,1;34,5;16,3
2011;3512704;Corumbataí;3903;1984;1919;96,7;33,9;14
2011;3512803;Cosmópolis;58927;29423;29504;100,3;32,2;381
2011;3512902;Cosmorama;7337;3714;3623;97,5;38,4;16,6
2011;3513009;Cotia;206652;101092;105560;104,4;31,4;637,8
2011;3513108;Cravinhos;31844;15940;15904;99,8;33,4;102,3
2011;3513207;Cristais Paulista;7707;3920;3787;96,6;33,5;20
2011;3513306;Cruzália;2264;1112;1152;103,6;36,9;15,2
2011;3513405;Cruzeiro;77014;37444;39570;105,7;34,3;251,9
2011;3513504;Cubatão;118381;58886;59495;101;31,3;828,5
2011;3513603;Cunha;21917;11194;10723;95,8;34,6;15,6
2011;3513702;Descalvado;31116;15355;15761;102,6;35,5;41,3
2011;3513801;Diadema;387306;187243;200063;106,8;31,4;12602,7
2011;3513850;Dirce Reis;1685;876;809;92,4;38,1;19,1
2011;3513900;Divinolândia;11223;5594;5629;100,6;36,9;50,2
2011;3514007;Dobrada;8021;4141;3880;93,7;30,7;53,6
2011;3514106;Dois Córregos;24781;12408;12373;99,7;34,1;39,2
2011;3514205;Dolcinópolis;2105;1096;1009;92,1;38,2;27
2011;3514304;Dourado;8572;4338;4234;97,6;36,6;41,6
2011;3514403;Dracena;43474;21501;21973;102,2;37,5;89,1
2011;3514502;Duartina;12276;5984;6292;105,1;37;46,4
2011;3514601;Dumont;8226;4135;4091;98,9;32,6;73,9
2011;3514700;Echaporã;6335;3124;3211;102,8;35,4;12,3
2011;3514809;Eldorado;14531;7413;7118;96;31,5;8,8
2011;3514908;Elias Fausto;15928;8229;7699;93,6;32,3;78,7
2011;3514924;Elisiário;3115;1643;1472;89,6;35,5;33,1
2011;3514957;Embaúba;2428;1259;1169;92,9;36,1;29,2
2011;3515004;Embu das Artes;241445;117274;124171;105,9;30,2;3429,7
2011;3515103;Embu-Guaçu;63160;31369;31791;101,3;31,7;405,8
2011;3515129;Emilianópolis;3028;1518;1510;99,5;36,8;13,4
2011;3515152;Engenheiro Coelho;15984;8340;7644;91,7;29,7;145,4
2011;3515186;Espírito Santo do Pinhal;41775;20425;21350;104,5;35,9;107,3
2011;3515194;Espírito Santo do Turvo;4236;2138;2098;98,1;31,3;21,9
2011;3515202;Estrela d'Oeste;8312;4187;4125;98,5;36,7;28,1
2011;3515301;Estrela do Norte;2664;1369;1295;94,6;33,6;10,1
2011;3515350;Euclides da Cunha Paulista;9476;4773;4703;98,5;32,6;16,5
2011;3515400;Fartura;15444;7489;7955;106,2;35,3;36
2011;3515509;Fernandópolis;65235;31744;33491;105,5;37,1;118,7
2011;3515608;Fernando Prestes;5559;2739;2820;103;38,2;32,7
2011;3515657;Fernão;1576;807;769;95,3;35,6;15,7
2011;3515707;Ferraz de Vasconcelos;169263;82567;86696;105;30,2;5728,5
2011;3515806;Flora Rica;1729;873;856;98,1;39,1;7,7
2011;3515905;Floreal;2987;1486;1501;101;40,6;14,6
2011;3516002;Flórida Paulista;12872;7070;5802;82,1;34,9;24,6
2011;3516101;Florínea;2926;1464;1462;99,9;35,9;13
2011;3516200;Franca;321349;156714;164635;105,1;33,6;530,6
2011;3516309;Francisco Morato;155214;76935;78279;101,7;29,2;3167,6
2011;3516408;Franco da Rocha;132609;67870;64739;95,4;30,9;998,8
2011;3516507;Gabriel Monteiro;2711;1375;1336;97,2;38,2;19,5
2011;3516606;Gália;6981;3491;3490;100;36,7;19,6
2011;3516705;Garça;43118;20958;22160;105,7;35,6;77,6
2011;3516804;Gastão Vidigal;4134;2234;1900;85;34,2;22,9
2011;3516853;Gavião Peixoto;4443;2287;2156;94,3;32,3;18,2
2011;3516903;General Salgado;10660;5343;5317;99,5;36,8;21,6
2011;3517000;Getulina;10732;5841;4891;83,7;34,8;15,9
2011;3517109;Glicério;4538;2270;2268;99,9;34,9;16,6
2011;3517208;Guaiçara;10733;5391;5342;99,1;33,2;38,7
2011;3517307;Guaimbê;5429;2702;2727;100,9;34;24,9
2011;3517406;Guaíra;37608;18597;19011;102,2;34,4;29,9
2011;3517505;Guapiaçu;18155;9154;9001;98,3;34,9;55,8
2011;3517604;Guapiara;17971;9137;8834;96,7;32,9;44
2011;3517703;Guará;19775;9825;9950;101,3;32,3;54,6
2011;3517802;Guaraçaí;8389;4176;4213;100,9;37,6;14,7
2011;3517901;Guaraci;10033;5103;4930;96,6;33,7;15,6
2011;3518008;Guarani d'Oeste;1971;970;1001;103,2;37,1;23
2011;3518107;Guarantã;6413;3216;3197;99,4;32,8;13,9
2011;3518206;Guararapes;30671;15114;15557;102,9;35,9;32,1
2011;3518305;Guararema;26274;13197;13077;99,1;33,3;97
2011;3518404;Guaratinguetá;112603;54185;58418;107,8;35;149,6
2011;3518503;Guareí;14584;8921;5663;63,5;33;25,7
2011;3518602;Guariba;35711;17959;17752;98,8;31,7;132,1
2011;3518701;Guarujá;290711;141551;149160;105,4;31,9;2007,8
2011;3518800;Guarulhos;1227831;597367;630464;105,5;31,4;3852,9
2011;3518859;Guatapará;6993;3586;3407;95;32,9;16,9
2011;3518909;Guzolândia;4720;2418;2302;95,2;34,2;18,7
2011;3519006;Herculândia;8737;4362;4375;100,3;34,2;24
2011;3519055;Holambra;11565;5855;5710;97,5;32,7;176,4
2011;3519071;Hortolândia;196017;98982;97035;98;31,2;3140,5
2011;3519105;Iacanga;10040;5161;4879;94,5;34,8;18,3
2011;3519204;Iacri;6411;3242;3169;97,7;36,2;19,9
2011;3519253;Iaras;6485;4273;2212;51,8;33;16,2
2011;3519303;Ibaté;30842;15829;15013;94,8;31,4;106
2011;3519402;Ibirá;10955;5434;5521;101,6;36,2;40,3
2011;3519501;Ibirarema;6699;3375;3324;98,5;34,4;29,4
2011;3519600;Ibitinga;53689;26461;27228;102,9;34,6;77,9
2011;3519709;Ibiúna;71590;36374;35216;96,8;32,5;67,7
2011;3519808;Icém;7499;3842;3657;95,2;33,3;20,7
2011;3519907;Iepê;7637;3776;3861;102,3;35,8;12,8
2011;3520004;Igaraçu do Tietê;23377;11659;11718;100,5;33,2;239,2
2011;3520103;Igarapava;27855;13761;14094;102,4;34,5;59,5
2011;3520202;Igaratá;8997;4599;4398;95,6;33,6;30,7
2011;3520301;Iguape;28893;14489;14404;99,4;34,8;14,6
2011;3520400;Ilhabela;28705;14558;14147;97,2;31,2;82,9
2011;3520426;Ilha Comprida;9386;4656;4730;101,6;36,5;47,7
2011;3520442;Ilha Solteira;25157;12244;12913;105,5;36,3;38,5
2011;3520509;Indaiatuba;205528;101988;103540;101,5;33,4;659,7
2011;3520608;Indiana;4853;2438;2415;99,1;35,8;37,5
2011;3520707;Indiaporã;3932;1933;1999;103,4;38,7;14,1
2011;3520806;Inúbia Paulista;3637;1817;1820;100,2;35,7;41,7
2011;3520905;Ipaussu;13673;6878;6795;98,8;33,6;65,2
2011;3521002;Iperó;28908;15532;13376;86,1;31,1;169,8
2011;3521101;Ipeúna;6068;3127;2941;94,1;32,1;31,9
2011;3521150;Ipiguá;4631;2346;2285;97,4;35,8;34
2011;3521200;Iporanga;4285;2165;2120;97,9;31,7;3,7
2011;3521309;Ipuã;14181;7212;6969;96,6;32;30,4
2011;3521408;Iracemápolis;20179;10117;10062;99,5;33,3;175,3
2011;3521507;Irapuã;7239;3768;3471;92,1;34,5;28,1
2011;3521606;Irapuru;7742;4499;3243;72,1;36,9;36,1
2011;3521705;Itaberá;17878;9026;8852;98,1;33,5;16,2
2011;3521804;Itaí;24105;12783;11322;88,6;32,9;22,1
2011;3521903;Itajobi;14779;7454;7325;98,3;37,6;29,4
2011;3522000;Itaju;3265;1708;1557;91,2;34,3;14,2
2011;3522109;Itanhaém;89195;43211;45984;106,4;34,4;148,2
2011;3522158;Itaoca;3238;1690;1548;91,6;34,7;17,7
2011;3522208;Itapecerica da Serra;153125;76397;76728;100,4;30,3;1015,8
2011;3522307;Itapetininga;145490;72717;72773;100,1;32,9;81,3
2011;3522406;Itapeva;87930;43322;44608;103;31,9;48,1
2011;3522505;Itapevi;203093;99825;103268;103,4;29,3;2457
2011;3522604;Itapira;68840;34075;34765;102;36,1;132,8
2011;3522653;Itapirapuã Paulista;3908;2019;1889;93,6;30,4;9,6
2011;3522703;Itápolis;40070;19855;20215;101,8;35,9;40,2
2011;3522802;Itaporanga;14540;7265;7275;100,1;34,5;28,6
2011;3522901;Itapuí;12310;6213;6097;98,1;33,5;87,9
2011;3523008;Itapura;4335;2238;2097;93,7;34;14,4
2011;3523107;Itaquaquecetuba;325360;160228;165132;103,1;29,3;3938
2011;3523206;Itararé;47712;23399;24313;103,9;32,9;47,5
2011;3523305;Itariri;15492;7798;7694;98,7;31,2;56,6
2011;3523404;Itatiba;103074;50908;52166;102,5;34;319,8
2011;3523503;Itatinga;18176;9323;8853;95;31;18,6
2011;3523602;Itirapina;15573;9179;6394;69,7;32,8;27,6
2011;3523701;Itirapuã;5900;3004;2896;96,4;32,9;36,6
2011;3523800;Itobi;7576;3920;3656;93,3;34,2;54,5
2011;3523909;Itu;155353;76749;78604;102,4;33,2;242,5
2011;3524006;Itupeva;46812;23760;23052;97;31;233
2011;3524105;Ituverava;38644;18839;19805;105,1;35,4;54,8
2011;3524204;Jaborandi;6584;3326;3258;98;34,4;24,1
2011;3524303;Jaboticabal;71722;34770;36952;106,3;35,3;101,5
2011;3524402;Jacareí;213748;104239;109509;105,1;33,6;460,4
2011;3524501;Jaci;5794;2958;2836;95,9;33,3;39,9
2011;3524600;Jacupiranga;17136;8720;8416;96,5;32,5;24,3
2011;3524709;Jaguariúna;45399;22503;22896;101,7;33,2;321,1
2011;3524808;Jales;47227;23074;24153;104,7;37,2;128,1
2011;3524907;Jambeiro;5420;2795;2625;93,9;33,5;29,4
2011;3525003;Jandira;109084;53393;55691;104,3;30,2;6251,6
2011;3525102;Jardinópolis;38231;19284;18947;98,3;33,1;76,2
2011;3525201;Jarinu;24907;12538;12369;98,7;32,7;120
2011;3525300;Jaú;131254;64249;67005;104,3;35;191
2011;3525409;Jeriquara;3223;1658;1565;94,4;31,9;22,7
2011;3525508;Joanópolis;11845;5968;5877;98,5;35,5;31,6
2011;3525607;João Ramalho;4171;2105;2066;98,1;32,5;10
2011;3525706;José Bonifácio;33053;16479;16574;100,6;34,5;38,4
2011;3525805;Júlio Mesquita;4424;2173;2251;103,6;33,8;34,5
2011;3525854;Jumirim;2810;1445;1365;94,5;33,2;49,6
2011;3525904;Jundiaí;375847;182715;193132;105,7;35,5;871,6
2011;3526001;Junqueirópolis;18875;9983;8892;89,1;36,8;32,4
2011;3526100;Juquiá;19104;9669;9435;97,6;33,1;23,5
2011;3526209;Juquitiba;28631;14487;14144;97,6;31,5;54,8
2011;3526308;Lagoinha;4872;2491;2381;95,6;36,9;19,1
2011;3526407;Laranjal Paulista;25319;12487;12832;102,8;35,1;65,9
2011;3526506;Lavínia;8829;6247;2582;41,3;34,4;16,4
2011;3526605;Lavrinhas;6659;3348;3311;98,9;30,9;39,9
2011;3526704;Leme;92396;46268;46128;99,7;32,9;229,3
2011;3526803;Lençóis Paulista;61851;30687;31164;101,6;33,3;76,4
2011;3526902;Limeira;277346;136201;141145;103,6;34,3;477,6
2011;3527009;Lindóia;6732;3332;3400;102;34,9;138,1
2011;3527108;Lins;71726;34791;36935;106,2;35,7;125,8
2011;3527207;Lorena;82733;39924;42809;107,2;34,1;199,8
2011;3527256;Lourdes;2116;1102;1014;92;37;18,6
2011;3527306;Louveira;38152;19290;18862;97,8;30,9;684,5
2011;3527405;Lucélia;19927;10616;9311;87,7;35,8;63,3
2011;3527504;Lucianópolis;2255;1127;1128;100,1;35,2;11,9
2011;3527603;Luís Antônio;11341;5843;5498;94,1;30,4;19
2011;3527702;Luiziânia;4996;2580;2416;93,6;34,3;30
2011;3527801;Lupércio;4335;2114;2221;105,1;33,8;27,9
2011;3527900;Lutécia;2723;1357;1366;100,7;35,3;5,7
2011;3528007;Macatuba;16341;8184;8157;99,7;33,3;72,8
2011;3528106;Macaubal;7625;3851;3774;98;38;30,7
2011;3528205;Macedônia;3701;1853;1848;99,7;37,8;11,3
2011;3528304;Magda;3213;1651;1562;94,6;38,3;10,3
2011;3528403;Mairinque;43810;21853;21957;100,5;32,5;208,5
2011;3528502;Mairiporã;82014;41449;40565;97,9;32,7;255,7
2011;3528601;Manduri;9069;4550;4519;99,3;35;39,6
2011;3528700;Marabá Paulista;4797;3031;1766;58,3;33,4;5,2
2011;3528809;Maracaí;13297;6639;6658;100,3;34,4;24,9
2011;3528858;Marapoama;2690;1376;1314;95,5;36,3;24,2
2011;3528908;Mariápolis;3891;2002;1889;94,4;35,8;20,9
2011;3529005;Marília;218474;105493;112981;107,1;35,3;186,6
2011;3529104;Marinópolis;2102;1057;1045;98,9;36,1;27
2011;3529203;Martinópolis;24292;12625;11667;92,4;35,1;19,4
2011;3529302;Matão;77005;38122;38883;102;34,6;146,7
2011;3529401;Mauá;417348;204024;213324;104,6;31,8;6738,2
2011;3529500;Mendonça;4747;2405;2342;97,4;36,4;24,3
2011;3529609;Meridiano;3918;1922;1996;103,9;36,8;17,2
2011;3529658;Mesópolis;1893;963;930;96,6;36;12,7
2011;3529708;Miguelópolis;20411;10168;10243;100,7;32,9;24,9
2011;3529807;Mineiros do Tietê;12001;5971;6030;101;34,1;56,3
2011;3529906;Miracatu;20477;10347;10130;97,9;31,8;20,4
2011;3530003;Mira Estrela;2842;1413;1429;101,1;37,7;13,1
2011;3530102;Mirandópolis;27560;15138;12422;82,1;36,8;30
2011;3530201;Mirante do Paranapanema;17002;8619;8383;97,3;35,3;13,7
2011;3530300;Mirassol;54521;26730;27791;104;35,6;224,2
2011;3530409;Mirassolândia;4324;2207;2117;95,9;35,8;26
2011;3530508;Mococa;66500;33113;33387;100,8;35,4;77,8
2011;3530607;Mogi das Cruzes;392765;191115;201650;105,5;32,6;551,2
2011;3530706;Mogi Guaçu;138643;68700;69943;101,8;34,2;170,6
2011;3530805;Mogi Mirim;87099;42848;44251;103,3;35,3;175
2011;3530904;Mombuca;3298;1676;1622;96,8;32,6;24,7
2011;3531001;Monções;2119;1090;1029;94,4;38,8;20,3
2011;3531100;Mongaguá;47568;23781;23787;100;34,7;333,2
2011;3531209;Monte Alegre do Sul;7295;3647;3648;100;36,8;66,1
2011;3531308;Monte Alto;46790;23040;23750;103,1;36,3;134,9
2011;3531407;Monte Aprazível;21793;10823;10970;101,4;36,5;44
2011;3531506;Monte Azul Paulista;18897;9478;9419;99,4;35,4;71,7
2011;3531605;Monte Castelo;4073;2021;2052;101,5;37,9;17,4
2011;3531704;Monteiro Lobato;4131;2144;1987;92,7;35,1;12,4
2011;3531803;Monte Mor;50137;25035;25102;100,3;31,6;208,4
2011;3531902;Morro Agudo;29097;14815;14282;96,4;31,4;21
2011;3532009;Morungaba;11913;5958;5955;99,9;33,4;81,2
2011;3532058;Motuca;4262;2153;2109;98;33,5;18,6
2011;3532108;Murutinga do Sul;4148;2074;2074;100;39;16,5
2011;3532157;Nantes;2713;1355;1358;100,2;31,8;9,5
2011;3532207;Narandiba;4403;2224;2179;98;32,4;12,3
2011;3532306;Natividade da Serra;6705;3502;3203;91,5;36,7;8
2011;3532405;Nazaré Paulista;16584;8534;8050;94,3;34,6;50,8
2011;3532504;Neves Paulista;8850;4399;4451;101,2;38,9;40,4
2011;3532603;Nhandeara;10659;5236;5423;103,6;38,9;24,4
2011;3532702;Nipoã;4296;2265;2031;89,7;33,5;31,2
2011;3532801;Nova Aliança;5937;2937;3000;102,1;36,3;27,3
2011;3532827;Nova Campina;8511;4334;4177;96,4;29,2;22,1
2011;3532843;Nova Canaã Paulista;2114;1080;1034;95,7;40,6;17
2011;3532868;Nova Castilho;1120;558;562;100,7;35,4;6,1
2011;3532900;Nova Europa;9288;4646;4642;99,9;32,7;58
2011;3533007;Nova Granada;19196;9657;9539;98,8;34,9;36,1
2011;3533106;Nova Guataporanga;2168;1094;1074;98,2;38,2;63,5
2011;3533205;Nova Independência;3192;1595;1597;100,1;32,4;12
2011;3533254;Novais;4587;2461;2126;86,4;30,9;38,9
2011;3533304;Nova Luzitânia;3396;1787;1609;90;34,1;46
2011;3533403;Nova Odessa;52063;25732;26331;102,3;34;705,6
2011;3533502;Novo Horizonte;36735;18319;18416;100,5;35,5;39,4
2011;3533601;Nuporanga;6861;3425;3436;100,3;35;19,7
2011;3533700;Ocauçu;4175;2145;2030;94,6;34,9;13,9
2011;3533809;Óleo;2665;1348;1317;97,7;37,2;13,4
2011;3533908;Olímpia;50465;24870;25595;102,9;35,5;62,9
2011;3534005;Onda Verde;3949;2027;1922;94,8;33,6;16,3
2011;3534104;Oriente;6105;2983;3122;104,7;36,4;27,9
2011;3534203;Orindiúva;5699;2905;2794;96,2;31,4;23
2011;3534302;Orlândia;39714;19442;20272;104,3;34,2;136,1
2011;3534401;Osasco;672990;323231;349759;108,2;32,8;10361
2011;3534500;Oscar Bressane;2545;1219;1326;108,8;38,9;11,5
2011;3534609;Osvaldo Cruz;30939;15545;15394;99;37,6;124,7
2011;3534708;Ourinhos;103259;50015;53244;106,5;34,7;349,1
2011;3534757;Ouroeste;8555;4262;4293;100,7;34,8;29,6
2011;3534807;Ouro Verde;7812;3864;3948;102,2;34,2;29,3
2011;3534906;Pacaembu;13385;7921;5464;69;36,9;39,4
2011;3535002;Palestina;11067;5594;5473;97,8;36,6;15,9
2011;3535101;Palmares Paulista;10824;5765;5059;87,8;30,2;131,8
2011;3535200;Palmeira d'Oeste;9547;4792;4755;99,2;38,6;30
2011;3535309;Palmital;21117;10316;10801;104,7;36,8;38,5
2011;3535408;Panorama;14623;7319;7304;99,8;32,8;41,1
2011;3535507;Paraguaçu Paulista;42207;21214;20993;99;34,3;42,1
2011;3535606;Paraibuna;17445;8861;8584;96,9;33,9;21,5
2011;3535705;Paraíso;5920;3019;2901;96,1;35,4;38,1
2011;3535804;Paranapanema;17949;9138;8811;96,4;32;17,6
2011;3535903;Paranapuã;3827;1954;1873;95,9;36,1;27,3
2011;3536000;Parapuã;10818;5506;5312;96,5;37,2;29,5
2011;3536109;Pardinho;5717;2910;2807;96,5;32,9;27,2
2011;3536208;Pariquera-Açu;18520;9171;9349;101,9;33,1;51,5
2011;3536257;Parisi;2095;1075;1020;94,9;37,5;24,7
2011;3536307;Patrocínio Paulista;13127;6656;6471;97,2;33,2;21,8
2011;3536406;Paulicéia;6465;3344;3121;93,3;32,6;17,3
2011;3536505;Paulínia;84190;41617;42573;102,3;32,2;606,7
2011;3536570;Paulistânia;1802;929;873;94;34,6;7
2011;3536604;Paulo de Faria;8510;4263;4247;99,6;34,7;11,5
2011;3536703;Pederneiras;41770;20980;20790;99,1;33,2;57,4
2011;3536802;Pedra Bela;5863;3070;2793;91;35,5;37
2011;3536901;Pedranópolis;2579;1329;1250;94,1;38,3;9,9
2011;3537008;Pedregulho;15703;7977;7726;96,9;33,2;22
2011;3537107;Pedreira;41700;20656;21044;101,9;34,4;383,2
2011;3537156;Pedrinhas Paulista;2926;1453;1473;101,4;35,6;19,2
2011;3537206;Pedro de Toledo;10308;5214;5094;97,7;33,3;15,4
2011;3537305;Penápolis;58809;28677;30132;105,1;36,1;82,7
2011;3537404;Pereira Barreto;24956;12251;12705;103,7;35,5;25,6
2011;3537503;Pereiras;7555;3824;3731;97,6;34,4;33,9
2011;3537602;Peruíbe;60557;29502;31055;105,3;34,5;185,6
2011;3537701;Piacatu;5305;2666;2639;99;35,6;22,8
2011;3537800;Piedade;52212;26584;25628;96,4;33,9;69,9
2011;3537909;Pilar do Sul;26523;13475;13048;96,8;32,9;38,9
2011;3538006;Pindamonhangaba;148470;72929;75541;103,6;32,8;203
2011;3538105;Pindorama;15004;7659;7345;95,9;36,4;81,2
2011;3538204;Pinhalzinho;13265;6670;6595;98,9;36;85,8
2011;3538303;Piquerobi;3515;1739;1776;102,1;36,2;7,3
2011;3538501;Piquete;14020;6778;7242;106,8;35,9;79,7
2011;3538600;Piracaia;25203;12535;12668;101,1;34,7;65,4
2011;3538709;Piracicaba;369188;180453;188735;104,6;34,6;267,9
2011;3538808;Piraju;28572;13864;14708;106,1;35,6;56,6
2011;3538907;Pirajuí;22687;12498;10189;81,5;35,4;27,5
2011;3539004;Pirangi;10658;5403;5255;97,3;36,8;49,4
2011;3539103;Pirapora do Bom Jesus;15885;7894;7991;101,2;29,4;146,4
2011;3539202;Pirapozinho;24764;12109;12655;104,5;34,6;51,8
2011;3539301;Pirassununga;70434;34430;36004;104,6;35,6;96,9
2011;3539400;Piratininga;12296;6086;6210;102;35,8;30,6
2011;3539509;Pitangueiras;35246;17941;17305;96,5;31,4;81,8
2011;3539608;Planalto;4465;2306;2159;93,6;33;15,4
2011;3539707;Platina;3189;1653;1536;92,9;34;9,7
2011;3539806;Poá;105998;51261;54737;106,8;31,9;6139,9
2011;3539905;Poloni;5416;2672;2744;102,7;37,2;40,1
2011;3540002;Pompéia;19991;9808;10183;103,8;35,3;25,5
2011;3540101;Pongaí;3470;1787;1683;94,2;38,5;18,9
2011;3540200;Pontal;40036;20990;19046;90,7;30;112,3
2011;3540259;Pontalinda;4077;2164;1913;88,4;33,5;19,5
2011;3540309;Pontes Gestal;2521;1257;1264;100,6;36,5;11,6
2011;3540408;Populina;4225;2135;2090;97,9;37,7;13,4
2011;3540507;Porangaba;8503;4366;4137;94,8;36,4;32
2011;3540606;Porto Feliz;49500;24871;24629;99;33,8;88,9
2011;3540705;Porto Ferreira;51550;25537;26013;101,9;34,5;210,5
2011;3540754;Potim;19460;11003;8457;76,9;30,3;435,9
2011;3540804;Potirendaba;15679;7951;7728;97,2;36,3;45,8
2011;3540853;Pracinha;2824;2053;771;37,6;32,2;44,8
2011;3540903;Pradópolis;17356;8843;8513;96,3;32,3;103,7
2011;3541000;Praia Grande;269012;129156;139856;108,3;33,6;1797,6
2011;3541059;Pratânia;4633;2388;2245;94;31,5;26,5
2011;3541109;Presidente Alves;4106;2030;2076;102,3;35,6;14,3
2011;3541208;Presidente Bernardes;13682;6817;6865;100,7;37,8;18,3
2011;3541307;Presidente Epitácio;41241;20168;21073;104,5;34;32,7
2011;3541406;Presidente Prudente;209118;100586;108532;107,9;35,4;373
2011;3541505;Presidente Venceslau;37752;18782;18970;101;36,6;50
2011;3541604;Promissão;35684;17745;17939;101,1;34,1;45,8
2011;3541653;Quadra;3251;1709;1542;90,2;34,7;15,8
2011;3541703;Quatá;12825;6401;6424;100,4;33,5;19,7
2011;3541802;Queiroz;2836;1437;1399;97,4;31,8;12,1
2011;3541901;Queluz;11123;5653;5470;96,8;32,6;44,6
2011;3542008;Quintana;6087;3006;3081;102,5;35;19,1
2011;3542107;Rafard;8642;4271;4371;102,3;34,1;71
2011;3542206;Rancharia;28806;14136;14670;103,8;35,1;18,1
2011;3542305;Redenção da Serra;3934;2051;1883;91,8;35,3;12,7
2011;3542404;Regente Feijó;18635;9252;9383;101,4;35,3;70,8
2011;3542503;Reginópolis;7338;4676;2662;56,9;32,9;17,9
2011;3542602;Registro;54799;26948;27851;103,4;33;75,9
2011;3542701;Restinga;6558;3278;3280;100,1;31,1;26,7
2011;3542800;Ribeira;3351;1734;1617;93,3;34,5;10
2011;3542909;Ribeirão Bonito;12067;6058;6009;99,2;33,2;25,6
2011;3543006;Ribeirão Branco;18334;9422;8912;94,6;30;26,3
2011;3543105;Ribeirão Corrente;4297;2226;2071;93;31,8;29
2011;3543204;Ribeirão do Sul;4451;2235;2216;99,1;36,3;21,9
2011;3543238;Ribeirão dos Índios;2181;1084;1097;101,2;38;11,1
2011;3543253;Ribeirão Grande;7442;3810;3632;95,3;33,2;22,3
2011;3543303;Ribeirão Pires;113408;55433;57975;104,6;34;1145,9
2011;3543402;Ribeirão Preto;612275;293617;318658;108,5;34,7;940,6
2011;3543501;Riversul;6139;3045;3094;101,6;35,2;15,9
2011;3543600;Rifaina;3477;1745;1732;99,3;35,8;21,4
2011;3543709;Rincão;10332;5199;5133;98,7;33,2;32,6
2011;3543808;Rinópolis;9901;5027;4874;97;37,2;27,6
2011;3543907;Rio Claro;187490;91216;96274;105,5;35,2;376,2
2011;3544004;Rio das Pedras;29599;14946;14653;98;32;130,6
2011;3544103;Rio Grande da Serra;44000;21798;22202;101,9;30,9;1210,8
2011;3544202;Riolândia;10533;6039;4494;74,4;32,7;16,7
2011;3544251;Rosana;19581;9729;9852;101,3;33,1;26,3
2011;3544301;Roseira;9711;4894;4817;98,4;32,6;74,8
2011;3544400;Rubiácea;2721;1387;1334;96,2;33,4;11,5
2011;3544509;Rubinéia;2947;1456;1491;102,4;39;12,1
2011;3544608;Sabino;5227;2621;2606;99,4;36,7;17,1
2011;3544707;Sagres;2399;1193;1206;101,1;35,7;16,2
2011;3544806;Sales;5543;2826;2717;96,1;36,2;18
2011;3544905;Sales Oliveira;10628;5253;5375;102,3;35,1;34,8
2011;3545001;Salesópolis;15629;7887;7742;98,2;33,3;36,8
2011;3545100;Salmourão;4815;2475;2340;94,5;35;27,8
2011;3545159;Saltinho;7138;3549;3589;101,1;35,8;71,6
2011;3545209;Salto;107727;53191;54536;102,5;33,5;809,6
2011;3545308;Salto de Pirapora;40434;20100;20334;101,2;33,2;144,2
2011;3545407;Salto Grande;8819;4361;4458;102,2;35,1;46,8
2011;3545506;Sandovalina;3697;1878;1819;96,9;32,2;8,1
2011;3545605;Santa Adélia;14308;7142;7166;100,3;35;43,3
2011;3545704;Santa Albertina;5775;2931;2844;97;38,3;21,2
2011;3545803;Santa Bárbara d'Oeste;180385;89352;91033;101,9;34,3;665,6
2011;3546009;Santa Branca;13816;6897;6919;100,3;34,5;50,7
2011;3546108;Santa Clara d'Oeste;2127;1098;1029;93,7;37,2;11,6
2011;3546207;Santa Cruz da Conceição;4035;1996;2039;102,2;36,5;26,9
2011;3546256;Santa Cruz da Esperança;1972;977;995;101,8;34,1;13,3
2011;3546306;Santa Cruz das Palmeiras;29876;15163;14713;97;32,8;101,2
2011;3546405;Santa Cruz do Rio Pardo;44151;21613;22538;104,3;35,1;39,6
2011;3546504;Santa Ernestina;5631;2882;2749;95,4;32;41,9
2011;3546603;Santa Fé do Sul;29675;14296;15379;107,6;37,1;143,7
2011;3546702;Santa Gertrudes;21772;11023;10749;97,5;31;221,5
2011;3546801;Santa Isabel;50721;25358;25363;100;32,9;139,6
2011;3546900;Santa Lúcia;8197;4098;4099;100;32;53,3
2011;3547007;Santa Maria da Serra;5387;2734;2653;97;32,3;21,3
2011;3547106;Santa Mercedes;2849;1429;1420;99,4;35,1;17,1
2011;3547205;Santana da Ponte Pensa;1642;842;800;95;41,5;12,6
2011;3547304;Santana de Parnaíba;112124;55241;56883;103;31,3;623,1
2011;3547403;Santa Rita d'Oeste;2563;1276;1287;100,9;40,4;12,2
2011;3547502;Santa Rita do Passa Quatro;26380;12754;13626;106,8;38,5;35
2011;3547601;Santa Rosa de Viterbo;23849;11754;12095;102,9;35,1;82,6
2011;3547650;Santa Salete;1457;745;712;95,6;39,5;18,4
2011;3547700;Santo Anastácio;20310;9893;10417;105,3;36,5;36,7
2011;3547809;Santo André;683156;327426;355730;108,6;35,7;3886,4
2011;3547908;Santo Antônio da Alegria;6343;3274;3069;93,7;35,7;20,4
2011;3548005;Santo Antônio de Posse;20865;10513;10352;98,5;32,8;135,4
2011;3548054;Santo Antônio do Aracanguá;7702;3909;3793;97;34,1;5,9
2011;3548104;Santo Antônio do Jardim;5961;3051;2910;95,4;35,8;54,2
2011;3548203;Santo Antônio do Pinhal;6547;3303;3244;98,2;33,7;49,2
2011;3548302;Santo Expedito;2809;1402;1407;100,4;37;29,7
2011;3548401;Santópolis do Aguapeí;4245;2141;2104;98,3;33;33,2
2011;3548500;Santos;419894;191996;227898;118,7;39,1;1494,1
2011;3548609;São Bento do Sapucaí;10565;5313;5252;98,9;35,9;41,8
2011;3548708;São Bernardo do Campo;770073;371469;398604;107,3;33,6;1880,4
2011;3548807;São Caetano do Sul;150708;69460;81248;117;39,5;9830,5
2011;3548906;São Carlos;224478;110088;114390;103,9;35,1;197,4
2011;3549003;São Francisco;2785;1393;1392;99,9;38,1;36,8
2011;3549102;São João da Boa Vista;84364;40871;43493;106,4;36,4;163,4
2011;3549201;São João das Duas Pontes;2572;1296;1276;98,5;36,3;19,9
2011;3549250;São João de Iracema;1783;901;882;97,9;36;10
2011;3549300;São João do Pau d'Alho;2112;1059;1053;99,4;40;17,9
2011;3549409;São Joaquim da Barra;46724;22875;23849;104,3;34,3;113,7
2011;3549508;São José da Bela Vista;8345;4272;4073;95,3;31,6;30,1
2011;3549607;São José do Barreiro;4066;2042;2024;99,1;34;7,1
2011;3549706;São José do Rio Pardo;51985;25547;26438;103,5;35,9;123,9
2011;3549805;São José do Rio Preto;414135;198759;215376;108,4;35,9;958,8
2011;3549904;São José dos Campos;635596;311020;324576;104,4;33,1;578,1
2011;3549953;São Lourenço da Serra;14141;7170;6971;97,2;32,4;75,8
2011;3550001;São Luiz do Paraitinga;10420;5325;5095;95,7;36;16,9
2011;3550100;São Manuel;38287;18741;19546;104,3;34,2;58,8
2011;3550209;São Miguel Arcanjo;31581;16051;15530;96,8;32,5;33,9
2011;3550308;São Paulo;11281788;5340103;5941685;111,3;34,2;7416,4
2011;3550407;São Pedro;32197;15683;16514;105,3;35,9;52,7
2011;3550506;São Pedro do Turvo;7192;3668;3524;96,1;34;9,8
2011;3550605;São Roque;78840;38759;40081;103,4;34,6;256,9
2011;3550704;São Sebastião;74520;37125;37395;100,7;31,2;185,2
2011;3550803;São Sebastião da Grama;12001;6109;5892;96,4;34,7;47,5
2011;3550902;São Simão;14311;7043;7268;103,2;35,1;23,2
2011;3551009;São Vicente;332572;159788;172784;108,1;33,3;2244,8
2011;3551108;Sarapuí;9135;4645;4490;96,7;33,1;25,9
2011;3551207;Sarutaiá;3639;1826;1813;99,3;34,4;25,7
2011;3551306;Sebastianópolis do Sul;3037;1524;1513;99,3;37,1;18,1
2011;3551405;Serra Azul;11362;6963;4399;63,2;32,5;40,1
2011;3551504;Serrana;39287;19658;19629;99,9;30,8;311,7
2011;3551603;Serra Negra;26686;13002;13684;105,2;37,4;131
2011;3551702;Sertãozinho;111488;55295;56193;101,6;33;276,6
2011;3551801;Sete Barras;13001;6677;6324;94,7;32,5;12,2
2011;3551900;Severínia;15420;7999;7421;92,8;32,1;109,8
2011;3552007;Silveiras;5822;2947;2875;97,6;33,7;14
2011;3552106;Socorro;36964;18327;18637;101,7;37,3;82,3
2011;3552205;Sorocaba;597367;291992;305375;104,6;33,7;1327,9
2011;3552304;Sud Mennucci;7428;3732;3696;99;34,2;12,5
2011;3552403;Sumaré;244268;121189;123079;101,6;31,7;1591,7
2011;3552502;Suzano;266200;130389;135811;104,2;31,5;1290,8
2011;3552551;Suzanápolis;3381;1749;1632;93,3;35,1;10,2
2011;3552601;Tabapuã;11349;5719;5630;98,4;36,5;32,8
2011;3552700;Tabatinga;14686;7537;7149;94,9;33,6;39,8
2011;3552809;Taboão da Serra;247058;118057;129001;109,3;31,4;12118
2011;3552908;Taciba;5762;2877;2885;100,3;34,2;9,5
2011;3553005;Taguaí;10954;5446;5508;101,1;31,9;75,4
2011;3553104;Taiaçu;5875;2963;2912;98,3;34,8;54,9
2011;3553203;Taiúva;5544;2775;2769;99,8;37,2;41,9
2011;3553302;Tambaú;22356;11133;11223;100,8;34,8;39,8
2011;3553401;Tanabi;24191;12088;12103;100,1;36,9;32,4
2011;3553500;Tapiraí;8030;4054;3976;98,1;31,8;10,6
2011;3553609;Tapiratiba;12675;6290;6385;101,5;35;57,1
2011;3553658;Taquaral;2735;1377;1358;98,6;34,9;50,7
2011;3553708;Taquaritinga;53890;26580;27310;102,7;35;90,7
2011;3553807;Taquarituba;22530;11246;11284;100,3;33,8;50,2
2011;3553856;Taquarivaí;5285;2648;2637;99,6;29,6;22,8
2011;3553906;Tarabai;6615;3290;3325;101,1;32,7;32,8
2011;3553955;Tarumã;13051;6655;6396;96,1;32,1;43,1
2011;3554003;Tatuí;108761;53691;55070;102,6;33,3;207,7
2011;3554102;Taubaté;281346;137860;143486;104,1;33,9;450,2
2011;3554201;Tejupá;4769;2448;2321;94,8;32,1;16,1
2011;3554300;Teodoro Sampaio;21439;10684;10755;100,7;32,2;13,8
2011;3554409;Terra Roxa;8457;4275;4182;97,8;34,2;38,2
2011;3554508;Tietê;36900;18273;18627;101,9;34,6;91,2
2011;3554607;Timburi;2642;1358;1284;94,6;36,9;13,4
2011;3554656;Torre de Pedra;2235;1176;1059;90,1;36,5;31,3
2011;3554706;Torrinha;9323;4696;4627;98,5;36,5;29,6
2011;3554755;Trabiju;1558;781;777;99,5;33,1;24,6
2011;3554805;Tremembé;41811;22124;19687;89;33;218,8
2011;3554904;Três Fronteiras;5553;2780;2773;99,7;37,8;36,6
2011;3554953;Tuiuti;5997;3049;2948;96,7;37,1;47,3
2011;3555000;Tupã;63532;30727;32805;106,8;37,5;101,2
2011;3555109;Tupi Paulista;14390;7615;6775;89;39,2;58,8
2011;3555208;Turiúba;1927;998;929;93,1;39,1;12,6
2011;3555307;Turmalina;1956;970;986;101,6;40,8;13,2
2011;3555356;Ubarana;5299;2716;2583;95,1;31,6;25,3
2011;3555406;Ubatuba;79836;39678;40158;101,2;32,2;112,7
2011;3555505;Ubirajara;4489;2314;2175;94;34,4;15,9
2011;3555604;Uchoa;9559;4746;4813;101,4;37;37,9
2011;3555703;União Paulista;1605;832;773;92,9;34,3;20,3
2011;3555802;Urânia;8840;4391;4449;101,3;37,6;42,2
2011;3555901;Uru;1268;649;619;95,4;37,2;8,6
2011;3556008;Urupês;12807;6359;6448;101,4;37,7;39,5
2011;3556107;Valentim Gentil;11266;5659;5607;99,1;34,4;75,2
2011;3556206;Valinhos;108287;53369;54918;102,9;35,3;729
2011;3556305;Valparaíso;22685;12480;10205;81,8;33,2;26,4
2011;3556354;Vargem;8910;4576;4334;94,7;35;62,5
2011;3556404;Vargem Grande do Sul;39320;19501;19819;101,6;34,4;147,2
2011;3556453;Vargem Grande Paulista;43574;21603;21971;101,7;31,8;1025,5
2011;3556503;Várzea Paulista;107948;53826;54122;100,5;31,4;3073,7
2011;3556602;Vera Cruz;10727;5278;5449;103,2;36,2;43,3
2011;3556701;Vinhedo;64604;31937;32667;102,3;34,4;798,1
2011;3556800;Viradouro;17335;8718;8617;98,8;34;79,6
2011;3556909;Vista Alegre do Alto;6960;3576;3384;94,6;33;72,9
2011;3556958;Vitória Brasil;1746;895;851;95,1;36,2;35
2011;3557006;Votorantim;110383;54723;55660;101,7;32,3;599,3
2011;3557105;Votuporanga;85621;41728;43893;105,2;36,5;203,5
2011;3557154;Zacarias;2363;1190;1173;98,6;36,2;7,4
2011;3557204;Chavantes;12151;6035;6116;101,3;34,2;64,4
2011;3557303;Estiva Gerbi;10156;5123;5033;98,2;33,1;137
2012;3500105;Adamantina;34001;16454;17547;106,6;38,2;82,5
2012;3500204;Adolfo;3677;1840;1837;99,8;37;17,4
2012;3500303;Aguaí;32176;16176;16000;98,9;33,6;67,8
2012;3500402;Águas da Prata;7563;3723;3840;103,1;38,7;53
2012;3500501;Águas de Lindóia;17460;8537;8923;104,5;36,6;290,4
2012;3500550;Águas de Santa Bárbara;5904;2929;2975;101,6;35,7;14,6
2012;3500600;Águas de São Pedro;2713;1263;1450;114,8;41,9;751,1
2012;3500709;Agudos;35100;17340;17760;102,4;33,6;36,3
2012;3500758;Alambari;5082;2556;2526;98,8;32,9;31,8
2012;3500808;Alfredo Marcondes;3996;2023;1973;97,5;39,1;33,6
2012;3500907;Altair;3772;2008;1764;87,8;32,7;12,1
2012;3501004;Altinópolis;15813;7896;7917;100,3;35,6;17
2012;3501103;Alto Alegre;4079;2088;1991;95,4;39,1;12,8
2012;3501152;Alumínio;16967;8543;8424;98,6;31,8;202,9
2012;3501202;Álvares Florence;3909;2002;1907;95,3;40,5;10,8
2012;3501301;Álvares Machado;24184;11930;12254;102,7;34,8;69,6
2012;3501400;Álvaro de Carvalho;4684;3003;1681;56;33,3;30,5
2012;3501509;Alvinlândia;2987;1473;1514;102,8;33,8;35,2
2012;3501608;Americana;215058;105088;109970;104,6;35,9;1606
2012;3501707;Américo Brasiliense;34320;17210;17110;99,4;31,5;279,1
2012;3501806;Américo de Campos;5757;2871;2886;100,5;37,8;22,8
2012;3501905;Amparo;66256;32576;33680;103,4;36,3;148,8
2012;3502002;Analândia;4332;2217;2115;95,4;34,8;13,3
2012;3502101;Andradina;56213;27681;28532;103,1;36,6;58,3
2012;3502200;Angatuba;22514;11381;11133;97,8;33,8;21,9
2012;3502309;Anhembi;5672;2910;2762;94,9;33,2;7,7
2012;3502408;Anhumas;3782;1876;1906;101,6;35;11,8
2012;3502507;Aparecida;34650;16717;17933;107,3;34,7;286,6
2012;3502606;Aparecida d'Oeste;4392;2154;2238;103,9;39,1;24,5
2012;3502705;Apiaí;25219;12603;12616;100,1;32,4;25,9
2012;3502754;Araçariguama;17772;9032;8740;96,8;30,3;122,4
2012;3502804;Araçatuba;184925;88769;96156;108,3;36,4;158,4
2012;3502903;Araçoiaba da Serra;28140;14025;14115;100,6;34,9;110,2
2012;3503000;Aramina;5213;2607;2606;100;36;25,7
2012;3503109;Arandu;6247;3148;3099;98,4;33,7;21,8
2012;3503158;Arapeí;2488;1249;1239;99,2;35,2;15,9
2012;3503208;Araraquara;214153;103204;110949;107,5;36,1;213,4
2012;3503307;Araras;120924;59528;61396;103,1;35,1;187,5
2012;3503356;Arco-Íris;1944;984;960;97,6;37,3;7,3
2012;3503406;Arealva;7901;4009;3892;97,1;38,1;15,6
2012;3503505;Areias;3699;1842;1857;100,8;33,4;12,1
2012;3503604;Areiópolis;10552;5421;5131;94,7;31,2;122,8
2012;3503703;Ariranha;8442;4287;4155;96,9;35,3;63,7
2012;3503802;Artur Nogueira;45393;22634;22759;100,6;32,7;255
2012;3503901;Arujá;76832;37808;39024;103,2;31,8;798,9
2012;3503950;Aspásia;1816;916;900;98,3;37,9;26,2
2012;3504008;Assis;96319;46806;49513;105,8;36;209,1
2012;3504107;Atibaia;131910;64665;67245;104;34,7;275,7
2012;3504206;Auriflama;14165;7069;7096;100,4;36,8;32,6
2012;3504305;Avaí;4873;2453;2420;98,7;33,8;9
2012;3504404;Avanhandava;11326;6256;5070;81;32,3;33,5
2012;3504503;Avaré;84594;41956;42638;101,6;34,5;69,7
2012;3504602;Bady Bassitt;16620;8231;8389;101,9;34,5;150,6
2012;3504701;Balbinos;3703;3000;703;23,4;33,9;40,4
2012;3504800;Bálsamo;8415;4116;4299;104,4;37,7;56,1
2012;3504909;Bananal;10210;5032;5178;102,9;35;16,6
2012;3505005;Barão de Antonina;3182;1614;1568;97,1;35,1;20,8
2012;3505104;Barbosa;6447;3234;3213;99,4;34,1;31,4
2012;3505203;Bariri;31610;15765;15845;100,5;35,9;71,1
2012;3505302;Barra Bonita;35289;17224;18065;104,9;36,7;235,1
2012;3505351;Barra do Chapéu;5247;2759;2488;90,2;32,2;12,9
2012;3505401;Barra do Turvo;7637;3987;3650;91,5;33;7,6
2012;3505500;Barretos;113880;54962;58918;107,2;35,5;72,7
2012;3505609;Barrinha;29143;14604;14539;99,6;30,4;199,6
2012;3505708;Barueri;253796;123045;130751;106,3;31,2;3862,9
2012;3505807;Bastos;20646;10124;10522;103,9;34,8;120,8
2012;3505906;Batatais;56795;27854;28941;103,9;35,5;66,9
2012;3506003;Bauru;350127;169613;180514;106,4;35,2;524,4
2012;3506102;Bebedouro;75437;36695;38742;105,6;35,6;110,4
2012;3506201;Bento de Abreu;2680;1362;1318;96,8;34,3;8,9
2012;3506300;Bernardino de Campos;10918;5388;5530;102,6;36,8;44,7
2012;3506359;Bertioga;50298;25155;25143;100;30,5;102,3
2012;3506409;Bilac;7106;3508;3598;102,6;37,6;45
2012;3506508;Birigui;110577;53906;56671;105,1;35,4;208,6
2012;3506607;Biritiba Mirim;28830;14516;14314;98,6;32,7;90,8
2012;3506706;Boa Esperança do Sul;13604;6829;6775;99,2;32,7;19,7
2012;3506805;Bocaina;10933;5429;5504;101,4;34,5;30
2012;3506904;Bofete;9765;4979;4786;96,1;35;14,9
2012;3507001;Boituva;50316;25239;25077;99,4;32,8;202,1
2012;3507100;Bom Jesus dos Perdões;20006;10047;9959;99,1;32,6;184,6
2012;3507159;Bom Sucesso de Itararé;3554;1812;1742;96,1;29,3;26,6
2012;3507209;Borá;823;431;392;91;34,2;6,9
2012;3507308;Boracéia;4346;2214;2132;96,3;33,7;35,6
2012;3507407;Borborema;14510;7310;7200;98,5;36,3;26,3
2012;3507456;Borebi;2363;1169;1194;102,1;32,6;6,8
2012;3507506;Botucatu;130315;63129;67186;106,4;35;87,9
2012;3507605;Bragança Paulista;151714;74368;77346;104;34,9;296
2012;3507704;Braúna;5054;2557;2497;97,7;36,2;25,9
2012;3507753;Brejo Alegre;2585;1333;1252;93,9;34,8;24,5
2012;3507803;Brodowski;21764;10771;10993;102,1;34,3;78,2
2012;3507902;Brotas;21973;10869;11104;102,2;34,5;20
2012;3508009;Buri;18912;9643;9269;96,1;31,2;15,8
2012;3508108;Buritama;15776;7870;7906;100,5;36,1;48,3
2012;3508207;Buritizal;4108;2083;2025;97,2;36,1;15,4
2012;3508306;Cabrália Paulista;4369;2225;2144;96,4;33,5;18,2
2012;3508405;Cabreúva;42467;21437;21030;98,1;30,9;163,2
2012;3508504;Caçapava;86856;42954;43902;102,2;34;235,4
2012;3508603;Cachoeira Paulista;30397;14868;15529;104,4;34,7;105,5
2012;3508702;Caconde;18329;9170;9159;99,9;35,1;39,1
2012;3508801;Cafelândia;16681;8181;8500;103,9;35,9;18,1
2012;3508900;Caiabu;4047;2067;1980;95,8;36,4;16
2012;3509007;Caieiras;88093;43012;45081;104,8;32;902,2
2012;3509106;Caiuá;5113;2748;2365;86,1;35,7;9,3
2012;3509205;Cajamar;68676;34186;34490;100,9;30,5;522,7
2012;3509254;Cajati;28527;14401;14126;98,1;31,5;62,8
2012;3509304;Cajobi;9695;4953;4742;95,7;35,7;54,8
2012;3509403;Cajuru;23462;11732;11730;100;33,8;35,5
2012;3509452;Campina do Monte Alegre;5628;2874;2754;95,8;33,8;30,5
2012;3509502;Campinas;1090876;525232;565644;107,7;35,2;1372,9
2012;3509601;Campo Limpo Paulista;74876;36769;38107;103,6;32,7;943
2012;3509700;Campos do Jordão;47749;23376;24373;104,3;32,4;164,7
2012;3509809;Campos Novos Paulista;4603;2360;2243;95;34,5;9,5
2012;3509908;Cananéia;12278;6134;6144;100,2;33,4;9,9
2012;3509957;Canas;4466;2251;2215;98,4;31,2;83,9
2012;3510005;Cândido Mota;29921;14657;15264;104,1;35,6;50,2
2012;3510104;Cândido Rodrigues;2715;1341;1374;102,5;38,9;38,3
2012;3510153;Canitar;4688;2361;2327;98,6;30,4;81,6
2012;3510203;Capão Bonito;46349;23092;23257;100,7;32,8;28,3
2012;3510302;Capela do Alto;18370;9564;8806;92,1;32,2;108,1
2012;3510401;Capivari;48841;24396;24445;100,2;33,2;151,3
2012;3510500;Caraguatatuba;106438;52588;53850;102,4;33,2;219,5
2012;3510609;Carapicuíba;373260;180868;192392;106,4;31,6;10804,8
2012;3510708;Cardoso;11790;5812;5978;102,9;37,4;18,4
2012;3510807;Casa Branca;28409;14994;13415;89,5;35,6;32,9
2012;3510906;Cássia dos Coqueiros;2673;1372;1301;94,8;36,5;13,9
2012;3511003;Castilho;18406;9160;9246;100,9;34,6;17,3
2012;3511102;Catanduva;113503;54982;58521;106,4;36,8;390,6
2012;3511201;Catiguá;7109;3609;3500;97;35;47,9
2012;3511300;Cedral;8709;4332;4377;101;37,2;44
2012;3511409;Cerqueira César;18210;9078;9132;100,6;34,1;35,6
2012;3511508;Cerquilho;40486;20012;20474;102,3;34,4;316,8
2012;3511607;Cesário Lange;16083;8327;7756;93,1;33,5;84,5
2012;3511706;Charqueada;15171;7700;7471;97;33,4;86,3
2012;3511904;Clementina;7080;3640;3440;94,5;32,7;42
2012;3512001;Colina;17596;8692;8904;102,4;34,9;41,7
2012;3512100;Colômbia;6146;3131;3015;96,3;33,3;8,4
2012;3512209;Conchal;25727;12980;12747;98,2;32,1;140,7
2012;3512308;Conchas;16182;8129;8053;99,1;35,5;34,7
2012;3512407;Cordeirópolis;21632;10842;10790;99,5;33,7;157,2
2012;3512506;Coroados;5281;2629;2652;100,9;35,1;21,4
2012;3512605;Coronel Macedo;4912;2513;2399;95,5;34,9;16,2
2012;3512704;Corumbataí;3927;1990;1937;97,3;34,2;14,1
2012;3512803;Cosmópolis;59152;29499;29653;100,5;32,6;382,5
2012;3512902;Cosmorama;7462;3765;3697;98,2;38,5;16,9
2012;3513009;Cotia;212784;104023;108761;104,6;31,7;656,8
2012;3513108;Cravinhos;32033;16013;16020;100;33,8;102,9
2012;3513207;Cristais Paulista;7838;3979;3859;97;33,8;20,3
2012;3513306;Cruzália;2252;1101;1151;104,5;37,3;15,1
2012;3513405;Cruzeiro;77053;37419;39634;105,9;34,7;252,1
2012;3513504;Cubatão;118178;58614;59564;101,6;31,6;827,1
2012;3513603;Cunha;21960;11213;10747;95,8;35,1;15,6
2012;3513702;Descalvado;31220;15397;15823;102,8;35,9;41,4
2012;3513801;Diadema;388920;187860;201060;107;31,8;12655,2
2012;3513850;Dirce Reis;1677;873;804;92,1;38,4;19
2012;3513900;Divinolândia;11239;5599;5640;100,7;37,3;50,2
2012;3514007;Dobrada;8106;4168;3938;94,5;31;54,1
2012;3514106;Dois Córregos;24790;12398;12392;100;34,4;39,2
2012;3514205;Dolcinópolis;2108;1095;1013;92,5;38,4;27
2012;3514304;Dourado;8543;4316;4227;97,9;36,9;41,5
2012;3514403;Dracena;43703;21599;22104;102,3;37,8;89,6
2012;3514502;Duartina;12299;5996;6303;105,1;37,3;46,5
2012;3514601;Dumont;8322;4179;4143;99,1;32,9;74,7
2012;3514700;Echaporã;6340;3125;3215;102,9;35,6;12,3
2012;3514809;Eldorado;14420;7346;7074;96,3;31,9;8,7
2012;3514908;Elias Fausto;16111;8302;7809;94,1;32,6;79,6
2012;3514924;Elisiário;3120;1632;1488;91,2;35,9;33,2
2012;3514957;Embaúba;2423;1258;1165;92,6;36,4;29,1
2012;3515004;Embu das Artes;242904;117930;124974;106;30,5;3450,4
2012;3515103;Embu-Guaçu;63599;31568;32031;101,5;32;408,6
2012;3515129;Emilianópolis;3039;1526;1513;99,1;37,2;13,5
2012;3515152;Engenheiro Coelho;16301;8477;7824;92,3;30,1;148,3
2012;3515186;Espírito Santo do Pinhal;41663;20357;21306;104,7;36,3;107
2012;3515194;Espírito Santo do Turvo;4235;2135;2100;98,4;31,6;21,9
2012;3515202;Estrela d'Oeste;8401;4236;4165;98,3;36,9;28,4
2012;3515301;Estrela do Norte;2674;1366;1308;95,8;34;10,1
2012;3515350;Euclides da Cunha Paulista;9355;4705;4650;98,8;33,1;16,3
2012;3515400;Fartura;15558;7548;8010;106,1;35,6;36,3
2012;3515509;Fernandópolis;65793;31981;33812;105,7;37,3;119,7
2012;3515608;Fernando Prestes;5596;2764;2832;102,5;38,4;32,9
2012;3515657;Fernão;1589;806;783;97,1;35,9;15,8
2012;3515707;Ferraz de Vasconcelos;170465;83105;87360;105,1;30,6;5769,2
2012;3515806;Flora Rica;1713;860;853;99,2;39,5;7,6
2012;3515905;Floreal;2963;1470;1493;101,6;41;14,5
2012;3516002;Flórida Paulista;12894;7082;5812;82,1;35,3;24,6
2012;3516101;Florínea;3012;1546;1466;94,8;36,3;13,3
2012;3516200;Franca;324277;158065;166212;105,2;33,9;535,4
2012;3516309;Francisco Morato;156207;77356;78851;101,9;29,6;3187,8
2012;3516408;Franco da Rocha;133797;68368;65429;95,7;31,2;1007,7
2012;3516507;Gabriel Monteiro;2713;1374;1339;97,5;38,4;19,6
2012;3516606;Gália;6947;3465;3482;100,5;37,1;19,5
2012;3516705;Garça;43112;20940;22172;105,9;35,9;77,6
2012;3516804;Gastão Vidigal;4080;2176;1904;87,5;34,7;22,6
2012;3516853;Gavião Peixoto;4474;2298;2176;94,7;32,6;18,4
2012;3516903;General Salgado;10646;5333;5313;99,6;37,1;21,5
2012;3517000;Getulina;10700;5824;4876;83,7;35,2;15,8
2012;3517109;Glicério;4510;2251;2259;100,4;35,3;16,5
2012;3517208;Guaiçara;10810;5423;5387;99,3;33,4;39
2012;3517307;Guaimbê;5452;2710;2742;101,2;34,4;25
2012;3517406;Guaíra;37824;18680;19144;102,5;34,7;30,1
2012;3517505;Guapiaçu;18467;9296;9171;98,7;35;56,8
2012;3517604;Guapiara;17927;9113;8814;96,7;33,3;43,9
2012;3517703;Guará;19711;9777;9934;101,6;32,7;54,4
2012;3517802;Guaraçaí;8328;4143;4185;101;38;14,6
2012;3517901;Guaraci;10088;5124;4964;96,9;34,1;15,7
2012;3518008;Guarani d'Oeste;1972;967;1005;103,9;37,4;23
2012;3518107;Guarantã;6433;3223;3210;99,6;33,2;13,9
2012;3518206;Guararapes;30749;15134;15615;103,2;36,2;32,2
2012;3518305;Guararema;26733;13411;13322;99,3;33,6;98,7
2012;3518404;Guaratinguetá;113159;54433;58726;107,9;35,3;150,4
2012;3518503;Guareí;14650;8942;5708;63,8;33,3;25,8
2012;3518602;Guariba;35961;18012;17949;99,7;32,1;133
2012;3518701;Guarujá;291141;141611;149530;105,6;32,3;2010,7
2012;3518800;Guarulhos;1235367;600485;634882;105,7;31,8;3876,6
2012;3518859;Guatapará;7042;3604;3438;95,4;33,3;17
2012;3518909;Guzolândia;4691;2404;2287;95,1;34,5;18,6
2012;3519006;Herculândia;8788;4382;4406;100,5;34,5;24,1
2012;3519055;Holambra;11860;5994;5866;97,9;33,1;180,9
2012;3519071;Hortolândia;199794;100744;99050;98,3;31,5;3201
2012;3519105;Iacanga;10065;5159;4906;95,1;35,1;18,4
2012;3519204;Iacri;6397;3230;3167;98;36,5;19,9
2012;3519253;Iaras;6617;4366;2251;51,6;33,4;16,5
2012;3519303;Ibaté;30996;15866;15130;95,4;31,7;106,5
2012;3519402;Ibirá;11020;5457;5563;101,9;36,5;40,5
2012;3519501;Ibirarema;6688;3369;3319;98,5;34,8;29,3
2012;3519600;Ibitinga;54281;26746;27535;102,9;34,8;78,7
2012;3519709;Ibiúna;72027;36566;35461;97;32,9;68,1
2012;3519808;Icém;7542;3894;3648;93,7;33,8;20,8
2012;3519907;Iepê;7637;3772;3865;102,5;36,1;12,8
2012;3520004;Igaraçu do Tietê;23388;11662;11726;100,5;33,6;239,3
2012;3520103;Igarapava;27730;13667;14063;102,9;34,9;59,2
2012;3520202;Igaratá;9159;4670;4489;96,1;34;31,3
2012;3520301;Iguape;28985;14538;14447;99,4;35,2;14,6
2012;3520400;Ilhabela;29274;14817;14457;97,6;31,6;84,5
2012;3520426;Ilha Comprida;9752;4838;4914;101,6;37;49,6
2012;3520442;Ilha Solteira;25252;12290;12962;105,5;36,7;38,7
2012;3520509;Indaiatuba;210086;104109;105977;101,8;33,7;674,3
2012;3520608;Indiana;4882;2455;2427;98,9;36,1;37,7
2012;3520707;Indiaporã;3949;1941;2008;103,5;39;14,1
2012;3520806;Inúbia Paulista;3644;1821;1823;100,1;36,1;41,8
2012;3520905;Ipaussu;13694;6873;6821;99,2;33,9;65,3
2012;3521002;Iperó;29608;15905;13703;86,2;31,4;173,9
2012;3521101;Ipeúna;6163;3169;2994;94,5;32,5;32,4
2012;3521150;Ipiguá;4823;2445;2378;97,3;35,9;35,5
2012;3521200;Iporanga;4260;2154;2106;97,8;32,1;3,7
2012;3521309;Ipuã;14230;7223;7007;97;32,4;30,5
2012;3521408;Iracemápolis;20358;10198;10160;99,6;33,6;176,8
2012;3521507;Irapuã;7217;3743;3474;92,8;34,8;28
2012;3521606;Irapuru;7705;4474;3231;72,2;37,2;35,9
2012;3521705;Itaberá;17874;9016;8858;98,2;33,8;16,2
2012;3521804;Itaí;24232;12822;11410;89;33,2;22,2
2012;3521903;Itajobi;14993;7557;7436;98,4;37,7;29,9
2012;3522000;Itaju;3292;1718;1574;91,6;34,6;14,3
2012;3522109;Itanhaém;91483;44301;47182;106,5;34,8;152
2012;3522158;Itaoca;3252;1686;1566;92,9;35;17,8
2012;3522208;Itapecerica da Serra;154003;76708;77295;100,8;30,7;1021,6
2012;3522307;Itapetininga;146730;73333;73397;100,1;33,2;82
2012;3522406;Itapeva;88217;43454;44763;103;32,2;48,3
2012;3522505;Itapevi;205874;101122;104752;103,6;29,7;2490,7
2012;3522604;Itapira;69224;34234;34990;102,2;36,4;133,5
2012;3522653;Itapirapuã Paulista;3938;2034;1904;93,6;30,7;9,7
2012;3522703;Itápolis;40120;19857;20263;102;36,2;40,3
2012;3522802;Itaporanga;14533;7249;7284;100,5;34,9;28,6
2012;3522901;Itapuí;12451;6276;6175;98,4;33,7;88,9
2012;3523008;Itapura;4316;2223;2093;94,2;34,4;14,3
2012;3523107;Itaquaquecetuba;329541;162199;167342;103,2;29,6;3988,6
2012;3523206;Itararé;47539;23306;24233;104;33,2;47,4
2012;3523305;Itariri;15524;7808;7716;98,8;31,6;56,7
2012;3523404;Itatiba;104885;51769;53116;102,6;34,3;325,5
2012;3523503;Itatinga;18324;9426;8898;94,4;31,4;18,7
2012;3523602;Itirapina;15635;9210;6425;69,8;33,1;27,7
2012;3523701;Itirapuã;5896;3005;2891;96,2;33,3;36,6
2012;3523800;Itobi;7615;3928;3687;93,9;34,5;54,8
2012;3523909;Itu;156776;77381;79395;102,6;33,6;244,7
2012;3524006;Itupeva;49002;24845;24157;97,2;31,3;243,9
2012;3524105;Ituverava;38582;18790;19792;105,3;35,7;54,8
2012;3524204;Jaborandi;6568;3313;3255;98,2;34,7;24
2012;3524303;Jaboticabal;71836;34773;37063;106,6;35,7;101,7
2012;3524402;Jacareí;216526;105500;111026;105,2;33,9;466,4
2012;3524501;Jaci;5959;3039;2920;96,1;33,5;41,1
2012;3524600;Jacupiranga;17060;8661;8399;97;32,9;24,2
2012;3524709;Jaguariúna;46635;23071;23564;102,1;33,5;329,8
2012;3524808;Jales;47440;23155;24285;104,9;37,5;128,7
2012;3524907;Jambeiro;5505;2836;2669;94,1;33,8;29,9
2012;3525003;Jandira;109979;53794;56185;104,4;30,6;6302,8
2012;3525102;Jardinópolis;38848;19643;19205;97,8;33,3;77,4
2012;3525201;Jarinu;26040;13109;12931;98,6;32,9;125,5
2012;3525300;Jaú;131612;64352;67260;104,5;35,3;191,5
2012;3525409;Jeriquara;3288;1690;1598;94,6;32,2;23,2
2012;3525508;Joanópolis;11939;6019;5920;98,4;35,8;31,9
2012;3525607;João Ramalho;4195;2119;2076;98;32,8;10,1
2012;3525706;José Bonifácio;33403;16637;16766;100,8;34,8;38,8
2012;3525805;Júlio Mesquita;4412;2168;2244;103,5;34,1;34,4
2012;3525854;Jumirim;2841;1454;1387;95,4;33,4;50,1
2012;3525904;Jundiaí;381956;185554;196402;105,8;35,7;885,8
2012;3526001;Junqueirópolis;19036;10058;8978;89,3;37;32,7
2012;3526100;Juquiá;18950;9588;9362;97,6;33,6;23,3
2012;3526209;Juquitiba;28549;14438;14111;97,7;32;54,7
2012;3526308;Lagoinha;4894;2502;2392;95,6;37,4;19,2
2012;3526407;Laranjal Paulista;25417;12524;12893;102,9;35,4;66,1
2012;3526506;Lavínia;8916;6336;2580;40,7;34,7;16,6
2012;3526605;Lavrinhas;6725;3377;3348;99,1;31,3;40,3
2012;3526704;Leme;93100;46538;46562;100,1;33,3;231,1
2012;3526803;Lençóis Paulista;62332;30909;31423;101,7;33,6;77
2012;3526902;Limeira;278912;136888;142024;103,8;34,7;480,3
2012;3527009;Lindóia;6766;3349;3417;102;35,3;138,8
2012;3527108;Lins;72107;34941;37166;106,4;36;126,5
2012;3527207;Lorena;83002;40024;42978;107,4;34,4;200,4
2012;3527256;Lourdes;2107;1087;1020;93,8;37,4;18,5
2012;3527306;Louveira;39340;19861;19479;98,1;31,2;705,8
2012;3527405;Lucélia;19978;10679;9299;87,1;36,2;63,5
2012;3527504;Lucianópolis;2261;1124;1137;101,2;35,6;11,9
2012;3527603;Luís Antônio;11448;5875;5573;94,9;30,7;19,1
2012;3527702;Luiziânia;4967;2558;2409;94,2;34,6;29,8
2012;3527801;Lupércio;4314;2102;2212;105,2;34,2;27,8
2012;3527900;Lutécia;2726;1362;1364;100,1;35,6;5,7
2012;3528007;Macatuba;16416;8212;8204;99,9;33,6;73,1
2012;3528106;Macaubal;7602;3837;3765;98,1;38,4;30,6
2012;3528205;Macedônia;3733;1873;1860;99,3;38,1;11,4
2012;3528304;Magda;3220;1650;1570;95,2;38,6;10,3
2012;3528403;Mairinque;44435;22187;22248;100,3;32,9;211,4
2012;3528502;Mairiporã;83213;41996;41217;98,1;33,1;259,5
2012;3528601;Manduri;9156;4590;4566;99,5;35,3;40
2012;3528700;Marabá Paulista;4785;3027;1758;58,1;33,8;5,2
2012;3528809;Maracaí;13265;6613;6652;100,6;34,8;24,9
2012;3528858;Marapoama;2745;1406;1339;95,2;36,4;24,7
2012;3528908;Mariápolis;3858;1981;1877;94,8;36,2;20,7
2012;3529005;Marília;220379;106346;114033;107,2;35,6;188,3
2012;3529104;Marinópolis;2090;1055;1035;98,1;36,6;26,9
2012;3529203;Martinópolis;24374;12656;11718;92,6;35,4;19,4
2012;3529302;Matão;77300;38242;39058;102,1;34,9;147,3
2012;3529401;Mauá;418138;204192;213946;104,8;32,1;6751
2012;3529500;Mendonça;4871;2468;2403;97,4;36,6;25
2012;3529609;Meridiano;3986;1958;2028;103,6;37,1;17,5
2012;3529658;Mesópolis;1894;963;931;96,7;36,2;12,7
2012;3529708;Miguelópolis;20366;10132;10234;101;33,2;24,8
2012;3529807;Mineiros do Tietê;11955;5948;6007;101;34,4;56,1
2012;3529906;Miracatu;20330;10266;10064;98;32,3;20,3
2012;3530003;Mira Estrela;2866;1425;1441;101,1;38,1;13,2
2012;3530102;Mirandópolis;27652;15234;12418;81,5;37,2;30,1
2012;3530201;Mirante do Paranapanema;16967;8588;8379;97,6;35,7;13,7
2012;3530300;Mirassol;55352;27110;28242;104,2;35,9;227,6
2012;3530409;Mirassolândia;4354;2213;2141;96,7;36;26,2
2012;3530508;Mococa;66707;33168;33539;101,1;35,7;78
2012;3530607;Mogi das Cruzes;398452;193705;204747;105,7;32,9;559,2
2012;3530706;Mogi Guaçu;140182;69367;70815;102,1;34,5;172,5
2012;3530805;Mogi Mirim;87720;43115;44605;103,5;35,6;176,2
2012;3530904;Mombuca;3335;1686;1649;97,8;32,8;24,9
2012;3531001;Monções;2108;1083;1025;94,6;39,2;20,2
2012;3531100;Mongaguá;48959;24518;24441;99,7;35,1;343
2012;3531209;Monte Alegre do Sul;7421;3701;3720;100,5;37,2;67,3
2012;3531308;Monte Alto;46940;23106;23834;103,2;36,6;135,3
2012;3531407;Monte Aprazível;21855;10836;11019;101,7;36,8;44,1
2012;3531506;Monte Azul Paulista;18863;9460;9403;99,4;35,8;71,6
2012;3531605;Monte Castelo;4082;2029;2053;101,2;38,1;17,5
2012;3531704;Monteiro Lobato;4146;2145;2001;93,3;35,4;12,5
2012;3531803;Monte Mor;51450;25666;25784;100,5;31,9;213,9
2012;3531902;Morro Agudo;29089;14757;14332;97,1;31,8;21
2012;3532009;Morungaba;12085;6030;6055;100,4;33,7;82,3
2012;3532058;Motuca;4240;2139;2101;98,2;33,9;18,5
2012;3532108;Murutinga do Sul;4114;2060;2054;99,7;39,3;16,4
2012;3532157;Nantes;2717;1352;1365;101;32,1;9,5
2012;3532207;Narandiba;4522;2279;2243;98,4;32,6;12,7
2012;3532306;Natividade da Serra;6743;3519;3224;91,6;37;8,1
2012;3532405;Nazaré Paulista;16761;8614;8147;94,6;34,9;51,4
2012;3532504;Neves Paulista;8920;4436;4484;101,1;39,1;40,7
2012;3532603;Nhandeara;10601;5196;5405;104;39,3;24,3
2012;3532702;Nipoã;4340;2281;2059;90,3;33,7;31,5
2012;3532801;Nova Aliança;6001;2970;3031;102,1;36,4;27,6
2012;3532827;Nova Campina;8512;4325;4187;96,8;29,6;22,1
2012;3532843;Nova Canaã Paulista;2109;1072;1037;96,7;41;16,9
2012;3532868;Nova Castilho;1120;554;566;102,2;35,6;6,1
2012;3532900;Nova Europa;9311;4657;4654;99,9;33,1;58,1
2012;3533007;Nova Granada;19233;9662;9571;99,1;35,2;36,2
2012;3533106;Nova Guataporanga;2170;1096;1074;98;38,4;63,5
2012;3533205;Nova Independência;3320;1673;1647;98,4;32,7;12,5
2012;3533254;Novais;4587;2449;2138;87,3;31,3;38,9
2012;3533304;Nova Luzitânia;3358;1759;1599;90,9;34,6;45,5
2012;3533403;Nova Odessa;52993;26169;26824;102,5;34,3;718,2
2012;3533502;Novo Horizonte;36905;18383;18522;100,8;35,8;39,6
2012;3533601;Nuporanga;6904;3446;3458;100,3;35,2;19,8
2012;3533700;Ocauçu;4193;2147;2046;95,3;35,2;13,9
2012;3533809;Óleo;2650;1333;1317;98,8;37,6;13,3
2012;3533908;Olímpia;50978;25092;25886;103,2;35,7;63,5
2012;3534005;Onda Verde;4024;2058;1966;95,5;33,9;16,6
2012;3534104;Oriente;6114;2982;3132;105;36,7;28
2012;3534203;Orindiúva;5744;2920;2824;96,7;31,8;23,2
2012;3534302;Orlândia;39688;19410;20278;104,5;34,6;136
2012;3534401;Osasco;679362;326068;353294;108,3;33,1;10459,1
2012;3534500;Oscar Bressane;2550;1222;1328;108,7;39,3;11,5
2012;3534609;Osvaldo Cruz;31005;15569;15436;99,1;37,8;125
2012;3534708;Ourinhos;103502;50054;53448;106,8;35,1;349,9
2012;3534757;Ouroeste;8734;4346;4388;101;35,1;30,3
2012;3534807;Ouro Verde;7844;3868;3976;102,8;34,5;29,4
2012;3534906;Pacaembu;13529;8092;5437;67,2;37,1;39,9
2012;3535002;Palestina;11116;5609;5507;98,2;36,9;15,9
2012;3535101;Palmares Paulista;10741;5683;5058;89;30,7;130,8
2012;3535200;Palmeira d'Oeste;9498;4762;4736;99,5;39;29,8
2012;3535309;Palmital;21023;10268;10755;104,7;37,2;38,3
2012;3535408;Panorama;14697;7349;7348;100;33,2;41,3
2012;3535507;Paraguaçu Paulista;42176;21187;20989;99,1;34,6;42,1
2012;3535606;Paraibuna;17502;8888;8614;96,9;34,3;21,6
2012;3535705;Paraíso;5942;3030;2912;96,1;35,8;38,3
2012;3535804;Paranapanema;18107;9218;8889;96,4;32,3;17,8
2012;3535903;Paranapuã;3840;1957;1883;96,2;36,3;27,4
2012;3536000;Parapuã;10812;5492;5320;96,9;37,5;29,5
2012;3536109;Pardinho;5856;2977;2879;96,7;33,2;27,9
2012;3536208;Pariquera-Açu;18601;9212;9389;101,9;33,4;51,8
2012;3536257;Parisi;2162;1097;1065;97,1;37,7;25,5
2012;3536307;Patrocínio Paulista;13264;6722;6542;97,3;33,5;22
2012;3536406;Paulicéia;6616;3408;3208;94,1;33;17,7
2012;3536505;Paulínia;86573;42733;43840;102,6;32,5;623,8
2012;3536570;Paulistânia;1828;941;887;94,3;34,9;7,1
2012;3536604;Paulo de Faria;8439;4228;4211;99,6;35,1;11,4
2012;3536703;Pederneiras;42085;21114;20971;99,3;33,6;57,9
2012;3536802;Pedra Bela;5918;3096;2822;91,1;35,9;37,3
2012;3536901;Pedranópolis;2603;1332;1271;95,4;38,7;10
2012;3537008;Pedregulho;15706;7968;7738;97,1;33,5;22
2012;3537107;Pedreira;41855;20714;21141;102,1;34,8;384,6
2012;3537156;Pedrinhas Paulista;2916;1446;1470;101,7;36,1;19,1
2012;3537206;Pedro de Toledo;10428;5283;5145;97,4;33,7;15,6
2012;3537305;Penápolis;59127;28803;30324;105,3;36,3;83,1
2012;3537404;Pereira Barreto;24953;12235;12718;103,9;35,9;25,6
2012;3537503;Pereiras;7666;3875;3791;97,8;34,7;34,4
2012;3537602;Peruíbe;61368;29874;31494;105,4;34,9;188,1
2012;3537701;Piacatu;5333;2680;2653;99;35,9;22,9
2012;3537800;Piedade;52313;26606;25707;96,6;34,3;70
2012;3537909;Pilar do Sul;26664;13547;13117;96,8;33,3;39,1
2012;3538006;Pindamonhangaba;150167;73680;76487;103,8;33,2;205,3
2012;3538105;Pindorama;14983;7629;7354;96,4;36,8;81,1
2012;3538204;Pinhalzinho;13435;6752;6683;99;36,4;86,9
2012;3538303;Piquerobi;3505;1728;1777;102,8;36,6;7,3
2012;3538501;Piquete;13915;6722;7193;107;36,3;79,1
2012;3538600;Piracaia;25305;12563;12742;101,4;35,2;65,6
2012;3538709;Piracicaba;374256;182776;191480;104,8;34,8;271,6
2012;3538808;Piraju;28718;13933;14785;106,1;35,9;56,9
2012;3538907;Pirajuí;22701;12442;10259;82,5;35,7;27,6
2012;3539004;Pirangi;10685;5408;5277;97,6;37,1;49,5
2012;3539103;Pirapora do Bom Jesus;16082;7997;8085;101,1;29,8;148,2
2012;3539202;Pirapozinho;24834;12140;12694;104,6;34,9;52
2012;3539301;Pirassununga;70790;34564;36226;104,8;35,9;97,4
2012;3539400;Piratininga;12552;6203;6349;102,4;36;31,2
2012;3539509;Pitangueiras;35193;17876;17317;96,9;31,8;81,7
2012;3539608;Planalto;4469;2300;2169;94,3;33,5;15,4
2012;3539707;Platina;3186;1649;1537;93,2;34,3;9,7
2012;3539806;Poá;106068;51269;54799;106,9;32,2;6144
2012;3539905;Poloni;5452;2688;2764;102,8;37,5;40,3
2012;3540002;Pompéia;20034;9829;10205;103,8;35,7;25,5
2012;3540101;Pongaí;3460;1781;1679;94,3;38,7;18,9
2012;3540200;Pontal;39878;20831;19047;91,4;30,4;111,9
2012;3540259;Pontalinda;4078;2164;1914;88,4;33,8;19,5
2012;3540309;Pontes Gestal;2524;1257;1267;100,8;36,9;11,6
2012;3540408;Populina;4226;2136;2090;97,8;38;13,4
2012;3540507;Porangaba;8701;4464;4237;94,9;36,8;32,7
2012;3540606;Porto Feliz;50151;25229;24922;98,8;34,1;90,1
2012;3540705;Porto Ferreira;51725;25588;26137;102,1;34,9;211,2
2012;3540754;Potim;19561;11056;8505;76,9;30,7;438,2
2012;3540804;Potirendaba;15930;8054;7876;97,8;36,5;46,5
2012;3540853;Pracinha;2810;2034;776;38,2;32,4;44,6
2012;3540903;Pradópolis;17367;8826;8541;96,8;32,7;103,8
2012;3541000;Praia Grande;276870;132808;144062;108,5;33,9;1850,1
2012;3541059;Pratânia;4676;2406;2270;94,3;31,7;26,7
2012;3541109;Presidente Alves;4085;2019;2066;102,3;36;14,3
2012;3541208;Presidente Bernardes;13775;6933;6842;98,7;38,1;18,4
2012;3541307;Presidente Epitácio;41135;20095;21040;104,7;34,4;32,6
2012;3541406;Presidente Prudente;210768;101345;109423;108;35,7;375,9
2012;3541505;Presidente Venceslau;37607;18660;18947;101,5;37;49,8
2012;3541604;Promissão;35720;17743;17977;101,3;34,5;45,8
2012;3541653;Quadra;3273;1719;1554;90,4;35;15,9
2012;3541703;Quatá;12868;6419;6449;100,5;33,8;19,8
2012;3541802;Queiroz;2876;1451;1425;98,2;32,1;12,2
2012;3541901;Queluz;10955;5557;5398;97,1;32,9;43,9
2012;3542008;Quintana;6171;3042;3129;102,9;35,2;19,3
2012;3542107;Rafard;8674;4287;4387;102,3;34,4;71,3
2012;3542206;Rancharia;28817;14125;14692;104;35,4;18,2
2012;3542305;Redenção da Serra;3999;2084;1915;91,9;35,8;12,9
2012;3542404;Regente Feijó;18793;9324;9469;101,6;35,6;71,4
2012;3542503;Reginópolis;7371;4679;2692;57,5;33,2;18
2012;3542602;Registro;55344;27245;28099;103,1;33,4;76,6
2012;3542701;Restinga;6535;3263;3272;100,3;31,5;26,6
2012;3542800;Ribeira;3336;1726;1610;93,3;34,9;9,9
2012;3542909;Ribeirão Bonito;12012;6023;5989;99,4;33,6;25,5
2012;3543006;Ribeirão Branco;18355;9424;8931;94,8;30,4;26,3
2012;3543105;Ribeirão Corrente;4334;2234;2100;94;32,2;29,2
2012;3543204;Ribeirão do Sul;4472;2246;2226;99,1;36,7;22
2012;3543238;Ribeirão dos Índios;2171;1076;1095;101,8;38,4;11,1
2012;3543253;Ribeirão Grande;7468;3826;3642;95,2;33,6;22,4
2012;3543303;Ribeirão Pires;113860;55601;58259;104,8;34,4;1150,4
2012;3543402;Ribeirão Preto;620806;297507;323299;108,7;35;953,7
2012;3543501;Riversul;6092;3031;3061;101;35,4;15,8
2012;3543600;Rifaina;3529;1771;1758;99,3;36;21,7
2012;3543709;Rincão;10246;5149;5097;99;33,6;32,4
2012;3543808;Rinópolis;9861;4993;4868;97,5;37,6;27,5
2012;3543907;Rio Claro;188911;91834;97077;105,7;35,4;379
2012;3544004;Rio das Pedras;29778;15019;14759;98,3;32,3;131,4
2012;3544103;Rio Grande da Serra;44147;21855;22292;102;31,3;1214,8
2012;3544202;Riolândia;10514;6067;4447;73,3;33,1;16,6
2012;3544251;Rosana;19424;9650;9774;101,3;33,6;26,1
2012;3544301;Roseira;9831;4952;4879;98,5;32,9;75,7
2012;3544400;Rubiácea;2718;1385;1333;96,2;33,7;11,5
2012;3544509;Rubinéia;3028;1496;1532;102,4;39,4;12,5
2012;3544608;Sabino;5237;2620;2617;99,9;37,1;17,2
2012;3544707;Sagres;2406;1189;1217;102,4;36;16,3
2012;3544806;Sales;5637;2864;2773;96,8;36,5;18,3
2012;3544905;Sales Oliveira;10714;5287;5427;102,6;35,4;35
2012;3545001;Salesópolis;15621;7871;7750;98,5;33,7;36,8
2012;3545100;Salmourão;4817;2465;2352;95,4;35,3;27,9
2012;3545159;Saltinho;7241;3596;3645;101,4;36,2;72,6
2012;3545209;Salto;110090;54319;55771;102,7;33,7;827,4
2012;3545308;Salto de Pirapora;40765;20264;20501;101,2;33,6;145,4
2012;3545407;Salto Grande;8852;4371;4481;102,5;35,4;47
2012;3545506;Sandovalina;3700;1878;1822;97;32,6;8,1
2012;3545605;Santa Adélia;14287;7121;7166;100,6;35,4;43,3
2012;3545704;Santa Albertina;5845;2957;2888;97,7;38,6;21,4
2012;3545803;Santa Bárbara d'Oeste;180821;89508;91313;102;34,6;667,2
2012;3546009;Santa Branca;13865;6923;6942;100,3;35;50,9
2012;3546108;Santa Clara d'Oeste;2171;1110;1061;95,6;37,4;11,8
2012;3546207;Santa Cruz da Conceição;4068;2008;2060;102,6;37;27,1
2012;3546256;Santa Cruz da Esperança;1999;990;1009;101,9;34,6;13,5
2012;3546306;Santa Cruz das Palmeiras;29850;15115;14735;97,5;33,2;101,1
2012;3546405;Santa Cruz do Rio Pardo;44399;21726;22673;104,4;35,4;39,8
2012;3546504;Santa Ernestina;5694;2912;2782;95,5;32,3;42,4
2012;3546603;Santa Fé do Sul;30140;14521;15619;107,6;37,3;145,9
2012;3546702;Santa Gertrudes;21982;11129;10853;97,5;31,3;223,6
2012;3546801;Santa Isabel;51030;25491;25539;100,2;33,3;140,5
2012;3546900;Santa Lúcia;8140;4066;4074;100,2;32,5;52,9
2012;3547007;Santa Maria da Serra;5376;2723;2653;97,4;32,7;21,3
2012;3547106;Santa Mercedes;2862;1434;1428;99,6;35,4;17,2
2012;3547205;Santana da Ponte Pensa;1641;839;802;95,6;41,7;12,6
2012;3547304;Santana de Parnaíba;115840;57005;58835;103,2;31,6;643,7
2012;3547403;Santa Rita d'Oeste;2592;1283;1309;102;40,8;12,4
2012;3547502;Santa Rita do Passa Quatro;26248;12677;13571;107,1;38,8;34,8
2012;3547601;Santa Rosa de Viterbo;23851;11735;12116;103,2;35,5;82,7
2012;3547650;Santa Salete;1475;755;720;95,4;39,6;18,6
2012;3547700;Santo Anastácio;20110;9784;10326;105,5;36,9;36,4
2012;3547809;Santo André;690149;330499;359650;108,8;36;3926,2
2012;3547908;Santo Antônio da Alegria;6395;3301;3094;93,7;36;20,6
2012;3548005;Santo Antônio de Posse;21096;10622;10474;98,6;33,1;136,9
2012;3548054;Santo Antônio do Aracanguá;7770;3937;3833;97,4;34,5;5,9
2012;3548104;Santo Antônio do Jardim;5971;3048;2923;95,9;36,2;54,3
2012;3548203;Santo Antônio do Pinhal;6611;3334;3277;98,3;34,1;49,7
2012;3548302;Santo Expedito;2818;1404;1414;100,7;37,3;29,8
2012;3548401;Santópolis do Aguapeí;4220;2126;2094;98,5;33,4;33
2012;3548500;Santos;420545;192156;228389;118,9;39,3;1496,4
2012;3548609;São Bento do Sapucaí;10678;5365;5313;99;36,3;42,3
2012;3548708;São Bernardo do Campo;775197;373536;401661;107,5;34;1892,9
2012;3548807;São Caetano do Sul;152262;70129;82133;117,1;39,7;9931,8
2012;3548906;São Carlos;227287;111402;115885;104;35,4;199,9
2012;3549003;São Francisco;2774;1387;1387;100;38,5;36,7
2012;3549102;São João da Boa Vista;85178;41239;43939;106,5;36,7;164,9
2012;3549201;São João das Duas Pontes;2579;1292;1287;99,6;36,6;19,9
2012;3549250;São João de Iracema;1786;903;883;97,8;36,2;10
2012;3549300;São João do Pau d'Alho;2129;1069;1060;99,2;40,2;18,1
2012;3549409;São Joaquim da Barra;46974;22975;23999;104,5;34,7;114,3
2012;3549508;São José da Bela Vista;8288;4238;4050;95,6;31,9;29,9
2012;3549607;São José do Barreiro;4058;2040;2018;98,9;34,4;7,1
2012;3549706;São José do Rio Pardo;52027;25519;26508;103,9;36,3;124
2012;3549805;São José do Rio Preto;420463;201713;218750;108,4;36,2;973,4
2012;3549904;São José dos Campos;642021;313757;328264;104,6;33,4;584
2012;3549953;São Lourenço da Serra;14327;7258;7069;97,4;32,8;76,8
2012;3550001;São Luiz do Paraitinga;10426;5322;5104;95,9;36,5;16,9
2012;3550100;São Manuel;38234;18718;19516;104,3;34,5;58,8
2012;3550209;São Miguel Arcanjo;31681;16095;15586;96,8;32,8;34,1
2012;3550308;São Paulo;11318071;5355160;5962911;111,3;34,5;7440,2
2012;3550407;São Pedro;32784;15967;16817;105,3;36,2;53,6
2012;3550506;São Pedro do Turvo;7198;3665;3533;96,4;34,3;9,8
2012;3550605;São Roque;78949;38795;40154;103,5;34,9;257,2
2012;3550704;São Sebastião;75275;37450;37825;101;31,6;187,1
2012;3550803;São Sebastião da Grama;11882;6041;5841;96,7;35,1;47,1
2012;3550902;São Simão;14269;7022;7247;103,2;35,5;23,1
2012;3551009;São Vicente;333180;160139;173041;108,1;33,7;2248,9
2012;3551108;Sarapuí;9271;4712;4559;96,8;33,5;26,3
2012;3551207;Sarutaiá;3651;1834;1817;99,1;34,7;25,8
2012;3551306;Sebastianópolis do Sul;3052;1523;1529;100,4;37,4;18,2
2012;3551405;Serra Azul;11502;7074;4428;62,6;32,9;40,6
2012;3551504;Serrana;39750;19859;19891;100,2;31,1;315,4
2012;3551603;Serra Negra;27010;13146;13864;105,5;37,7;132,6
2012;3551702;Sertãozinho;113100;55983;57117;102;33,3;280,6
2012;3551801;Sete Barras;12993;6665;6328;94,9;32,9;12,2
2012;3551900;Severínia;15371;7969;7402;92,9;32,5;109,4
2012;3552007;Silveiras;5865;2963;2902;97,9;34,1;14,1
2012;3552106;Socorro;37281;18473;18808;101,8;37,6;83
2012;3552205;Sorocaba;609256;297516;311740;104,8;33,9;1354,3
2012;3552304;Sud Mennucci;7433;3731;3702;99,2;34,6;12,5
2012;3552403;Sumaré;247707;122743;124964;101,8;32,1;1614,1
2012;3552502;Suzano;270316;132273;138043;104,4;31,8;1310,7
2012;3552551;Suzanápolis;3387;1745;1642;94,1;35,5;10,2
2012;3552601;Tabapuã;11355;5714;5641;98,7;36,9;32,8
2012;3552700;Tabatinga;14713;7521;7192;95,6;33,9;39,9
2012;3552809;Taboão da Serra;249977;119401;130576;109,4;31,7;12261,1
2012;3552908;Taciba;5811;2901;2910;100,3;34,4;9,6
2012;3553005;Taguaí;11124;5527;5597;101,3;32,2;76,5
2012;3553104;Taiaçu;5855;2957;2898;98;35,2;54,7
2012;3553203;Taiúva;5643;2858;2785;97,4;37,3;42,6
2012;3553302;Tambaú;22321;11101;11220;101,1;35,1;39,7
2012;3553401;Tanabi;24316;12131;12185;100,4;37,2;32,5
2012;3553500;Tapiraí;8044;4058;3986;98,2;32,2;10,7
2012;3553609;Tapiratiba;12610;6244;6366;102;35,4;56,8
2012;3553658;Taquaral;2743;1379;1364;98,9;35,3;50,9
2012;3553708;Taquaritinga;53793;26496;27297;103;35,4;90,5
2012;3553807;Taquarituba;22726;11385;11341;99,6;34,1;50,7
2012;3553856;Taquarivaí;5428;2723;2705;99,3;30;23,4
2012;3553906;Tarabai;6615;3287;3328;101,2;33,1;32,8
2012;3553955;Tarumã;13242;6732;6510;96,7;32,4;43,7
2012;3554003;Tatuí;110323;54413;55910;102,8;33,6;210,6
2012;3554102;Taubaté;284332;139116;145216;104,4;34,2;454,9
2012;3554201;Tejupá;4724;2423;2301;95;32,5;15,9
2012;3554300;Teodoro Sampaio;21532;10721;10811;100,8;32,5;13,8
2012;3554409;Terra Roxa;8417;4246;4171;98,2;34,6;38
2012;3554508;Tietê;36991;18311;18680;102;34,9;91,5
2012;3554607;Timburi;2635;1356;1279;94,3;37,3;13,4
2012;3554656;Torre de Pedra;2218;1161;1057;91;36,8;31,1
2012;3554706;Torrinha;9304;4684;4620;98,6;36,8;29,5
2012;3554755;Trabiju;1568;785;783;99,7;33,4;24,7
2012;3554805;Tremembé;42693;22614;20079;88,8;33,4;223,4
2012;3554904;Três Fronteiras;5676;2841;2835;99,8;38;37,4
2012;3554953;Tuiuti;6078;3087;2991;96,9;37,5;48
2012;3555000;Tupã;63599;30725;32874;107;37,7;101,3
2012;3555109;Tupi Paulista;14532;7663;6869;89,6;39,5;59,4
2012;3555208;Turiúba;1919;983;936;95,2;39,5;12,5
2012;3555307;Turmalina;1932;957;975;101,9;41,2;13,1
2012;3555356;Ubarana;5322;2730;2592;94,9;32;25,4
2012;3555406;Ubatuba;80984;40229;40755;101,3;32,5;114,4
2012;3555505;Ubirajara;4550;2350;2200;93,6;34,5;16,1
2012;3555604;Uchoa;9657;4789;4868;101,6;37,2;38,3
2012;3555703;União Paulista;1611;827;784;94,8;34,4;20,4
2012;3555802;Urânia;8844;4394;4450;101,3;37,9;42,3
2012;3555901;Uru;1284;655;629;96;37,5;8,7
2012;3556008;Urupês;12919;6408;6511;101,6;37,9;39,9
2012;3556107;Valentim Gentil;11509;5774;5735;99,3;34,7;76,9
2012;3556206;Valinhos;109988;54158;55830;103,1;35,6;740,5
2012;3556305;Valparaíso;22845;12575;10270;81,7;33,5;26,6
2012;3556354;Vargem;9039;4641;4398;94,8;35,2;63,4
2012;3556404;Vargem Grande do Sul;39401;19532;19869;101,7;34,7;147,5
2012;3556453;Vargem Grande Paulista;44284;21927;22357;102;32,1;1042,2
2012;3556503;Várzea Paulista;108917;54288;54629;100,6;31,8;3101,3
2012;3556602;Vera Cruz;10690;5259;5431;103,3;36,6;43,2
2012;3556701;Vinhedo;65771;32473;33298;102,5;34,8;812,5
2012;3556800;Viradouro;17382;8725;8657;99,2;34,3;79,8
2012;3556909;Vista Alegre do Alto;7068;3623;3445;95,1;33,2;74,1
2012;3556958;Vitória Brasil;1758;900;858;95,3;36,5;35,3
2012;3557006;Votorantim;112096;55500;56596;102;32,6;608,6
2012;3557105;Votuporanga;86653;42192;44461;105,4;36,7;206
2012;3557154;Zacarias;2400;1202;1198;99,7;36,5;7,5
2012;3557204;Chavantes;12200;6047;6153;101,8;34,5;64,6
2012;3557303;Estiva Gerbi;10270;5177;5093;98,4;33,4;138,5
2013;3500105;Adamantina;34085;16488;17597;106,7;38,5;82,7
2013;3500204;Adolfo;3752;1881;1871;99,5;37,3;17,8
2013;3500303;Aguaí;32205;16166;16039;99,2;33,9;67,9
2013;3500402;Águas da Prata;7559;3709;3850;103,8;39,1;53
2013;3500501;Águas de Lindóia;17553;8583;8970;104,5;37;291,9
2013;3500550;Águas de Santa Bárbara;6040;3001;3039;101,3;36;14,9
2013;3500600;Águas de São Pedro;2717;1265;1452;114,8;42,4;752,2
2013;3500709;Agudos;35390;17472;17918;102,6;33,9;36,6
2013;3500758;Alambari;5188;2610;2578;98,8;33,3;32,5
2013;3500808;Alfredo Marcondes;4046;2048;1998;97,6;39,3;34
2013;3500907;Altair;3753;1987;1766;88,9;33,1;12
2013;3501004;Altinópolis;15928;7945;7983;100,5;35,8;17,1
2013;3501103;Alto Alegre;4074;2078;1996;96,1;39,4;12,8
2013;3501152;Alumínio;17034;8563;8471;98,9;32,2;203,7
2013;3501202;Álvares Florence;3921;2012;1909;94,9;40,8;10,8
2013;3501301;Álvares Machado;24543;12084;12459;103,1;35,1;70,6
2013;3501400;Álvaro de Carvalho;4698;3021;1677;55,5;33,6;30,6
2013;3501509;Alvinlândia;2978;1470;1508;102,6;34,2;35,1
2013;3501608;Americana;217484;106144;111340;104,9;36,2;1624,1
2013;3501707;Américo Brasiliense;34292;17174;17118;99,7;31,9;278,9
2013;3501806;Américo de Campos;5779;2873;2906;101,1;38,2;22,9
2013;3501905;Amparo;66508;32667;33841;103,6;36,6;149,3
2013;3502002;Analândia;4348;2222;2126;95,7;35,1;13,3
2013;3502101;Andradina;56691;27943;28748;102,9;36,8;58,8
2013;3502200;Angatuba;22681;11457;11224;98;34,1;22,1
2013;3502309;Anhembi;5682;2912;2770;95,1;33,5;7,7
2013;3502408;Anhumas;3813;1890;1923;101,7;35,3;11,9
2013;3502507;Aparecida;34502;16638;17864;107,4;35,1;285,4
2013;3502606;Aparecida d'Oeste;4362;2145;2217;103,4;39,4;24,4
2013;3502705;Apiaí;25192;12594;12598;100;32,8;25,9
2013;3502754;Araçariguama;18130;9203;8927;97;30,6;124,9
2013;3502804;Araçatuba;186694;89539;97155;108,5;36,7;160
2013;3502903;Araçoiaba da Serra;28595;14249;14346;100,7;35,4;112
2013;3503000;Aramina;5243;2618;2625;100,3;36,3;25,8
2013;3503109;Arandu;6305;3176;3129;98,5;34;22,1
2013;3503158;Arapeí;2478;1246;1232;98,9;35,6;15,8
2013;3503208;Araraquara;217130;104588;112542;107,6;36,3;216,3
2013;3503307;Araras;122023;59970;62053;103,5;35,4;189,2
2013;3503356;Arco-Íris;1961;990;971;98,1;37,5;7,4
2013;3503406;Arealva;7923;4014;3909;97,4;38,5;15,7
2013;3503505;Areias;3697;1844;1853;100,5;33,8;12,1
2013;3503604;Areiópolis;10528;5400;5128;95;31,6;122,6
2013;3503703;Ariranha;8388;4250;4138;97,4;35,7;63,2
2013;3503802;Artur Nogueira;46058;22938;23120;100,8;33;258,7
2013;3503901;Arujá;77862;38274;39588;103,4;32,2;809,7
2013;3503950;Aspásia;1815;915;900;98,4;38,2;26,2
2013;3504008;Assis;96937;47067;49870;106;36,3;210,5
2013;3504107;Atibaia;134738;65972;68766;104,2;35;281,6
2013;3504206;Auriflama;14140;7047;7093;100,7;37,2;32,5
2013;3504305;Avaí;4837;2434;2403;98,7;34,2;8,9
2013;3504404;Avanhandava;11332;6255;5077;81,2;32,6;33,5
2013;3504503;Avaré;85494;42399;43095;101,6;34,8;70,5
2013;3504602;Bady Bassitt;17661;8734;8927;102,2;34,6;160
2013;3504701;Balbinos;3720;3015;705;23,4;34,3;40,6
2013;3504800;Bálsamo;8548;4178;4370;104,6;37,9;57
2013;3504909;Bananal;10200;5020;5180;103,2;35,4;16,5
2013;3505005;Barão de Antonina;3212;1626;1586;97,5;35,3;21
2013;3505104;Barbosa;6367;3184;3183;100;34,4;31
2013;3505203;Bariri;31651;15757;15894;100,9;36,2;71,2
2013;3505302;Barra Bonita;35272;17191;18081;105,2;37,1;235
2013;3505351;Barra do Chapéu;5235;2749;2486;90,4;32,5;12,9
2013;3505401;Barra do Turvo;7569;3943;3626;92;33,4;7,5
2013;3505500;Barretos;114814;55376;59438;107,3;35,7;73,3
2013;3505609;Barrinha;29458;14739;14719;99,9;30,8;201,7
2013;3505708;Barueri;260533;126130;134403;106,6;31,5;3965,5
2013;3505807;Bastos;20748;10170;10578;104;35,1;121,4
2013;3505906;Batatais;56997;27929;29068;104,1;35,9;67,1
2013;3506003;Bauru;353425;171189;182236;106,5;35,4;529,3
2013;3506102;Bebedouro;75591;36756;38835;105,7;36;110,6
2013;3506201;Bento de Abreu;2688;1369;1319;96,3;34,5;8,9
2013;3506300;Bernardino de Campos;10986;5455;5531;101,4;37;45
2013;3506359;Bertioga;51695;25846;25849;100;30,9;105,2
2013;3506409;Bilac;7134;3522;3612;102,6;37,8;45,1
2013;3506508;Birigui;111596;54369;57227;105,3;35,7;210,5
2013;3506607;Biritiba Mirim;28963;14569;14394;98,8;33,1;91,2
2013;3506706;Boa Esperança do Sul;13571;6804;6767;99,5;33;19,6
2013;3506805;Bocaina;10990;5447;5543;101,8;34,8;30,2
2013;3506904;Bofete;9852;5022;4830;96,2;35,4;15,1
2013;3507001;Boituva;51426;25747;25679;99,7;33,2;206,6
2013;3507100;Bom Jesus dos Perdões;20202;10133;10069;99,4;32,9;186,4
2013;3507159;Bom Sucesso de Itararé;3543;1808;1735;96;29,6;26,5
2013;3507209;Borá;835;428;407;95,1;34,6;7
2013;3507308;Boracéia;4392;2238;2154;96,2;33,9;36
2013;3507407;Borborema;14519;7303;7216;98,8;36,7;26,3
2013;3507456;Borebi;2394;1184;1210;102,2;32,8;6,9
2013;3507506;Botucatu;131863;63837;68026;106,6;35,3;88,9
2013;3507605;Bragança Paulista;154291;75553;78738;104,2;35,2;301
2013;3507704;Braúna;5091;2563;2528;98,6;36,4;26,1
2013;3507753;Brejo Alegre;2592;1334;1258;94,3;35,2;24,5
2013;3507803;Brodowski;22126;10941;11185;102,2;34,6;79,5
2013;3507902;Brotas;22189;10955;11234;102,5;34,9;20,1
2013;3508009;Buri;19069;9708;9361;96,4;31,5;15,9
2013;3508108;Buritama;15977;7947;8030;101;36,5;48,9
2013;3508207;Buritizal;4140;2096;2044;97,5;36,3;15,5
2013;3508306;Cabrália Paulista;4371;2223;2148;96,6;33,9;18,2
2013;3508405;Cabreúva;42933;21630;21303;98,5;31,2;165
2013;3508504;Caçapava;87946;43453;44493;102,4;34,3;238,3
2013;3508603;Cachoeira Paulista;30556;14925;15631;104,7;35;106,1
2013;3508702;Caconde;18196;9098;9098;100;35,5;38,9
2013;3508801;Cafelândia;16708;8181;8527;104,2;36,1;18,2
2013;3508900;Caiabu;4029;2054;1975;96,2;36,8;15,9
2013;3509007;Caieiras;88852;43356;45496;104,9;32,4;910
2013;3509106;Caiuá;5150;2801;2349;83,9;36,1;9,3
2013;3509205;Cajamar;71041;35314;35727;101,2;30,8;540,7
2013;3509254;Cajati;28578;14422;14156;98,2;31,8;62,9
2013;3509304;Cajobi;9657;4915;4742;96,5;36,1;54,6
2013;3509403;Cajuru;23528;11759;11769;100,1;34,1;35,6
2013;3509452;Campina do Monte Alegre;5666;2890;2776;96,1;34,2;30,7
2013;3509502;Campinas;1097030;527752;569278;107,9;35,5;1380,7
2013;3509601;Campo Limpo Paulista;75371;36999;38372;103,7;33;949,2
2013;3509700;Campos do Jordão;47716;23355;24361;104,3;32,7;164,5
2013;3509809;Campos Novos Paulista;4641;2379;2262;95,1;34,8;9,6
2013;3509908;Cananéia;12298;6129;6169;100,7;33,8;9,9
2013;3509957;Canas;4518;2278;2240;98,3;31,5;84,8
2013;3510005;Cândido Mota;29904;14638;15266;104,3;36;50,2
2013;3510104;Cândido Rodrigues;2741;1358;1383;101,8;39,2;38,7
2013;3510153;Canitar;4845;2435;2410;99;30,6;84,3
2013;3510203;Capão Bonito;46425;23116;23309;100,8;33,1;28,3
2013;3510302;Capela do Alto;18822;9847;8975;91,1;32,5;110,8
2013;3510401;Capivari;49021;24439;24582;100,6;33,6;151,8
2013;3510500;Caraguatatuba;109339;53945;55394;102,7;33,6;225,5
2013;3510609;Carapicuíba;375280;181732;193548;106,5;31,9;10863,3
2013;3510708;Cardoso;11780;5800;5980;103,1;37,8;18,4
2013;3510807;Casa Branca;28438;14983;13455;89,8;35,9;32,9
2013;3510906;Cássia dos Coqueiros;2696;1380;1316;95,4;36,9;14,1
2013;3511003;Castilho;18612;9253;9359;101,1;34,9;17,5
2013;3511102;Catanduva;113892;55109;58783;106,7;37;391,9
2013;3511201;Catiguá;7110;3604;3506;97,3;35,3;47,9
2013;3511300;Cedral;9088;4519;4569;101,1;37,3;45,9
2013;3511409;Cerqueira César;18573;9299;9274;99,7;34,3;36,3
2013;3511508;Cerquilho;40951;20215;20736;102,6;34,7;320,4
2013;3511607;Cesário Lange;16383;8474;7909;93,3;33,8;86
2013;3511706;Charqueada;15220;7708;7512;97,5;33,7;86,6
2013;3511904;Clementina;7103;3640;3463;95,1;33;42,1
2013;3512001;Colina;17706;8729;8977;102,8;35,2;41,9
2013;3512100;Colômbia;6209;3157;3052;96,7;33,6;8,5
2013;3512209;Conchal;25996;13100;12896;98,4;32,4;142,2
2013;3512308;Conchas;16098;8085;8013;99,1;35,8;34,5
2013;3512407;Cordeirópolis;21951;10986;10965;99,8;33,9;159,6
2013;3512506;Coroados;5310;2646;2664;100,7;35,4;21,5
2013;3512605;Coronel Macedo;4857;2482;2375;95,7;35,4;16
2013;3512704;Corumbataí;3958;2006;1952;97,3;34,5;14,2
2013;3512803;Cosmópolis;59373;29563;29810;100,8;32,9;383,9
2013;3512902;Cosmorama;7585;3825;3760;98,3;38,5;17,2
2013;3513009;Cotia;219052;107013;112039;104,7;32;676,1
2013;3513108;Cravinhos;32223;16080;16143;100,4;34,2;103,5
2013;3513207;Cristais Paulista;7982;4044;3938;97,4;34,1;20,7
2013;3513306;Cruzália;2239;1096;1143;104,3;37,7;15
2013;3513405;Cruzeiro;77005;37348;39657;106,2;35;251,9
2013;3513504;Cubatão;117938;58320;59618;102,2;32;825,4
2013;3513603;Cunha;22005;11229;10776;96;35,5;15,6
2013;3513702;Descalvado;31347;15455;15892;102,8;36,2;41,6
2013;3513801;Diadema;390422;188413;202009;107,2;32,2;12704,1
2013;3513850;Dirce Reis;1676;867;809;93,3;38,7;19
2013;3513900;Divinolândia;11259;5602;5657;101;37,6;50,3
2013;3514007;Dobrada;8189;4192;3997;95,3;31,4;54,7
2013;3514106;Dois Córregos;24806;12386;12420;100,3;34,7;39,2
2013;3514205;Dolcinópolis;2113;1096;1017;92,8;38,7;27,1
2013;3514304;Dourado;8523;4298;4225;98,3;37,3;41,4
2013;3514403;Dracena;43927;21693;22234;102,5;38;90,1
2013;3514502;Duartina;12322;6008;6314;105,1;37,7;46,6
2013;3514601;Dumont;8428;4232;4196;99,1;33,2;75,7
2013;3514700;Echaporã;6329;3119;3210;102,9;35,9;12,3
2013;3514809;Eldorado;14311;7282;7029;96,5;32,3;8,7
2013;3514908;Elias Fausto;16272;8361;7911;94,6;33;80,4
2013;3514924;Elisiário;3124;1630;1494;91,7;36,2;33,2
2013;3514957;Embaúba;2411;1248;1163;93,2;36,8;29
2013;3515004;Embu das Artes;244301;118551;125750;106,1;30,9;3470,3
2013;3515103;Embu-Guaçu;64108;31807;32301;101,6;32,4;411,9
2013;3515129;Emilianópolis;3044;1526;1518;99,5;37,6;13,5
2013;3515152;Engenheiro Coelho;16617;8610;8007;93;30,4;151,1
2013;3515186;Espírito Santo do Pinhal;41554;20289;21265;104,8;36,7;106,8
2013;3515194;Espírito Santo do Turvo;4232;2134;2098;98,3;31,9;21,9
2013;3515202;Estrela d'Oeste;8496;4287;4209;98,2;37,2;28,7
2013;3515301;Estrela do Norte;2688;1366;1322;96,8;34,4;10,1
2013;3515350;Euclides da Cunha Paulista;9234;4636;4598;99,2;33,5;16,1
2013;3515400;Fartura;15681;7611;8070;106;35,9;36,5
2013;3515509;Fernandópolis;66403;32242;34161;106;37,5;120,8
2013;3515608;Fernando Prestes;5637;2779;2858;102,8;38,7;33,2
2013;3515657;Fernão;1594;810;784;96,8;36,2;15,9
2013;3515707;Ferraz de Vasconcelos;171625;83616;88009;105,3;31;5808,5
2013;3515806;Flora Rica;1695;854;841;98,5;40;7,5
2013;3515905;Floreal;2940;1459;1481;101,5;41,3;14,4
2013;3516002;Flórida Paulista;12912;7091;5821;82,1;35,6;24,6
2013;3516101;Florínea;3110;1633;1477;90,4;36,5;13,8
2013;3516200;Franca;327347;159485;167862;105,3;34,2;540,5
2013;3516309;Francisco Morato;157266;77803;79463;102,1;29,9;3209,4
2013;3516408;Franco da Rocha;134961;68853;66108;96;31,5;1016,5
2013;3516507;Gabriel Monteiro;2726;1373;1353;98,5;38,7;19,7
2013;3516606;Gália;6905;3438;3467;100,8;37,5;19,4
2013;3516705;Garça;43091;20916;22175;106;36,2;77,5
2013;3516804;Gastão Vidigal;4010;2113;1897;89,8;35,3;22,2
2013;3516853;Gavião Peixoto;4503;2304;2199;95,4;32,9;18,5
2013;3516903;General Salgado;10632;5320;5312;99,8;37,5;21,5
2013;3517000;Getulina;10671;5811;4860;83,6;35,6;15,8
2013;3517109;Glicério;4479;2231;2248;100,8;35,8;16,4
2013;3517208;Guaiçara;10859;5441;5418;99,6;33,7;39,2
2013;3517307;Guaimbê;5478;2723;2755;101,2;34,8;25,2
2013;3517406;Guaíra;38025;18752;19273;102,8;35;30,2
2013;3517505;Guapiaçu;18771;9434;9337;99;35,2;57,7
2013;3517604;Guapiara;17880;9082;8798;96,9;33,7;43,8
2013;3517703;Guará;19633;9723;9910;101,9;33,1;54,2
2013;3517802;Guaraçaí;8259;4103;4156;101,3;38,5;14,5
2013;3517901;Guaraci;10131;5138;4993;97,2;34,5;15,8
2013;3518008;Guarani d'Oeste;1976;971;1005;103,5;37,8;23,1
2013;3518107;Guarantã;6451;3229;3222;99,8;33,5;14
2013;3518206;Guararapes;30846;15164;15682;103,4;36,5;32,3
2013;3518305;Guararema;27200;13623;13577;99,7;34;100,4
2013;3518404;Guaratinguetá;113713;54682;59031;108;35,7;151,1
2013;3518503;Guareí;14711;8961;5750;64,2;33,7;25,9
2013;3518602;Guariba;36225;18073;18152;100,4;32,4;134
2013;3518701;Guarujá;291478;141625;149853;105,8;32,6;2013
2013;3518800;Guarulhos;1243111;603669;639442;105,9;32,1;3900,9
2013;3518859;Guatapará;7080;3616;3464;95,8;33,6;17,1
2013;3518909;Guzolândia;4662;2390;2272;95,1;34,9;18,5
2013;3519006;Herculândia;8839;4401;4438;100,8;34,8;24,3
2013;3519055;Holambra;12158;6137;6021;98,1;33,4;185,4
2013;3519071;Hortolândia;203617;102519;101098;98,6;31,9;3262,3
2013;3519105;Iacanga;10097;5153;4944;95,9;35,4;18,4
2013;3519204;Iacri;6393;3223;3170;98,4;36,8;19,9
2013;3519253;Iaras;6761;4466;2295;51,4;33,9;16,8
2013;3519303;Ibaté;31151;15901;15250;95,9;32;107,1
2013;3519402;Ibirá;11083;5483;5600;102,1;36,8;40,8
2013;3519501;Ibirarema;6680;3359;3321;98,9;35,2;29,3
2013;3519600;Ibitinga;54891;27032;27859;103,1;35,1;79,6
2013;3519709;Ibiúna;72459;36750;35709;97,2;33,2;68,5
2013;3519808;Icém;7589;3948;3641;92,2;34,2;20,9
2013;3519907;Iepê;7641;3765;3876;102,9;36,5;12,8
2013;3520004;Igaraçu do Tietê;23399;11667;11732;100,6;33,9;239,4
2013;3520103;Igarapava;27599;13574;14025;103,3;35,2;58,9
2013;3520202;Igaratá;9318;4747;4571;96,3;34,3;31,8
2013;3520301;Iguape;29063;14581;14482;99,3;35,6;14,7
2013;3520400;Ilhabela;29824;15065;14759;98;31,9;86,1
2013;3520426;Ilha Comprida;10123;5021;5102;101,6;37,4;51,5
2013;3520442;Ilha Solteira;25334;12332;13002;105,4;37;38,8
2013;3520509;Indaiatuba;214706;106253;108453;102,1;34,1;689,2
2013;3520608;Indiana;4910;2470;2440;98,8;36,4;38
2013;3520707;Indiaporã;3961;1944;2017;103,8;39,3;14,2
2013;3520806;Inúbia Paulista;3651;1819;1832;100,7;36,5;41,9
2013;3520905;Ipaussu;13713;6868;6845;99,7;34,2;65,4
2013;3521002;Iperó;30320;16286;14034;86,2;31,8;178,1
2013;3521101;Ipeúna;6260;3212;3048;94,9;32,8;32,9
2013;3521150;Ipiguá;5021;2540;2481;97,7;36,2;36,9
2013;3521200;Iporanga;4235;2143;2092;97,6;32,5;3,7
2013;3521309;Ipuã;14274;7232;7042;97,4;32,8;30,6
2013;3521408;Iracemápolis;20512;10267;10245;99,8;34;178,2
2013;3521507;Irapuã;7192;3720;3472;93,3;35,2;27,9
2013;3521606;Irapuru;7664;4444;3220;72,5;37,5;35,7
2013;3521705;Itaberá;17903;9025;8878;98,4;34,2;16,3
2013;3521804;Itaí;24377;12870;11507;89,4;33,5;22,3
2013;3521903;Itajobi;15195;7653;7542;98,5;37,8;30,3
2013;3522000;Itaju;3327;1725;1602;92,9;34,9;14,4
2013;3522109;Itanhaém;93781;45392;48389;106,6;35,2;155,9
2013;3522158;Itaoca;3279;1696;1583;93,3;35,3;17,9
2013;3522208;Itapecerica da Serra;154920;77032;77888;101,1;31;1027,7
2013;3522307;Itapetininga;147941;73932;74009;100,1;33,5;82,7
2013;3522406;Itapeva;88561;43612;44949;103,1;32,6;48,5
2013;3522505;Itapevi;208697;102438;106259;103,7;30;2524,8
2013;3522604;Itapira;69582;34383;35199;102,4;36,7;134,2
2013;3522653;Itapirapuã Paulista;3963;2049;1914;93,4;31,1;9,7
2013;3522703;Itápolis;40117;19835;20282;102,3;36,6;40,2
2013;3522802;Itaporanga;14541;7242;7299;100,8;35,2;28,6
2013;3522901;Itapuí;12569;6329;6240;98,6;33,9;89,8
2013;3523008;Itapura;4285;2203;2082;94,5;34,9;14,2
2013;3523107;Itaquaquecetuba;333732;164165;169567;103,3;30;4039,3
2013;3523206;Itararé;47358;23204;24154;104,1;33,6;47,2
2013;3523305;Itariri;15545;7808;7737;99,1;32,1;56,8
2013;3523404;Itatiba;106702;52626;54076;102,8;34,6;331,1
2013;3523503;Itatinga;18449;9516;8933;93,9;31,7;18,8
2013;3523602;Itirapina;15699;9244;6455;69,8;33,5;27,8
2013;3523701;Itirapuã;5898;3002;2896;96,5;33,6;36,6
2013;3523800;Itobi;7659;3947;3712;94;34,8;55,1
2013;3523909;Itu;158199;78010;80189;102,8;33,9;246,9
2013;3524006;Itupeva;51189;25927;25262;97,4;31,6;254,8
2013;3524105;Ituverava;38518;18747;19771;105,5;36,1;54,7
2013;3524204;Jaborandi;6562;3303;3259;98,7;35,1;24
2013;3524303;Jaboticabal;71938;34772;37166;106,9;36;101,8
2013;3524402;Jacareí;219289;106750;112539;105,4;34,2;472,3
2013;3524501;Jaci;6128;3121;3007;96,3;33,7;42,2
2013;3524600;Jacupiranga;16962;8592;8370;97,4;33,3;24,1
2013;3524709;Jaguariúna;47895;23650;24245;102,5;33,8;338,7
2013;3524808;Jales;47641;23235;24406;105;37,8;129,3
2013;3524907;Jambeiro;5599;2875;2724;94,7;34,2;30,4
2013;3525003;Jandira;110873;54191;56682;104,6;31;6354,1
2013;3525102;Jardinópolis;39483;20014;19469;97,3;33,6;78,7
2013;3525201;Jarinu;27203;13692;13511;98,7;33,2;131,1
2013;3525300;Jaú;131968;64457;67511;104,7;35,6;192,1
2013;3525409;Jeriquara;3345;1721;1624;94,4;32,4;23,6
2013;3525508;Joanópolis;12041;6076;5965;98,2;36,1;32,2
2013;3525607;João Ramalho;4214;2124;2090;98,4;33,2;10,1
2013;3525706;José Bonifácio;33765;16802;16963;101;35,1;39,3
2013;3525805;Júlio Mesquita;4404;2161;2243;103,8;34,5;34,4
2013;3525854;Jumirim;2870;1465;1405;95,9;33,6;50,6
2013;3525904;Jundiaí;388079;188398;199681;106;36;900
2013;3526001;Junqueirópolis;19202;10132;9070;89,5;37,3;33
2013;3526100;Juquiá;18795;9503;9292;97,8;34;23,1
2013;3526209;Juquitiba;28476;14397;14079;97,8;32,4;54,5
2013;3526308;Lagoinha;4902;2503;2399;95,8;37,8;19,2
2013;3526407;Laranjal Paulista;25497;12549;12948;103,2;35,7;66,4
2013;3526506;Lavínia;9002;6427;2575;40,1;35;16,7
2013;3526605;Lavrinhas;6774;3397;3377;99,4;31,6;40,5
2013;3526704;Leme;93724;46764;46960;100,4;33,6;232,6
2013;3526803;Lençóis Paulista;62797;31119;31678;101,8;33,9;77,6
2013;3526902;Limeira;280472;137568;142904;103,9;35;483
2013;3527009;Lindóia;6801;3368;3433;101,9;35,7;139,5
2013;3527108;Lins;72499;35098;37401;106,6;36,3;127,2
2013;3527207;Lorena;83308;40141;43167;107,5;34,8;201,1
2013;3527256;Lourdes;2093;1078;1015;94,2;37,7;18,4
2013;3527306;Louveira;40551;20440;20111;98,4;31,4;727,5
2013;3527405;Lucélia;20028;10747;9281;86,4;36,6;63,6
2013;3527504;Lucianópolis;2271;1133;1138;100,4;35,9;12
2013;3527603;Luís Antônio;11550;5907;5643;95,5;31,1;19,3
2013;3527702;Luiziânia;4946;2536;2410;95;34,8;29,7
2013;3527801;Lupércio;4279;2085;2194;105,2;34,6;27,6
2013;3527900;Lutécia;2725;1360;1365;100,4;35,9;5,7
2013;3528007;Macatuba;16495;8244;8251;100,1;34;73,5
2013;3528106;Macaubal;7595;3827;3768;98,5;38,7;30,6
2013;3528205;Macedônia;3758;1885;1873;99,4;38,4;11,5
2013;3528304;Magda;3226;1645;1581;96,1;39;10,3
2013;3528403;Mairinque;45074;22530;22544;100,1;33,3;214,5
2013;3528502;Mairiporã;84397;42530;41867;98,4;33,4;263,2
2013;3528601;Manduri;9250;4628;4622;99,9;35,7;40,4
2013;3528700;Marabá Paulista;4767;3008;1759;58,5;34,1;5,2
2013;3528809;Maracaí;13224;6591;6633;100,6;35,1;24,8
2013;3528858;Marapoama;2799;1436;1363;94,9;36,6;25,2
2013;3528908;Mariápolis;3828;1958;1870;95,5;36,6;20,5
2013;3529005;Marília;222282;107197;115085;107,4;35,9;189,9
2013;3529104;Marinópolis;2075;1047;1028;98,2;37;26,7
2013;3529203;Martinópolis;24455;12684;11771;92,8;35,7;19,5
2013;3529302;Matão;77621;38378;39243;102,3;35,3;147,9
2013;3529401;Mauá;418828;204293;214535;105;32,5;6762,1
2013;3529500;Mendonça;4993;2527;2466;97,6;36,8;25,6
2013;3529609;Meridiano;4048;1985;2063;103,9;37,3;17,7
2013;3529658;Mesópolis;1897;964;933;96,8;36,4;12,8
2013;3529708;Miguelópolis;20314;10090;10224;101,3;33,6;24,7
2013;3529807;Mineiros do Tietê;11909;5926;5983;101;34,8;55,8
2013;3529906;Miracatu;20173;10171;10002;98,3;32,7;20,1
2013;3530003;Mira Estrela;2888;1438;1450;100,8;38,4;13,3
2013;3530102;Mirandópolis;27761;15342;12419;80,9;37,5;30,3
2013;3530201;Mirante do Paranapanema;16929;8557;8372;97,8;36,2;13,7
2013;3530300;Mirassol;56174;27485;28689;104,4;36,1;231
2013;3530409;Mirassolândia;4379;2229;2150;96,5;36,2;26,4
2013;3530508;Mococa;66898;33214;33684;101,4;36,1;78,2
2013;3530607;Mogi das Cruzes;404123;196276;207847;105,9;33,3;567,2
2013;3530706;Mogi Guaçu;141713;70028;71685;102,4;34,8;174,4
2013;3530805;Mogi Mirim;88361;43385;44976;103,7;35,9;177,5
2013;3530904;Mombuca;3381;1705;1676;98,3;33;25,3
2013;3531001;Monções;2099;1076;1023;95,1;39,5;20,1
2013;3531100;Mongaguá;50315;25241;25074;99,3;35,5;352,5
2013;3531209;Monte Alegre do Sul;7547;3760;3787;100,7;37,6;68,4
2013;3531308;Monte Alto;47057;23153;23904;103,2;37;135,6
2013;3531407;Monte Aprazível;21912;10850;11062;102;37,1;44,2
2013;3531506;Monte Azul Paulista;18826;9443;9383;99,4;36,2;71,5
2013;3531605;Monte Castelo;4092;2029;2063;101,7;38,3;17,5
2013;3531704;Monteiro Lobato;4152;2141;2011;93,9;35,8;12,5
2013;3531803;Monte Mor;52799;26310;26489;100,7;32,2;219,5
2013;3531902;Morro Agudo;29062;14696;14366;97,8;32,2;20,9
2013;3532009;Morungaba;12271;6108;6163;100,9;34;83,6
2013;3532058;Motuca;4218;2131;2087;97,9;34,2;18,4
2013;3532108;Murutinga do Sul;4086;2044;2042;99,9;39,6;16,3
2013;3532157;Nantes;2712;1348;1364;101,2;32,5;9,5
2013;3532207;Narandiba;4641;2339;2302;98,4;32,7;13
2013;3532306;Natividade da Serra;6772;3532;3240;91,7;37,4;8,1
2013;3532405;Nazaré Paulista;16933;8692;8241;94,8;35,2;51,9
2013;3532504;Neves Paulista;9003;4472;4531;101,3;39,3;41,1
2013;3532603;Nhandeara;10538;5155;5383;104,4;39,6;24,2
2013;3532702;Nipoã;4385;2299;2086;90,7;34;31,9
2013;3532801;Nova Aliança;6077;3007;3070;102,1;36,6;27,9
2013;3532827;Nova Campina;8506;4314;4192;97,2;29,9;22,1
2013;3532843;Nova Canaã Paulista;2100;1069;1031;96,4;41,3;16,9
2013;3532868;Nova Castilho;1121;555;566;102;36;6,1
2013;3532900;Nova Europa;9345;4676;4669;99,9;33,5;58,3
2013;3533007;Nova Granada;19254;9661;9593;99,3;35,5;36,2
2013;3533106;Nova Guataporanga;2173;1086;1087;100,1;38,7;63,6
2013;3533205;Nova Independência;3447;1750;1697;97;32,9;13
2013;3533254;Novais;4570;2421;2149;88,8;31,6;38,8
2013;3533304;Nova Luzitânia;3325;1731;1594;92,1;35;45
2013;3533403;Nova Odessa;53954;26620;27334;102,7;34,6;731,2
2013;3533502;Novo Horizonte;37078;18448;18630;101;36,1;39,8
2013;3533601;Nuporanga;6952;3467;3485;100,5;35,5;20
2013;3533700;Ocauçu;4214;2160;2054;95,1;35,5;14
2013;3533809;Óleo;2638;1328;1310;98,6;37,9;13,3
2013;3533908;Olímpia;51476;25303;26173;103,4;36;64,1
2013;3534005;Onda Verde;4102;2100;2002;95,3;34,1;16,9
2013;3534104;Oriente;6126;2983;3143;105,4;37;28
2013;3534203;Orindiúva;5780;2933;2847;97,1;32,2;23,4
2013;3534302;Orlândia;39641;19364;20277;104,7;35;135,9
2013;3534401;Osasco;685623;328833;356790;108,5;33,4;10555,5
2013;3534500;Oscar Bressane;2545;1224;1321;107,9;39,6;11,5
2013;3534609;Osvaldo Cruz;31083;15591;15492;99,4;38,1;125,3
2013;3534708;Ourinhos;103766;50106;53660;107,1;35,4;350,8
2013;3534757;Ouroeste;8918;4436;4482;101;35,4;30,9
2013;3534807;Ouro Verde;7856;3864;3992;103,3;34,7;29,4
2013;3534906;Pacaembu;13675;8266;5409;65,4;37,3;40,3
2013;3535002;Palestina;11161;5623;5538;98,5;37,1;16
2013;3535101;Palmares Paulista;10652;5603;5049;90,1;31,1;129,7
2013;3535200;Palmeira d'Oeste;9443;4732;4711;99,6;39,4;29,6
2013;3535309;Palmital;20907;10206;10701;104,9;37,5;38,1
2013;3535408;Panorama;14767;7375;7392;100,2;33,5;41,5
2013;3535507;Paraguaçu Paulista;42129;21149;20980;99,2;34,9;42,1
2013;3535606;Paraibuna;17540;8903;8637;97;34,8;21,7
2013;3535705;Paraíso;5976;3043;2933;96,4;36,2;38,5
2013;3535804;Paranapanema;18227;9282;8945;96,4;32,6;17,9
2013;3535903;Paranapuã;3861;1961;1900;96,9;36,5;27,5
2013;3536000;Parapuã;10810;5476;5334;97,4;37,9;29,5
2013;3536109;Pardinho;5994;3045;2949;96,8;33,5;28,6
2013;3536208;Pariquera-Açu;18675;9249;9426;101,9;33,8;52
2013;3536257;Parisi;2232;1131;1101;97,3;37,9;26,3
2013;3536307;Patrocínio Paulista;13411;6796;6615;97,3;33,7;22,2
2013;3536406;Paulicéia;6761;3476;3285;94,5;33,3;18,1
2013;3536505;Paulínia;88973;43850;45123;102,9;32,9;641,1
2013;3536570;Paulistânia;1853;952;901;94,6;35,1;7,2
2013;3536604;Paulo de Faria;8359;4190;4169;99,5;35,6;11,3
2013;3536703;Pederneiras;42423;21265;21158;99,5;33,9;58,3
2013;3536802;Pedra Bela;5968;3119;2849;91,3;36,3;37,6
2013;3536901;Pedranópolis;2633;1345;1288;95,8;39,1;10,1
2013;3537008;Pedregulho;15695;7954;7741;97,3;33,9;22
2013;3537107;Pedreira;42018;20775;21243;102,3;35,2;386,1
2013;3537156;Pedrinhas Paulista;2904;1440;1464;101,7;36,6;19,1
2013;3537206;Pedro de Toledo;10538;5344;5194;97,2;34,2;15,7
2013;3537305;Penápolis;59392;28897;30495;105,5;36,6;83,5
2013;3537404;Pereira Barreto;24934;12211;12723;104,2;36,3;25,6
2013;3537503;Pereiras;7766;3919;3847;98,2;35;34,8
2013;3537602;Peruíbe;62143;30227;31916;105,6;35,3;190,5
2013;3537701;Piacatu;5380;2705;2675;98,9;36,3;23,1
2013;3537800;Piedade;52441;26641;25800;96,8;34,7;70,2
2013;3537909;Pilar do Sul;26788;13604;13184;96,9;33,7;39,3
2013;3538006;Pindamonhangaba;151833;74411;77422;104;33,5;207,6
2013;3538105;Pindorama;14958;7600;7358;96,8;37,1;80,9
2013;3538204;Pinhalzinho;13621;6836;6785;99,3;36,8;88,1
2013;3538303;Piquerobi;3492;1715;1777;103,6;36,9;7,2
2013;3538501;Piquete;13802;6662;7140;107,2;36,6;78,4
2013;3538600;Piracaia;25410;12593;12817;101,8;35,6;65,9
2013;3538709;Piracicaba;379558;185201;194357;104,9;35,1;275,4
2013;3538808;Piraju;28831;13982;14849;106,2;36,2;57,1
2013;3538907;Pirajuí;22710;12386;10324;83,4;36;27,6
2013;3539004;Pirangi;10698;5407;5291;97,9;37,3;49,6
2013;3539103;Pirapora do Bom Jesus;16291;8099;8192;101,1;30,1;150,2
2013;3539202;Pirapozinho;24921;12176;12745;104,7;35,2;52,2
2013;3539301;Pirassununga;71099;34676;36423;105;36,2;97,8
2013;3539400;Piratininga;12822;6323;6499;102,8;36,2;31,9
2013;3539509;Pitangueiras;35102;17795;17307;97,3;32,2;81,5
2013;3539608;Planalto;4469;2288;2181;95,3;33,9;15,4
2013;3539707;Platina;3176;1639;1537;93,8;34,7;9,7
2013;3539806;Poá;106148;51277;54871;107;32,6;6148,6
2013;3539905;Poloni;5472;2695;2777;103;37,7;40,5
2013;3540002;Pompéia;20073;9849;10224;103,8;36;25,6
2013;3540101;Pongaí;3462;1774;1688;95,2;39;18,9
2013;3540200;Pontal;39675;20647;19028;92,2;30,8;111,3
2013;3540259;Pontalinda;4087;2174;1913;88;34,1;19,5
2013;3540309;Pontes Gestal;2518;1255;1263;100,6;37,2;11,6
2013;3540408;Populina;4228;2130;2098;98,5;38,3;13,4
2013;3540507;Porangaba;8890;4560;4330;95;37,2;33,5
2013;3540606;Porto Feliz;50816;25595;25221;98,5;34,4;91,3
2013;3540705;Porto Ferreira;51884;25626;26258;102,5;35,2;211,9
2013;3540754;Potim;19665;11109;8556;77;31;440,5
2013;3540804;Potirendaba;16199;8170;8029;98,3;36,7;47,3
2013;3540853;Pracinha;2790;2019;771;38,2;32,7;44,2
2013;3540903;Pradópolis;17377;8800;8577;97,5;33,1;103,8
2013;3541000;Praia Grande;284594;136384;148210;108,7;34,2;1901,7
2013;3541059;Pratânia;4718;2414;2304;95,4;32;26,9
2013;3541109;Presidente Alves;4067;2012;2055;102,1;36,4;14,2
2013;3541208;Presidente Bernardes;13861;7052;6809;96,6;38,5;18,5
2013;3541307;Presidente Epitácio;41032;20025;21007;104,9;34,8;32,6
2013;3541406;Presidente Prudente;212411;102093;110318;108,1;36,1;378,9
2013;3541505;Presidente Venceslau;37422;18522;18900;102;37,4;49,6
2013;3541604;Promissão;35741;17735;18006;101,5;34,8;45,9
2013;3541653;Quadra;3286;1723;1563;90,7;35,4;16
2013;3541703;Quatá;12902;6435;6467;100,5;34,2;19,8
2013;3541802;Queiroz;2920;1474;1446;98,1;32,4;12,4
2013;3541901;Queluz;10790;5461;5329;97,6;33,3;43,3
2013;3542008;Quintana;6246;3077;3169;103;35,4;19,6
2013;3542107;Rafard;8700;4302;4398;102,2;34,7;71,5
2013;3542206;Rancharia;28830;14113;14717;104,3;35,8;18,2
2013;3542305;Redenção da Serra;4055;2116;1939;91,6;36,3;13,1
2013;3542404;Regente Feijó;18940;9390;9550;101,7;35,9;71,9
2013;3542503;Reginópolis;7400;4683;2717;58;33,6;18
2013;3542602;Registro;55853;27521;28332;102,9;33,8;77,3
2013;3542701;Restinga;6525;3258;3267;100,3;31,9;26,6
2013;3542800;Ribeira;3314;1712;1602;93,6;35,2;9,9
2013;3542909;Ribeirão Bonito;11943;5985;5958;99,5;34;25,3
2013;3543006;Ribeirão Branco;18351;9415;8936;94,9;30,8;26,3
2013;3543105;Ribeirão Corrente;4371;2247;2124;94,5;32,5;29,5
2013;3543204;Ribeirão do Sul;4502;2264;2238;98,9;37;22,2
2013;3543238;Ribeirão dos Índios;2160;1072;1088;101,5;38,6;11
2013;3543253;Ribeirão Grande;7497;3841;3656;95,2;34;22,5
2013;3543303;Ribeirão Pires;114303;55761;58542;105;34,8;1154,9
2013;3543402;Ribeirão Preto;629139;301290;327849;108,8;35,3;966,5
2013;3543501;Riversul;6040;3011;3029;100,6;35,6;15,7
2013;3543600;Rifaina;3582;1794;1788;99,7;36,3;22
2013;3543709;Rincão;10144;5093;5051;99,2;34,1;32
2013;3543808;Rinópolis;9815;4957;4858;98;37,9;27,4
2013;3543907;Rio Claro;190309;92440;97869;105,9;35,7;381,8
2013;3544004;Rio das Pedras;29993;15111;14882;98,5;32,7;132,3
2013;3544103;Rio Grande da Serra;44267;21889;22378;102,2;31,7;1218,1
2013;3544202;Riolândia;10513;6106;4407;72,2;33,4;16,6
2013;3544251;Rosana;19266;9572;9694;101,3;34,1;25,9
2013;3544301;Roseira;9947;5010;4937;98,5;33,2;76,6
2013;3544400;Rubiácea;2713;1376;1337;97,2;34;11,5
2013;3544509;Rubinéia;3101;1535;1566;102;39,8;12,8
2013;3544608;Sabino;5239;2608;2631;100,9;37,5;17,2
2013;3544707;Sagres;2419;1192;1227;102,9;36,3;16,4
2013;3544806;Sales;5739;2906;2833;97,5;36,9;18,6
2013;3544905;Sales Oliveira;10818;5324;5494;103,2;35,7;35,4
2013;3545001;Salesópolis;15602;7849;7753;98,8;34,1;36,7
2013;3545100;Salmourão;4824;2470;2354;95,3;35,6;27,9
2013;3545159;Saltinho;7341;3642;3699;101,6;36,5;73,6
2013;3545209;Salto;112528;55487;57041;102,8;34;845,7
2013;3545308;Salto de Pirapora;41136;20448;20688;101,2;33,9;146,7
2013;3545407;Salto Grande;8888;4380;4508;102,9;35,7;47,2
2013;3545506;Sandovalina;3704;1879;1825;97,1;33;8,1
2013;3545605;Santa Adélia;14268;7104;7164;100,8;35,7;43,2
2013;3545704;Santa Albertina;5906;2982;2924;98,1;38,8;21,7
2013;3545803;Santa Bárbara d'Oeste;181251;89655;91596;102,2;35;668,7
2013;3546009;Santa Branca;13908;6942;6966;100,3;35,4;51,1
2013;3546108;Santa Clara d'Oeste;2214;1133;1081;95,4;37,5;12,1
2013;3546207;Santa Cruz da Conceição;4100;2023;2077;102,7;37,5;27,3
2013;3546256;Santa Cruz da Esperança;2027;1006;1021;101,5;35;13,7
2013;3546306;Santa Cruz das Palmeiras;29834;15074;14760;97,9;33,6;101
2013;3546405;Santa Cruz do Rio Pardo;44639;21830;22809;104,5;35,7;40
2013;3546504;Santa Ernestina;5746;2933;2813;95,9;32,7;42,7
2013;3546603;Santa Fé do Sul;30583;14733;15850;107,6;37,6;148,1
2013;3546702;Santa Gertrudes;22180;11224;10956;97,6;31,6;225,7
2013;3546801;Santa Isabel;51309;25607;25702;100,4;33,7;141,2
2013;3546900;Santa Lúcia;8070;4029;4041;100,3;33;52,5
2013;3547007;Santa Maria da Serra;5366;2716;2650;97,6;33;21,2
2013;3547106;Santa Mercedes;2880;1438;1442;100,3;35,7;17,3
2013;3547205;Santana da Ponte Pensa;1645;841;804;95,6;41,9;12,7
2013;3547304;Santana de Parnaíba;119591;58773;60818;103,5;31,9;664,6
2013;3547403;Santa Rita d'Oeste;2616;1293;1323;102,3;41;12,5
2013;3547502;Santa Rita do Passa Quatro;26137;12614;13523;107,2;39,1;34,7
2013;3547601;Santa Rosa de Viterbo;23858;11715;12143;103,7;35,9;82,7
2013;3547650;Santa Salete;1494;755;739;97,9;39,9;18,9
2013;3547700;Santo Anastácio;19906;9673;10233;105,8;37,3;36
2013;3547809;Santo André;697094;333536;363558;109;36,3;3965,7
2013;3547908;Santo Antônio da Alegria;6433;3316;3117;94;36,3;20,7
2013;3548005;Santo Antônio de Posse;21314;10723;10591;98,8;33,4;138,3
2013;3548054;Santo Antônio do Aracanguá;7844;3966;3878;97,8;34,9;6
2013;3548104;Santo Antônio do Jardim;5982;3049;2933;96,2;36,5;54,4
2013;3548203;Santo Antônio do Pinhal;6674;3365;3309;98,3;34,6;50,2
2013;3548302;Santo Expedito;2836;1415;1421;100,4;37,5;30
2013;3548401;Santópolis do Aguapeí;4206;2113;2093;99,1;33,7;32,9
2013;3548500;Santos;421115;192274;228841;119;39,6;1498,5
2013;3548609;São Bento do Sapucaí;10811;5423;5388;99,4;36,6;42,8
2013;3548708;São Bernardo do Campo;780189;375515;404674;107,8;34,4;1905,1
2013;3548807;São Caetano do Sul;153774;70771;83003;117,3;40;10030,4
2013;3548906;São Carlos;230121;112719;117402;104,2;35,6;202,4
2013;3549003;São Francisco;2761;1382;1379;99,8;38,9;36,5
2013;3549102;São João da Boa Vista;85982;41604;44378;106,7;37;166,5
2013;3549201;São João das Duas Pontes;2593;1298;1295;99,8;37;20
2013;3549250;São João de Iracema;1789;904;885;97,9;36,4;10
2013;3549300;São João do Pau d'Alho;2145;1068;1077;100,8;40,5;18,2
2013;3549409;São Joaquim da Barra;47214;23073;24141;104,6;35;114,9
2013;3549508;São José da Bela Vista;8240;4207;4033;95,9;32,3;29,8
2013;3549607;São José do Barreiro;4046;2036;2010;98,7;34,8;7,1
2013;3549706;São José do Rio Pardo;52065;25493;26572;104,2;36,6;124,1
2013;3549805;São José do Rio Preto;426819;204672;222147;108,5;36,4;988,1
2013;3549904;São José dos Campos;648368;316437;331931;104,9;33,7;589,7
2013;3549953;São Lourenço da Serra;14514;7347;7167;97,6;33,2;77,8
2013;3550001;São Luiz do Paraitinga;10424;5315;5109;96,1;36,9;16,9
2013;3550100;São Manuel;38182;18694;19488;104,2;34,9;58,7
2013;3550209;São Miguel Arcanjo;31757;16123;15634;97;33,2;34,1
2013;3550308;São Paulo;11351446;5368644;5982802;111,4;34,9;7462,2
2013;3550407;São Pedro;33365;16246;17119;105,4;36,6;54,6
2013;3550506;São Pedro do Turvo;7206;3670;3536;96,3;34,6;9,9
2013;3550605;São Roque;79027;38810;40217;103,6;35,2;257,5
2013;3550704;São Sebastião;75964;37735;38229;101,3;31,9;188,8
2013;3550803;São Sebastião da Grama;11763;5971;5792;97;35,6;46,6
2013;3550902;São Simão;14209;6993;7216;103,2;35,9;23
2013;3551009;São Vicente;333768;160474;173294;108;34;2252,9
2013;3551108;Sarapuí;9404;4776;4628;96,9;33,9;26,7
2013;3551207;Sarutaiá;3658;1835;1823;99,3;35;25,8
2013;3551306;Sebastianópolis do Sul;3067;1524;1543;101,2;37,6;18,3
2013;3551405;Serra Azul;11642;7187;4455;62;33,2;41,1
2013;3551504;Serrana;40215;20062;20153;100,5;31,5;319,1
2013;3551603;Serra Negra;27331;13290;14041;105,7;38;134,2
2013;3551702;Sertãozinho;114649;56640;58009;102,4;33,6;284,4
2013;3551801;Sete Barras;12998;6664;6334;95;33,3;12,2
2013;3551900;Severínia;15326;7939;7387;93;32,8;109,1
2013;3552007;Silveiras;5908;2979;2929;98,3;34,4;14,2
2013;3552106;Socorro;37624;18629;18995;102;37,9;83,8
2013;3552205;Sorocaba;621354;303124;318230;105;34,2;1381,2
2013;3552304;Sud Mennucci;7442;3733;3709;99,4;34,9;12,5
2013;3552403;Sumaré;251175;124308;126867;102,1;32,4;1636,7
2013;3552502;Suzano;274334;134100;140234;104,6;32,1;1330,2
2013;3552551;Suzanápolis;3407;1753;1654;94,4;35,9;10,3
2013;3552601;Tabapuã;11382;5716;5666;99,1;37,2;32,9
2013;3552700;Tabatinga;14722;7501;7221;96,3;34,2;39,9
2013;3552809;Taboão da Serra;252892;120731;132161;109,5;32,1;12404,1
2013;3552908;Taciba;5861;2918;2943;100,9;34,6;9,7
2013;3553005;Taguaí;11297;5613;5684;101,3;32,5;77,7
2013;3553104;Taiaçu;5842;2950;2892;98;35,6;54,6
2013;3553203;Taiúva;5733;2936;2797;95,3;37,5;43,3
2013;3553302;Tambaú;22267;11062;11205;101,3;35,5;39,6
2013;3553401;Tanabi;24456;12182;12274;100,8;37,4;32,7
2013;3553500;Tapiraí;8054;4061;3993;98,3;32,6;10,7
2013;3553609;Tapiratiba;12547;6200;6347;102,4;35,8;56,5
2013;3553658;Taquaral;2744;1377;1367;99,3;35,6;50,9
2013;3553708;Taquaritinga;53727;26431;27296;103,3;35,7;90,4
2013;3553807;Taquarituba;22904;11513;11391;98,9;34,4;51,1
2013;3553856;Taquarivaí;5557;2789;2768;99,2;30,4;24
2013;3553906;Tarabai;6606;3278;3328;101,5;33,4;32,8
2013;3553955;Tarumã;13426;6810;6616;97,2;32,7;44,3
2013;3554003;Tatuí;111854;55117;56737;102,9;33,9;213,6
2013;3554102;Taubaté;287364;140387;146977;104,7;34,5;459,8
2013;3554201;Tejupá;4675;2394;2281;95,3;32,8;15,8
2013;3554300;Teodoro Sampaio;21616;10754;10862;101;32,9;13,9
2013;3554409;Terra Roxa;8381;4224;4157;98,4;35;37,8
2013;3554508;Tietê;37078;18345;18733;102,1;35,3;91,7
2013;3554607;Timburi;2620;1336;1284;96,1;37,7;13,3
2013;3554656;Torre de Pedra;2204;1144;1060;92,7;37,3;30,9
2013;3554706;Torrinha;9298;4679;4619;98,7;37,1;29,5
2013;3554755;Trabiju;1579;792;787;99,4;33,7;24,9
2013;3554805;Tremembé;43586;23110;20476;88,6;33,7;228,1
2013;3554904;Três Fronteiras;5790;2904;2886;99,4;38,1;38,2
2013;3554953;Tuiuti;6158;3123;3035;97,2;37,8;48,6
2013;3555000;Tupã;63705;30743;32962;107,2;38;101,4
2013;3555109;Tupi Paulista;14691;7718;6973;90,3;39,7;60
2013;3555208;Turiúba;1911;976;935;95,8;39,7;12,5
2013;3555307;Turmalina;1905;941;964;102,4;41,8;12,9
2013;3555356;Ubarana;5334;2735;2599;95;32,3;25,4
2013;3555406;Ubatuba;82120;40780;41340;101,4;32,9;116
2013;3555505;Ubirajara;4598;2376;2222;93,5;34,6;16,3
2013;3555604;Uchoa;9752;4832;4920;101,8;37,5;38,6
2013;3555703;União Paulista;1615;826;789;95,5;34,5;20,4
2013;3555802;Urânia;8842;4384;4458;101,7;38,2;42,3
2013;3555901;Uru;1298;659;639;97;37,8;8,8
2013;3556008;Urupês;13024;6453;6571;101,8;38,2;40,2
2013;3556107;Valentim Gentil;11764;5901;5863;99,4;34,9;78,6
2013;3556206;Valinhos;111692;54946;56746;103,3;35,9;751,9
2013;3556305;Valparaíso;23035;12692;10343;81,5;33,8;26,9
2013;3556354;Vargem;9190;4713;4477;95;35,4;64,4
2013;3556404;Vargem Grande do Sul;39482;19560;19922;101,9;35;147,8
2013;3556453;Vargem Grande Paulista;44991;22252;22739;102,2;32,5;1058,9
2013;3556503;Várzea Paulista;109918;54764;55154;100,7;32,1;3129,8
2013;3556602;Vera Cruz;10643;5231;5412;103,5;37;43
2013;3556701;Vinhedo;66948;33012;33936;102,8;35,1;827
2013;3556800;Viradouro;17425;8732;8693;99,6;34,6;80
2013;3556909;Vista Alegre do Alto;7179;3675;3504;95,3;33,4;75,2
2013;3556958;Vitória Brasil;1766;905;861;95,1;36,8;35,4
2013;3557006;Votorantim;113806;56271;57535;102,2;32,9;617,9
2013;3557105;Votuporanga;87696;42657;45039;105,6;36,9;208,5
2013;3557154;Zacarias;2441;1225;1216;99,3;36,8;7,7
2013;3557204;Chavantes;12238;6053;6185;102,2;34,8;64,8
2013;3557303;Estiva Gerbi;10373;5226;5147;98,5;33,7;139,9
2014;3500105;Adamantina;34185;16528;17657;106,8;38,8;83
2014;3500204;Adolfo;3829;1915;1914;99,9;37,5;18,1
2014;3500303;Aguaí;32206;16140;16066;99,5;34,2;67,9
2014;3500402;Águas da Prata;7565;3705;3860;104,2;39,5;53
2014;3500501;Águas de Lindóia;17623;8610;9013;104,7;37,5;293,1
2014;3500550;Águas de Santa Bárbara;6171;3066;3105;101,3;36,4;15,3
2014;3500600;Águas de São Pedro;2729;1274;1455;114,2;42,7;755,5
2014;3500709;Agudos;35703;17615;18088;102,7;34,2;36,9
2014;3500758;Alambari;5291;2660;2631;98,9;33,6;33,2
2014;3500808;Alfredo Marcondes;4092;2065;2027;98,2;39,5;34,4
2014;3500907;Altair;3722;1962;1760;89,7;33,6;11,9
2014;3501004;Altinópolis;16043;7991;8052;100,8;36,1;17,3
2014;3501103;Alto Alegre;4070;2071;1999;96,5;39,8;12,8
2014;3501152;Alumínio;17110;8587;8523;99,3;32,6;204,6
2014;3501202;Álvares Florence;3928;2009;1919;95,5;41,1;10,8
2014;3501301;Álvares Machado;24875;12228;12647;103,4;35,3;71,6
2014;3501400;Álvaro de Carvalho;4711;3042;1669;54,9;34;30,7
2014;3501509;Alvinlândia;2977;1470;1507;102,5;34,5;35,1
2014;3501608;Americana;219820;107154;112666;105,1;36,5;1641,5
2014;3501707;Américo Brasiliense;34259;17133;17126;100;32,4;278,6
2014;3501806;Américo de Campos;5802;2874;2928;101,9;38,5;22,9
2014;3501905;Amparo;66789;32769;34020;103,8;36,9;150
2014;3502002;Analândia;4373;2225;2148;96,5;35,3;13,4
2014;3502101;Andradina;57135;28190;28945;102,7;37,1;59,3
2014;3502200;Angatuba;22847;11534;11313;98,1;34,4;22,2
2014;3502309;Anhembi;5688;2914;2774;95,2;33,9;7,7
2014;3502408;Anhumas;3828;1897;1931;101,8;35,7;11,9
2014;3502507;Aparecida;34393;16579;17814;107,4;35,5;284,5
2014;3502606;Aparecida d'Oeste;4342;2138;2204;103,1;39,8;24,3
2014;3502705;Apiaí;25187;12594;12593;100;33,2;25,9
2014;3502754;Araçariguama;18515;9389;9126;97,2;31;127,5
2014;3502804;Araçatuba;188501;90322;98179;108,7;37;161,5
2014;3502903;Araçoiaba da Serra;29065;14481;14584;100,7;35,9;113,8
2014;3503000;Aramina;5279;2626;2653;101;36,6;26
2014;3503109;Arandu;6361;3201;3160;98,7;34,3;22,2
2014;3503158;Arapeí;2467;1240;1227;99;36;15,7
2014;3503208;Araraquara;220190;106011;114179;107,7;36,6;219,4
2014;3503307;Araras;123141;60421;62720;103,8;35,7;191
2014;3503356;Arco-Íris;1979;999;980;98,1;37,6;7,5
2014;3503406;Arealva;7953;4027;3926;97,5;38,8;15,7
2014;3503505;Areias;3689;1842;1847;100,3;34,2;12,1
2014;3503604;Areiópolis;10511;5380;5131;95,4;32;122,4
2014;3503703;Ariranha;8328;4210;4118;97,8;36,1;62,8
2014;3503802;Artur Nogueira;46686;23223;23463;101;33,3;262,2
2014;3503901;Arujá;78871;38724;40147;103,7;32,6;820,1
2014;3503950;Aspásia;1816;916;900;98,3;38,5;26,2
2014;3504008;Assis;97557;47325;50232;106,1;36,5;211,8
2014;3504107;Atibaia;137520;67254;70266;104,5;35,3;287,4
2014;3504206;Auriflama;14113;7026;7087;100,9;37,5;32,5
2014;3504305;Avaí;4804;2410;2394;99,3;34,5;8,9
2014;3504404;Avanhandava;11339;6257;5082;81,2;32,9;33,5
2014;3504503;Avaré;86439;42868;43571;101,6;35,1;71,3
2014;3504602;Bady Bassitt;18713;9247;9466;102,4;34,8;169,5
2014;3504701;Balbinos;3740;3032;708;23,4;34,7;40,8
2014;3504800;Bálsamo;8680;4242;4438;104,6;38,1;57,9
2014;3504909;Bananal;10189;5011;5178;103,3;35,8;16,5
2014;3505005;Barão de Antonina;3248;1641;1607;97,9;35,6;21,2
2014;3505104;Barbosa;6289;3142;3147;100,2;34,7;30,6
2014;3505203;Bariri;31679;15745;15934;101,2;36,5;71,3
2014;3505302;Barra Bonita;35213;17137;18076;105,5;37,5;234,6
2014;3505351;Barra do Chapéu;5225;2739;2486;90,8;32,8;12,9
2014;3505401;Barra do Turvo;7492;3895;3597;92,3;33,9;7,4
2014;3505500;Barretos;115772;55804;59968;107,5;36;73,9
2014;3505609;Barrinha;29779;14880;14899;100,1;31,1;203,9
2014;3505708;Barueri;267156;129144;138012;106,9;31,8;4066,3
2014;3505807;Bastos;20855;10220;10635;104,1;35,5;122
2014;3505906;Batatais;57192;28001;29191;104,2;36,2;67,3
2014;3506003;Bauru;356751;172776;183975;106,5;35,7;534,3
2014;3506102;Bebedouro;75735;36808;38927;105,8;36,3;110,9
2014;3506201;Bento de Abreu;2687;1365;1322;96,8;34,8;8,9
2014;3506300;Bernardino de Campos;11058;5525;5533;100,1;37,3;45,3
2014;3506359;Bertioga;53087;26537;26550;100;31,3;108
2014;3506409;Bilac;7175;3539;3636;102,7;38,1;45,4
2014;3506508;Birigui;112644;54839;57805;105,4;36;212,5
2014;3506607;Biritiba Mirim;29078;14615;14463;99;33,5;91,6
2014;3506706;Boa Esperança do Sul;13532;6771;6761;99,9;33,4;19,6
2014;3506805;Bocaina;11046;5468;5578;102;35,1;30,4
2014;3506904;Bofete;9936;5065;4871;96,2;35,8;15,2
2014;3507001;Boituva;52561;26276;26285;100;33,6;211,1
2014;3507100;Bom Jesus dos Perdões;20407;10222;10185;99,6;33,3;188,3
2014;3507159;Bom Sucesso de Itararé;3551;1816;1735;95,5;30;26,6
2014;3507209;Borá;848;434;414;95,4;35;7,1
2014;3507308;Boracéia;4435;2258;2177;96,4;34,1;36,3
2014;3507407;Borborema;14510;7288;7222;99,1;37,1;26,3
2014;3507456;Borebi;2433;1202;1231;102,4;32,9;7
2014;3507506;Botucatu;133509;64590;68919;106,7;35,6;90
2014;3507605;Bragança Paulista;156920;76757;80163;104,4;35,4;306,1
2014;3507704;Braúna;5130;2579;2551;98,9;36,6;26,3
2014;3507753;Brejo Alegre;2591;1333;1258;94,4;35,6;24,5
2014;3507803;Brodowski;22503;11118;11385;102,4;34,9;80,8
2014;3507902;Brotas;22395;11038;11357;102,9;35,3;20,3
2014;3508009;Buri;19212;9764;9448;96,8;31,8;16,1
2014;3508108;Buritama;16168;8021;8147;101,6;36,9;49,5
2014;3508207;Buritizal;4165;2098;2067;98,5;36,7;15,6
2014;3508306;Cabrália Paulista;4375;2223;2152;96,8;34,3;18,2
2014;3508405;Cabreúva;43350;21803;21547;98,8;31,6;166,6
2014;3508504;Caçapava;89013;43932;45081;102,6;34,7;241,2
2014;3508603;Cachoeira Paulista;30702;14978;15724;105;35,3;106,6
2014;3508702;Caconde;18076;9035;9041;100,1;35,9;38,6
2014;3508801;Cafelândia;16722;8177;8545;104,5;36,4;18,2
2014;3508900;Caiabu;4011;2040;1971;96,6;37,2;15,8
2014;3509007;Caieiras;89635;43707;45928;105,1;32,8;918
2014;3509106;Caiuá;5188;2852;2336;81,9;36,4;9,4
2014;3509205;Cajamar;73443;36460;36983;101,4;31,1;559
2014;3509254;Cajati;28622;14438;14184;98,2;32,2;63
2014;3509304;Cajobi;9613;4877;4736;97,1;36,5;54,3
2014;3509403;Cajuru;23580;11779;11801;100,2;34,5;35,7
2014;3509452;Campina do Monte Alegre;5696;2901;2795;96,3;34,6;30,9
2014;3509502;Campinas;1103425;530368;573057;108;35,8;1388,7
2014;3509601;Campo Limpo Paulista;75822;37203;38619;103,8;33,4;954,9
2014;3509700;Campos do Jordão;47700;23347;24353;104,3;33,1;164,5
2014;3509809;Campos Novos Paulista;4677;2390;2287;95,7;35;9,7
2014;3509908;Cananéia;12311;6122;6189;101,1;34,3;9,9
2014;3509957;Canas;4576;2302;2274;98,8;31,9;85,9
2014;3510005;Cândido Mota;29878;14615;15263;104,4;36,3;50,1
2014;3510104;Cândido Rodrigues;2765;1366;1399;102,4;39,5;39
2014;3510153;Canitar;5004;2509;2495;99,4;30,9;87,1
2014;3510203;Capão Bonito;46509;23145;23364;100,9;33,5;28,4
2014;3510302;Capela do Alto;19284;10140;9144;90,2;32,9;113,5
2014;3510401;Capivari;49173;24469;24704;101;33,9;152,3
2014;3510500;Caraguatatuba;112190;55269;56921;103;33,9;231,3
2014;3510609;Carapicuíba;377222;182548;194674;106,6;32,2;10919,5
2014;3510708;Cardoso;11770;5792;5978;103,2;38,2;18,4
2014;3510807;Casa Branca;28423;14946;13477;90,2;36,2;32,9
2014;3510906;Cássia dos Coqueiros;2709;1389;1320;95;37,3;14,1
2014;3511003;Castilho;18823;9349;9474;101,3;35,3;17,7
2014;3511102;Catanduva;114269;55231;59038;106,9;37,3;393,2
2014;3511201;Catiguá;7107;3595;3512;97,7;35,6;47,9
2014;3511300;Cedral;9467;4705;4762;101,2;37,4;47,9
2014;3511409;Cerqueira César;18910;9502;9408;99;34,6;37
2014;3511508;Cerquilho;41414;20415;20999;102,9;35,1;324
2014;3511607;Cesário Lange;16701;8631;8070;93,5;34,1;87,7
2014;3511706;Charqueada;15274;7722;7552;97,8;34,1;86,9
2014;3511904;Clementina;7115;3633;3482;95,8;33,4;42,2
2014;3512001;Colina;17819;8771;9048;103,2;35,5;42,2
2014;3512100;Colômbia;6289;3191;3098;97,1;33,9;8,6
2014;3512209;Conchal;26284;13231;13053;98,7;32,8;143,8
2014;3512308;Conchas;16013;8039;7974;99,2;36,2;34,4
2014;3512407;Cordeirópolis;22265;11128;11137;100,1;34,1;161,8
2014;3512506;Coroados;5339;2659;2680;100,8;35,8;21,6
2014;3512605;Coronel Macedo;4801;2450;2351;96;35,8;15,8
2014;3512704;Corumbataí;3996;2020;1976;97,8;34,7;14,3
2014;3512803;Cosmópolis;59566;29619;29947;101,1;33,3;385,1
2014;3512902;Cosmorama;7704;3881;3823;98,5;38,6;17,4
2014;3513009;Cotia;225437;110050;115387;104,8;32,3;695,8
2014;3513108;Cravinhos;32393;16140;16253;100,7;34,6;104
2014;3513207;Cristais Paulista;8124;4107;4017;97,8;34,4;21,1
2014;3513306;Cruzália;2223;1090;1133;103,9;38,1;14,9
2014;3513405;Cruzeiro;76938;37274;39664;106,4;35,4;251,7
2014;3513504;Cubatão;117649;57998;59651;102,9;32,3;823,4
2014;3513603;Cunha;22033;11242;10791;96;35,9;15,7
2014;3513702;Descalvado;31449;15498;15951;102,9;36,5;41,7
2014;3513801;Diadema;391850;188915;202935;107,4;32,6;12750,5
2014;3513850;Dirce Reis;1677;866;811;93,6;39;19
2014;3513900;Divinolândia;11273;5609;5664;101;38;50,4
2014;3514007;Dobrada;8275;4221;4054;96;31,8;55,3
2014;3514106;Dois Córregos;24833;12382;12451;100,6;35,1;39,2
2014;3514205;Dolcinópolis;2125;1096;1029;93,9;38,9;27,3
2014;3514304;Dourado;8478;4265;4213;98,8;37,6;41,2
2014;3514403;Dracena;44159;21790;22369;102,7;38,3;90,5
2014;3514502;Duartina;12338;6016;6322;105,1;38;46,6
2014;3514601;Dumont;8536;4280;4256;99,4;33,5;76,6
2014;3514700;Echaporã;6308;3108;3200;103;36,1;12,2
2014;3514809;Eldorado;14187;7210;6977;96,8;32,7;8,6
2014;3514908;Elias Fausto;16424;8418;8006;95,1;33,3;81,2
2014;3514924;Elisiário;3134;1630;1504;92,3;36,5;33,3
2014;3514957;Embaúba;2403;1241;1162;93,6;37,1;28,9
2014;3515004;Embu das Artes;245599;119111;126488;106,2;31,2;3488,7
2014;3515103;Embu-Guaçu;64587;32023;32564;101,7;32,7;415
2014;3515129;Emilianópolis;3046;1529;1517;99,2;38;13,5
2014;3515152;Engenheiro Coelho;16931;8741;8190;93,7;30,7;154
2014;3515186;Espírito Santo do Pinhal;41438;20220;21218;104,9;37;106,5
2014;3515194;Espírito Santo do Turvo;4223;2128;2095;98,4;32,2;21,8
2014;3515202;Estrela d'Oeste;8608;4345;4263;98,1;37,4;29,1
2014;3515301;Estrela do Norte;2696;1367;1329;97,2;34,7;10,2
2014;3515350;Euclides da Cunha Paulista;9110;4564;4546;99,6;34;15,9
2014;3515400;Fartura;15812;7677;8135;106;36,2;36,8
2014;3515509;Fernandópolis;67033;32512;34521;106,2;37,8;121,9
2014;3515608;Fernando Prestes;5672;2798;2874;102,7;38,9;33,4
2014;3515657;Fernão;1601;814;787;96,7;36,5;15,9
2014;3515707;Ferraz de Vasconcelos;172523;83998;88525;105,4;31,3;5838,9
2014;3515806;Flora Rica;1677;844;833;98,7;40,4;7,5
2014;3515905;Floreal;2924;1447;1477;102,1;41,7;14,3
2014;3516002;Flórida Paulista;12920;7092;5828;82,2;36;24,7
2014;3516101;Florínea;3208;1723;1485;86,2;36,8;14,2
2014;3516200;Franca;330547;160962;169585;105,4;34,5;545,7
2014;3516309;Francisco Morato;158413;78285;80128;102,4;30,3;3232,9
2014;3516408;Franco da Rocha;136163;69354;66809;96,3;31,8;1025,5
2014;3516507;Gabriel Monteiro;2747;1383;1364;98,6;38,9;19,8
2014;3516606;Gália;6862;3408;3454;101,3;37,9;19,3
2014;3516705;Garça;43077;20892;22185;106,2;36,6;77,5
2014;3516804;Gastão Vidigal;3937;2048;1889;92,2;35,8;21,8
2014;3516853;Gavião Peixoto;4529;2311;2218;96;33,2;18,6
2014;3516903;General Salgado;10627;5313;5314;100;37,8;21,5
2014;3517000;Getulina;10647;5801;4846;83,5;36;15,7
2014;3517109;Glicério;4457;2214;2243;101,3;36,2;16,3
2014;3517208;Guaiçara;10909;5456;5453;99,9;34;39,4
2014;3517307;Guaimbê;5482;2726;2756;101,1;35,2;25,2
2014;3517406;Guaíra;38223;18823;19400;103,1;35,3;30,4
2014;3517505;Guapiaçu;19088;9576;9512;99,3;35,4;58,7
2014;3517604;Guapiara;17832;9051;8781;97;34,2;43,7
2014;3517703;Guará;19546;9666;9880;102,2;33,5;54
2014;3517802;Guaraçaí;8183;4065;4118;101,3;38,9;14,4
2014;3517901;Guaraci;10174;5152;5022;97,5;34,9;15,9
2014;3518008;Guarani d'Oeste;1981;979;1002;102,3;38,1;23,1
2014;3518107;Guarantã;6447;3219;3228;100,3;33,9;14
2014;3518206;Guararapes;30931;15189;15742;103,6;36,9;32,4
2014;3518305;Guararema;27686;13846;13840;100;34,4;102,2
2014;3518404;Guaratinguetá;114308;54945;59363;108;36;151,9
2014;3518503;Guareí;14777;8987;5790;64,4;34,1;26
2014;3518602;Guariba;36486;18132;18354;101,2;32,8;135
2014;3518701;Guarujá;291660;141552;150108;106;33;2014,3
2014;3518800;Guarulhos;1250680;606744;643936;106,1;32,5;3924,6
2014;3518859;Guatapará;7118;3632;3486;96;34;17,2
2014;3518909;Guzolândia;4624;2372;2252;94,9;35,3;18,3
2014;3519006;Herculândia;8877;4415;4462;101,1;35,1;24,4
2014;3519055;Holambra;12461;6282;6179;98,4;33,7;190
2014;3519071;Hortolândia;207436;104283;103153;98,9;32,2;3323,5
2014;3519105;Iacanga;10146;5159;4987;96,7;35,7;18,5
2014;3519204;Iacri;6379;3214;3165;98,5;37,1;19,8
2014;3519253;Iaras;6911;4575;2336;51,1;34,4;17,2
2014;3519303;Ibaté;31303;15938;15365;96,4;32,4;107,6
2014;3519402;Ibirá;11167;5517;5650;102,4;37,1;41,1
2014;3519501;Ibirarema;6663;3345;3318;99,2;35,6;29,2
2014;3519600;Ibitinga;55531;27336;28195;103,1;35,3;80,6
2014;3519709;Ibiúna;72907;36939;35968;97,4;33,6;68,9
2014;3519808;Icém;7633;3998;3635;90,9;34,6;21,1
2014;3519907;Iepê;7647;3763;3884;103,2;36,8;12,9
2014;3520004;Igaraçu do Tietê;23389;11663;11726;100,5;34,3;239,3
2014;3520103;Igarapava;27484;13484;14000;103,8;35,6;58,7
2014;3520202;Igaratá;9476;4819;4657;96,6;34,7;32,3
2014;3520301;Iguape;29090;14600;14490;99,2;35,9;14,7
2014;3520400;Ilhabela;30369;15305;15064;98,4;32,3;87,7
2014;3520426;Ilha Comprida;10507;5212;5295;101,6;37,9;53,5
2014;3520442;Ilha Solteira;25413;12372;13041;105,4;37,4;38,9
2014;3520509;Indaiatuba;219338;108394;110944;102,4;34,4;704
2014;3520608;Indiana;4947;2487;2460;98,9;36,7;38,2
2014;3520707;Indiaporã;3974;1949;2025;103,9;39,6;14,2
2014;3520806;Inúbia Paulista;3655;1821;1834;100,7;36,8;42
2014;3520905;Ipaussu;13720;6855;6865;100,1;34,5;65,5
2014;3521002;Iperó;31018;16657;14361;86,2;32,1;182,1
2014;3521101;Ipeúna;6348;3247;3101;95,5;33,2;33,4
2014;3521150;Ipiguá;5204;2634;2570;97,6;36,3;38,3
2014;3521200;Iporanga;4230;2138;2092;97,8;32,8;3,7
2014;3521309;Ipuã;14311;7234;7077;97,8;33,2;30,7
2014;3521408;Iracemápolis;20682;10341;10341;100;34,3;179,7
2014;3521507;Irapuã;7181;3701;3480;94;35,5;27,9
2014;3521606;Irapuru;7614;4407;3207;72,8;37,8;35,5
2014;3521705;Itaberá;17949;9040;8909;98,6;34,5;16,3
2014;3521804;Itaí;24508;12913;11595;89,8;33,8;22,4
2014;3521903;Itajobi;15396;7751;7645;98,6;37,9;30,7
2014;3522000;Itaju;3358;1735;1623;93,5;35,2;14,6
2014;3522109;Itanhaém;96065;46471;49594;106,7;35,6;159,7
2014;3522158;Itaoca;3295;1698;1597;94,1;35,6;18
2014;3522208;Itapecerica da Serra;155737;77299;78438;101,5;31,4;1033,1
2014;3522307;Itapetininga;149202;74556;74646;100,1;33,8;83,4
2014;3522406;Itapeva;88852;43744;45108;103,1;33;48,7
2014;3522505;Itapevi;211605;103791;107814;103,9;30,4;2560
2014;3522604;Itapira;69922;34522;35400;102,5;37;134,9
2014;3522653;Itapirapuã Paulista;3995;2063;1932;93,7;31,4;9,8
2014;3522703;Itápolis;40091;19802;20289;102,5;36,9;40,2
2014;3522802;Itaporanga;14529;7226;7303;101,1;35,5;28,6
2014;3522901;Itapuí;12686;6381;6305;98,8;34,1;90,6
2014;3523008;Itapura;4254;2185;2069;94,7;35,3;14,1
2014;3523107;Itaquaquecetuba;337879;166100;171779;103,4;30,3;4089,5
2014;3523206;Itararé;47142;23089;24053;104,2;34;47
2014;3523305;Itariri;15553;7804;7749;99,3;32,5;56,8
2014;3523404;Itatiba;108506;53476;55030;102,9;34,9;336,7
2014;3523503;Itatinga;18539;9591;8948;93,3;32,1;18,9
2014;3523602;Itirapina;15763;9280;6483;69,9;33,8;27,9
2014;3523701;Itirapuã;5897;3002;2895;96,4;33,9;36,6
2014;3523800;Itobi;7703;3963;3740;94,4;35,2;55,4
2014;3523909;Itu;159567;78606;80961;103;34,2;249
2014;3524006;Itupeva;53364;26999;26365;97,7;31,9;265,7
2014;3524105;Ituverava;38456;18703;19753;105,6;36,4;54,6
2014;3524204;Jaborandi;6537;3283;3254;99,1;35,5;23,9
2014;3524303;Jaboticabal;72041;34772;37269;107,2;36,4;102
2014;3524402;Jacareí;222128;108028;114100;105,6;34,6;478,4
2014;3524501;Jaci;6287;3198;3089;96,6;33,9;43,3
2014;3524600;Jacupiranga;16875;8528;8347;97,9;33,7;24
2014;3524709;Jaguariúna;49154;24230;24924;102,9;34,1;347,6
2014;3524808;Jales;47844;23316;24528;105,2;38,1;129,8
2014;3524907;Jambeiro;5700;2919;2781;95,3;34,6;30,9
2014;3525003;Jandira;111859;54632;57227;104,7;31,4;6410,6
2014;3525102;Jardinópolis;40119;20384;19735;96,8;33,9;79,9
2014;3525201;Jarinu;28380;14285;14095;98,7;33,5;136,7
2014;3525300;Jaú;132292;64539;67753;105;36;192,5
2014;3525409;Jeriquara;3399;1749;1650;94,3;32,6;23,9
2014;3525508;Joanópolis;12144;6132;6012;98;36,4;32,4
2014;3525607;João Ramalho;4236;2138;2098;98,1;33,5;10,2
2014;3525706;José Bonifácio;34117;16956;17161;101,2;35,3;39,7
2014;3525805;Júlio Mesquita;4398;2159;2239;103,7;34,8;34,3
2014;3525854;Jumirim;2892;1469;1423;96,9;33,9;51
2014;3525904;Jundiaí;394155;191211;202944;106,1;36,3;914,1
2014;3526001;Junqueirópolis;19379;10214;9165;89,7;37,5;33,3
2014;3526100;Juquiá;18677;9436;9241;97,9;34,5;23
2014;3526209;Juquitiba;28408;14356;14052;97,9;32,8;54,4
2014;3526308;Lagoinha;4910;2505;2405;96;38,3;19,2
2014;3526407;Laranjal Paulista;25592;12584;13008;103,4;35,9;66,6
2014;3526506;Lavínia;9075;6509;2566;39,4;35,2;16,9
2014;3526605;Lavrinhas;6822;3418;3404;99,6;32;40,8
2014;3526704;Leme;94371;46998;47373;100,8;34;234,2
2014;3526803;Lençóis Paulista;63338;31366;31972;101,9;34,2;78,2
2014;3526902;Limeira;282054;138249;143805;104;35,4;485,7
2014;3527009;Lindóia;6843;3388;3455;102;36,1;140,4
2014;3527108;Lins;72858;35237;37621;106,8;36,6;127,8
2014;3527207;Lorena;83544;40226;43318;107,7;35,1;201,7
2014;3527256;Lourdes;2084;1066;1018;95,5;38,1;18,3
2014;3527306;Louveira;41780;21024;20756;98,7;31,7;749,6
2014;3527405;Lucélia;20071;10807;9264;85,7;37;63,8
2014;3527504;Lucianópolis;2283;1143;1140;99,7;36,2;12
2014;3527603;Luís Antônio;11646;5941;5705;96;31,5;19,5
2014;3527702;Luiziânia;4936;2524;2412;95,6;35,1;29,6
2014;3527801;Lupércio;4249;2072;2177;105,1;35;27,4
2014;3527900;Lutécia;2728;1358;1370;100,9;36,2;5,7
2014;3528007;Macatuba;16578;8275;8303;100,3;34,3;73,8
2014;3528106;Macaubal;7595;3827;3768;98,5;39,1;30,6
2014;3528205;Macedônia;3777;1890;1887;99,8;38,8;11,5
2014;3528304;Magda;3232;1642;1590;96,8;39,3;10,3
2014;3528403;Mairinque;45703;22862;22841;99,9;33,6;217,5
2014;3528502;Mairiporã;85599;43071;42528;98,7;33,8;266,9
2014;3528601;Manduri;9325;4660;4665;100,1;36;40,7
2014;3528700;Marabá Paulista;4742;2990;1752;58,6;34,5;5,2
2014;3528809;Maracaí;13177;6561;6616;100,8;35,5;24,7
2014;3528858;Marapoama;2855;1462;1393;95,3;36,8;25,7
2014;3528908;Mariápolis;3802;1939;1863;96,1;36,9;20,4
2014;3529005;Marília;224136;108015;116121;107,5;36,1;191,5
2014;3529104;Marinópolis;2058;1041;1017;97,7;37,5;26,4
2014;3529203;Martinópolis;24533;12710;11823;93;36;19,6
2014;3529302;Matão;77958;38520;39438;102,4;35,7;148,5
2014;3529401;Mauá;419449;204352;215097;105,3;32,9;6772,2
2014;3529500;Mendonça;5125;2590;2535;97,9;37;26,3
2014;3529609;Meridiano;4113;2017;2096;103,9;37,5;18
2014;3529658;Mesópolis;1901;966;935;96,8;36,6;12,8
2014;3529708;Miguelópolis;20273;10053;10220;101,7;34;24,7
2014;3529807;Mineiros do Tietê;11863;5901;5962;101;35,2;55,6
2014;3529906;Miracatu;20024;10087;9937;98,5;33,2;20
2014;3530003;Mira Estrela;2919;1452;1467;101;38,8;13,5
2014;3530102;Mirandópolis;27856;15446;12410;80,3;37,9;30,4
2014;3530201;Mirante do Paranapanema;16872;8518;8354;98,1;36,6;13,6
2014;3530300;Mirassol;57028;27870;29158;104,6;36,4;234,5
2014;3530409;Mirassolândia;4406;2241;2165;96,6;36,4;26,5
2014;3530508;Mococa;67101;33269;33832;101,7;36,4;78,5
2014;3530607;Mogi das Cruzes;409780;198832;210948;106,1;33,6;575,1
2014;3530706;Mogi Guaçu;143246;70684;72562;102,7;35,2;176,2
2014;3530805;Mogi Mirim;89010;43659;45351;103,9;36,3;178,8
2014;3530904;Mombuca;3422;1723;1699;98,6;33,3;25,6
2014;3531001;Monções;2087;1068;1019;95,4;39,8;20
2014;3531100;Mongaguá;51641;25950;25691;99;35,9;361,7
2014;3531209;Monte Alegre do Sul;7687;3824;3863;101;38;69,7
2014;3531308;Monte Alto;47182;23199;23983;103,4;37,3;136
2014;3531407;Monte Aprazível;21998;10879;11119;102,2;37,4;44,4
2014;3531506;Monte Azul Paulista;18776;9416;9360;99,4;36,6;71,3
2014;3531605;Monte Castelo;4116;2044;2072;101,4;38,5;17,6
2014;3531704;Monteiro Lobato;4158;2137;2021;94,6;36,2;12,5
2014;3531803;Monte Mor;54189;26970;27219;100,9;32,5;225,3
2014;3531902;Morro Agudo;29014;14615;14399;98,5;32,7;20,9
2014;3532009;Morungaba;12470;6196;6274;101,3;34,3;85
2014;3532058;Motuca;4203;2128;2075;97,5;34,6;18,4
2014;3532108;Murutinga do Sul;4059;2033;2026;99,7;40;16,2
2014;3532157;Nantes;2707;1346;1361;101,1;32,8;9,4
2014;3532207;Narandiba;4771;2401;2370;98,7;32,9;13,4
2014;3532306;Natividade da Serra;6806;3552;3254;91,6;37,7;8,2
2014;3532405;Nazaré Paulista;17111;8774;8337;95;35,6;52,4
2014;3532504;Neves Paulista;9089;4511;4578;101,5;39,6;41,5
2014;3532603;Nhandeara;10486;5121;5365;104,8;40;24
2014;3532702;Nipoã;4430;2316;2114;91,3;34,2;32,2
2014;3532801;Nova Aliança;6151;3040;3111;102,3;36,8;28,3
2014;3532827;Nova Campina;8511;4309;4202;97,5;30,3;22,1
2014;3532843;Nova Canaã Paulista;2091;1063;1028;96,7;41,6;16,8
2014;3532868;Nova Castilho;1119;554;565;102;36,2;6,1
2014;3532900;Nova Europa;9367;4688;4679;99,8;33,9;58,5
2014;3533007;Nova Granada;19299;9671;9628;99,6;35,8;36,3
2014;3533106;Nova Guataporanga;2178;1089;1089;100;38,9;63,8
2014;3533205;Nova Independência;3574;1833;1741;95;33,2;13,5
2014;3533254;Novais;4550;2397;2153;89,8;31,9;38,6
2014;3533304;Nova Luzitânia;3289;1705;1584;92,9;35,5;44,6
2014;3533403;Nova Odessa;54921;27072;27849;102,9;34,9;744,3
2014;3533502;Novo Horizonte;37268;18522;18746;101,2;36,4;40
2014;3533601;Nuporanga;7003;3489;3514;100,7;35,7;20,1
2014;3533700;Ocauçu;4225;2165;2060;95,2;35,8;14
2014;3533809;Óleo;2625;1325;1300;98,1;38,1;13,2
2014;3533908;Olímpia;51935;25499;26436;103,7;36,2;64,7
2014;3534005;Onda Verde;4177;2133;2044;95,8;34,4;17,2
2014;3534104;Oriente;6135;2982;3153;105,7;37,3;28,1
2014;3534203;Orindiúva;5820;2945;2875;97,6;32,6;23,5
2014;3534302;Orlândia;39564;19306;20258;104,9;35,4;135,6
2014;3534401;Osasco;691781;331529;360252;108,7;33,7;10650,3
2014;3534500;Oscar Bressane;2537;1221;1316;107,8;39,9;11,4
2014;3534609;Osvaldo Cruz;31168;15621;15547;99,5;38,4;125,7
2014;3534708;Ourinhos;104001;50144;53857;107,4;35,7;351,6
2014;3534757;Ouroeste;9094;4518;4576;101,3;35,8;31,5
2014;3534807;Ouro Verde;7861;3856;4005;103,9;35;29,5
2014;3534906;Pacaembu;13829;8446;5383;63,7;37,6;40,7
2014;3535002;Palestina;11206;5641;5565;98,7;37,3;16,1
2014;3535101;Palmares Paulista;10563;5523;5040;91,3;31,5;128,6
2014;3535200;Palmeira d'Oeste;9399;4704;4695;99,8;39,7;29,5
2014;3535309;Palmital;20791;10148;10643;104,9;37,8;37,9
2014;3535408;Panorama;14844;7405;7439;100,5;33,8;41,7
2014;3535507;Paraguaçu Paulista;42069;21103;20966;99,4;35,3;42
2014;3535606;Paraibuna;17580;8921;8659;97,1;35,2;21,7
2014;3535705;Paraíso;5999;3049;2950;96,8;36,6;38,7
2014;3535804;Paranapanema;18356;9343;9013;96,5;33;18
2014;3535903;Paranapuã;3894;1976;1918;97,1;36,7;27,7
2014;3536000;Parapuã;10804;5460;5344;97,9;38,2;29,5
2014;3536109;Pardinho;6140;3119;3021;96,9;33,8;29,3
2014;3536208;Pariquera-Açu;18758;9294;9464;101,8;34,2;52,2
2014;3536257;Parisi;2305;1157;1148;99,2;38,1;27,2
2014;3536307;Patrocínio Paulista;13562;6868;6694;97,5;34;22,5
2014;3536406;Paulicéia;6909;3547;3362;94,8;33,7;18,5
2014;3536505;Paulínia;91351;44949;46402;103,2;33,2;658,3
2014;3536570;Paulistânia;1875;960;915;95,3;35,4;7,3
2014;3536604;Paulo de Faria;8263;4143;4120;99,4;36;11,2
2014;3536703;Pederneiras;42791;21424;21367;99,7;34,3;58,8
2014;3536802;Pedra Bela;6034;3153;2881;91,4;36,7;38
2014;3536901;Pedranópolis;2657;1352;1305;96,5;39,5;10,2
2014;3537008;Pedregulho;15682;7940;7742;97,5;34,3;22
2014;3537107;Pedreira;42224;20853;21371;102,5;35,5;388
2014;3537156;Pedrinhas Paulista;2891;1427;1464;102,6;37,1;19
2014;3537206;Pedro de Toledo;10640;5404;5236;96,9;34,6;15,9
2014;3537305;Penápolis;59687;29008;30679;105,8;36,9;83,9
2014;3537404;Pereira Barreto;24913;12184;12729;104,5;36,7;25,6
2014;3537503;Pereiras;7864;3964;3900;98,4;35,3;35,2
2014;3537602;Peruíbe;62928;30585;32343;105,7;35,7;192,9
2014;3537701;Piacatu;5426;2727;2699;99;36,6;23,3
2014;3537800;Piedade;52540;26657;25883;97,1;35,1;70,3
2014;3537909;Pilar do Sul;26929;13674;13255;96,9;34,1;39,5
2014;3538006;Pindamonhangaba;153532;75155;78377;104,3;33,8;209,9
2014;3538105;Pindorama;14956;7583;7373;97,2;37,5;80,9
2014;3538204;Pinhalzinho;13815;6930;6885;99,4;37,1;89,4
2014;3538303;Piquerobi;3470;1700;1770;104,1;37,3;7,2
2014;3538501;Piquete;13688;6604;7084;107,3;37;77,8
2014;3538600;Piracaia;25515;12626;12889;102,1;36;66,2
2014;3538709;Piracicaba;384963;187672;197291;105,1;35,4;279,3
2014;3538808;Piraju;28919;14019;14900;106,3;36,5;57,3
2014;3538907;Pirajuí;22716;12327;10389;84,3;36,4;27,6
2014;3539004;Pirangi;10724;5413;5311;98,1;37,6;49,7
2014;3539103;Pirapora do Bom Jesus;16513;8209;8304;101,2;30,4;152,2
2014;3539202;Pirapozinho;24995;12206;12789;104,8;35,6;52,3
2014;3539301;Pirassununga;71442;34801;36641;105,3;36,5;98,3
2014;3539400;Piratininga;13088;6445;6643;103,1;36,4;32,5
2014;3539509;Pitangueiras;35002;17704;17298;97,7;32,6;81,3
2014;3539608;Planalto;4475;2281;2194;96,2;34,3;15,4
2014;3539707;Platina;3170;1634;1536;94;35;9,7
2014;3539806;Poá;106156;51250;54906;107,1;33;6149,1
2014;3539905;Poloni;5488;2702;2786;103,1;37,9;40,6
2014;3540002;Pompéia;20114;9869;10245;103,8;36,3;25,6
2014;3540101;Pongaí;3463;1776;1687;95;39,2;18,9
2014;3540200;Pontal;39481;20474;19007;92,8;31,2;110,8
2014;3540259;Pontalinda;4110;2188;1922;87,8;34,4;19,6
2014;3540309;Pontes Gestal;2511;1251;1260;100,7;37,5;11,5
2014;3540408;Populina;4231;2129;2102;98,7;38,6;13,4
2014;3540507;Porangaba;9070;4648;4422;95,1;37,7;34,1
2014;3540606;Porto Feliz;51484;25960;25524;98,3;34,8;92,5
2014;3540705;Porto Ferreira;52042;25667;26375;102,8;35,6;212,5
2014;3540754;Potim;19778;11166;8612;77,1;31,4;443
2014;3540804;Potirendaba;16477;8290;8187;98,8;36,9;48,1
2014;3540853;Pracinha;2772;2006;766;38,2;33;44
2014;3540903;Pradópolis;17381;8781;8600;97,9;33,5;103,8
2014;3541000;Praia Grande;292210;139893;152317;108,9;34,6;1952,6
2014;3541059;Pratânia;4774;2440;2334;95,7;32,2;27,3
2014;3541109;Presidente Alves;4052;2010;2042;101,6;36,7;14,1
2014;3541208;Presidente Bernardes;13947;7170;6777;94,5;38,8;18,6
2014;3541307;Presidente Epitácio;40950;19967;20983;105,1;35,2;32,5
2014;3541406;Presidente Prudente;214121;102869;111252;108,1;36,4;381,9
2014;3541505;Presidente Venceslau;37239;18385;18854;102,6;37,8;49,3
2014;3541604;Promissão;35766;17729;18037;101,7;35,2;45,9
2014;3541653;Quadra;3294;1723;1571;91,2;35,7;16
2014;3541703;Quatá;12941;6454;6487;100,5;34,5;19,9
2014;3541802;Queiroz;2954;1491;1463;98,1;32,7;12,6
2014;3541901;Queluz;10616;5360;5256;98,1;33,6;42,6
2014;3542008;Quintana;6331;3117;3214;103,1;35,6;19,9
2014;3542107;Rafard;8727;4315;4412;102,2;35;71,7
2014;3542206;Rancharia;28840;14098;14742;104,6;36,1;18,2
2014;3542305;Redenção da Serra;4106;2142;1964;91,7;36,7;13,3
2014;3542404;Regente Feijó;19094;9459;9635;101,9;36,2;72,5
2014;3542503;Reginópolis;7431;4689;2742;58,5;33,9;18,1
2014;3542602;Registro;56417;27828;28589;102,7;34,1;78,1
2014;3542701;Restinga;6516;3252;3264;100,4;32,4;26,5
2014;3542800;Ribeira;3294;1701;1593;93,7;35,5;9,8
2014;3542909;Ribeirão Bonito;11854;5930;5924;99,9;34,5;25,1
2014;3543006;Ribeirão Branco;18380;9424;8956;95;31,1;26,4
2014;3543105;Ribeirão Corrente;4396;2254;2142;95;32,8;29,6
2014;3543204;Ribeirão do Sul;4528;2273;2255;99,2;37,4;22,3
2014;3543238;Ribeirão dos Índios;2148;1064;1084;101,9;39;10,9
2014;3543253;Ribeirão Grande;7517;3856;3661;94,9;34,4;22,5
2014;3543303;Ribeirão Pires;114665;55880;58785;105,2;35,2;1158,6
2014;3543402;Ribeirão Preto;637534;305090;332444;109;35,5;979,4
2014;3543501;Riversul;5997;2993;3004;100,4;35,9;15,5
2014;3543600;Rifaina;3638;1825;1813;99,3;36,5;22,4
2014;3543709;Rincão;10042;5036;5006;99,4;34,5;31,7
2014;3543808;Rinópolis;9774;4923;4851;98,5;38,2;27,3
2014;3543907;Rio Claro;191717;93047;98670;106;36;384,6
2014;3544004;Rio das Pedras;30209;15200;15009;98,7;33;133,3
2014;3544103;Rio Grande da Serra;44330;21894;22436;102,5;32,1;1219,8
2014;3544202;Riolândia;10505;6142;4363;71;33,7;16,6
2014;3544251;Rosana;19104;9492;9612;101,3;34,6;25,7
2014;3544301;Roseira;10061;5067;4994;98,6;33,5;77,5
2014;3544400;Rubiácea;2716;1376;1340;97,4;34,4;11,5
2014;3544509;Rubinéia;3185;1574;1611;102,4;40,1;13,1
2014;3544608;Sabino;5235;2602;2633;101,2;38;17,1
2014;3544707;Sagres;2435;1195;1240;103,8;36,5;16,5
2014;3544806;Sales;5833;2943;2890;98,2;37,3;18,9
2014;3544905;Sales Oliveira;10900;5351;5549;103,7;36;35,6
2014;3545001;Salesópolis;15574;7825;7749;99;34,5;36,6
2014;3545100;Salmourão;4822;2463;2359;95,8;35,9;27,9
2014;3545159;Saltinho;7432;3679;3753;102;36,8;74,5
2014;3545209;Salto;114961;56647;58314;102,9;34,3;864
2014;3545308;Salto de Pirapora;41513;20633;20880;101,2;34,3;148
2014;3545407;Salto Grande;8933;4396;4537;103,2;36,1;47,4
2014;3545506;Sandovalina;3710;1879;1831;97,4;33,4;8,1
2014;3545605;Santa Adélia;14254;7087;7167;101,1;36,1;43,2
2014;3545704;Santa Albertina;5961;3003;2958;98,5;38,9;21,9
2014;3545803;Santa Bárbara d'Oeste;181668;89794;91874;102,3;35,4;670,3
2014;3546009;Santa Branca;13929;6948;6981;100,5;35,8;51,2
2014;3546108;Santa Clara d'Oeste;2264;1152;1112;96,5;37,7;12,3
2014;3546207;Santa Cruz da Conceição;4135;2039;2096;102,8;38;27,5
2014;3546256;Santa Cruz da Esperança;2050;1016;1034;101,8;35,4;13,8
2014;3546306;Santa Cruz das Palmeiras;29791;15017;14774;98,4;34;100,9
2014;3546405;Santa Cruz do Rio Pardo;44876;21933;22943;104,6;36;40,3
2014;3546504;Santa Ernestina;5793;2948;2845;96,5;33;43,1
2014;3546603;Santa Fé do Sul;31042;14955;16087;107,6;37,8;150,3
2014;3546702;Santa Gertrudes;22371;11321;11050;97,6;31,9;227,6
2014;3546801;Santa Isabel;51593;25723;25870;100,6;34;142
2014;3546900;Santa Lúcia;7986;3983;4003;100,5;33,4;51,9
2014;3547007;Santa Maria da Serra;5360;2712;2648;97,6;33,4;21,2
2014;3547106;Santa Mercedes;2902;1449;1453;100,3;36;17,4
2014;3547205;Santana da Ponte Pensa;1652;846;806;95,3;42,1;12,7
2014;3547304;Santana de Parnaíba;123415;60576;62839;103,7;32,2;685,8
2014;3547403;Santa Rita d'Oeste;2631;1300;1331;102,4;41,3;12,5
2014;3547502;Santa Rita do Passa Quatro;26049;12560;13489;107,4;39,5;34,5
2014;3547601;Santa Rosa de Viterbo;23880;11703;12177;104,1;36,2;82,8
2014;3547650;Santa Salete;1513;763;750;98,3;40;19,1
2014;3547700;Santo Anastácio;19717;9570;10147;106;37,7;35,7
2014;3547809;Santo André;703904;336495;367409;109,2;36,6;4004,4
2014;3547908;Santo Antônio da Alegria;6457;3327;3130;94,1;36,5;20,8
2014;3548005;Santo Antônio de Posse;21540;10830;10710;98,9;33,7;139,7
2014;3548054;Santo Antônio do Aracanguá;7924;4001;3923;98,1;35,3;6,1
2014;3548104;Santo Antônio do Jardim;6007;3062;2945;96,2;36,8;54,6
2014;3548203;Santo Antônio do Pinhal;6732;3393;3339;98,4;35;50,6
2014;3548302;Santo Expedito;2860;1416;1444;102;37,9;30,3
2014;3548401;Santópolis do Aguapeí;4181;2094;2087;99,7;34,1;32,7
2014;3548500;Santos;421777;192429;229348;119,2;39,9;1500,8
2014;3548609;São Bento do Sapucaí;10939;5484;5455;99,5;37;43,3
2014;3548708;São Bernardo do Campo;785220;377489;407731;108;34,8;1917,4
2014;3548807;São Caetano do Sul;155347;71441;83906;117,4;40,2;10133,1
2014;3548906;São Carlos;233020;114064;118956;104,3;35,9;205
2014;3549003;São Francisco;2753;1369;1384;101,1;39,4;36,4
2014;3549102;São João da Boa Vista;86790;41966;44824;106,8;37,3;168,1
2014;3549201;São João das Duas Pontes;2604;1298;1306;100,6;37,4;20,1
2014;3549250;São João de Iracema;1794;901;893;99,1;36,6;10,1
2014;3549300;São João do Pau d'Alho;2159;1071;1088;101,6;40,8;18,3
2014;3549409;São Joaquim da Barra;47434;23158;24276;104,8;35,3;115,4
2014;3549508;São José da Bela Vista;8184;4173;4011;96,1;32,7;29,6
2014;3549607;São José do Barreiro;4027;2026;2001;98,8;35,2;7,1
2014;3549706;São José do Rio Pardo;52153;25491;26662;104,6;36,9;124,3
2014;3549805;São José do Rio Preto;433339;207707;225632;108,6;36,6;1003,2
2014;3549904;São José dos Campos;654803;319140;335663;105,2;34,1;595,6
2014;3549953;São Lourenço da Serra;14710;7442;7268;97,7;33,6;78,9
2014;3550001;São Luiz do Paraitinga;10429;5312;5117;96,3;37,4;16,9
2014;3550100;São Manuel;38129;18671;19458;104,2;35,2;58,6
2014;3550209;São Miguel Arcanjo;31825;16145;15680;97,1;33,6;34,2
2014;3550308;São Paulo;11384211;5381631;6002580;111,5;35,2;7483,7
2014;3550407;São Pedro;33928;16518;17410;105,4;36,9;55,5
2014;3550506;São Pedro do Turvo;7203;3666;3537;96,5;34,9;9,9
2014;3550605;São Roque;79120;38836;40284;103,7;35,5;257,8
2014;3550704;São Sebastião;76640;38012;38628;101,6;32,2;190,5
2014;3550803;São Sebastião da Grama;11654;5904;5750;97,4;36;46,2
2014;3550902;São Simão;14159;6965;7194;103,3;36,4;22,9
2014;3551009;São Vicente;334285;160770;173515;107,9;34,4;2256,4
2014;3551108;Sarapuí;9523;4837;4686;96,9;34,2;27
2014;3551207;Sarutaiá;3669;1838;1831;99,6;35,3;25,9
2014;3551306;Sebastianópolis do Sul;3086;1526;1560;102,2;37,9;18,4
2014;3551405;Serra Azul;11783;7303;4480;61,3;33,6;41,6
2014;3551504;Serrana;40685;20259;20426;100,8;31,8;322,8
2014;3551603;Serra Negra;27652;13436;14216;105,8;38,3;135,7
2014;3551702;Sertãozinho;116184;57286;58898;102,8;33,9;288,2
2014;3551801;Sete Barras;12990;6658;6332;95,1;33,7;12,2
2014;3551900;Severínia;15265;7900;7365;93,2;33,2;108,7
2014;3552007;Silveiras;5951;2994;2957;98,8;34,8;14,3
2014;3552106;Socorro;37963;18782;19181;102,1;38,3;84,5
2014;3552205;Sorocaba;633400;308693;324707;105,2;34,5;1408
2014;3552304;Sud Mennucci;7440;3722;3718;99,9;35,3;12,5
2014;3552403;Sumaré;254597;125844;128753;102,3;32,7;1659
2014;3552502;Suzano;278296;135890;142406;104,8;32,4;1349,4
2014;3552551;Suzanápolis;3419;1762;1657;94;36,3;10,3
2014;3552601;Tabapuã;11416;5719;5697;99,6;37,5;33
2014;3552700;Tabatinga;14727;7474;7253;97;34,5;40
2014;3552809;Taboão da Serra;255841;122073;133768;109,6;32,5;12548,8
2014;3552908;Taciba;5914;2936;2978;101,4;34,9;9,7
2014;3553005;Taguaí;11461;5688;5773;101,5;32,8;78,9
2014;3553104;Taiaçu;5833;2950;2883;97,7;35,9;54,5
2014;3553203;Taiúva;5832;3021;2811;93;37,7;44
2014;3553302;Tambaú;22198;11013;11185;101,6;35,8;39,5
2014;3553401;Tanabi;24625;12245;12380;101,1;37,6;33
2014;3553500;Tapiraí;8043;4055;3988;98,3;33;10,7
2014;3553609;Tapiratiba;12485;6155;6330;102,8;36,3;56,3
2014;3553658;Taquaral;2743;1374;1369;99,6;35,9;50,9
2014;3553708;Taquaritinga;53697;26382;27315;103,5;36,1;90,3
2014;3553807;Taquarituba;23084;11639;11445;98,3;34,7;51,5
2014;3553856;Taquarivaí;5684;2859;2825;98,8;30,7;24,5
2014;3553906;Tarabai;6604;3276;3328;101,6;33,8;32,8
2014;3553955;Tarumã;13609;6887;6722;97,6;33;44,9
2014;3554003;Tatuí;113366;55805;57561;103,1;34,2;216,5
2014;3554102;Taubaté;290512;141708;148804;105;34,9;464,8
2014;3554201;Tejupá;4616;2364;2252;95,3;33,2;15,6
2014;3554300;Teodoro Sampaio;21706;10789;10917;101,2;33,3;14
2014;3554409;Terra Roxa;8349;4200;4149;98,8;35,4;37,7
2014;3554508;Tietê;37168;18380;18788;102,2;35,6;91,9
2014;3554607;Timburi;2606;1326;1280;96,5;38;13,2
2014;3554656;Torre de Pedra;2196;1142;1054;92,3;37,5;30,8
2014;3554706;Torrinha;9306;4680;4626;98,8;37,4;29,5
2014;3554755;Trabiju;1595;801;794;99,1;34;25,1
2014;3554805;Tremembé;44471;23602;20869;88,4;34;232,7
2014;3554904;Três Fronteiras;5909;2962;2947;99,5;38,3;39
2014;3554953;Tuiuti;6247;3165;3082;97,4;38,2;49,3
2014;3555000;Tupã;63818;30767;33051;107,4;38,3;101,6
2014;3555109;Tupi Paulista;14851;7772;7079;91,1;40;60,7
2014;3555208;Turiúba;1905;972;933;96;40;12,4
2014;3555307;Turmalina;1880;928;952;102,6;42,3;12,7
2014;3555356;Ubarana;5350;2740;2610;95,3;32,6;25,5
2014;3555406;Ubatuba;83246;41320;41926;101,5;33,2;117,6
2014;3555505;Ubirajara;4645;2400;2245;93,5;34,7;16,5
2014;3555604;Uchoa;9852;4878;4974;102;37,8;39
2014;3555703;União Paulista;1621;827;794;96;34,6;20,5
2014;3555802;Urânia;8853;4389;4464;101,7;38,5;42,3
2014;3555901;Uru;1312;664;648;97,6;38;8,9
2014;3556008;Urupês;13110;6489;6621;102;38,5;40,5
2014;3556107;Valentim Gentil;12029;6027;6002;99,6;35,2;80,3
2014;3556206;Valinhos;113433;55750;57683;103,5;36,3;763,7
2014;3556305;Valparaíso;23238;12815;10423;81,3;34,1;27,1
2014;3556354;Vargem;9344;4788;4556;95,2;35,6;65,5
2014;3556404;Vargem Grande do Sul;39592;19599;19993;102;35,3;148,2
2014;3556453;Vargem Grande Paulista;45678;22564;23114;102,4;32,9;1075
2014;3556503;Várzea Paulista;110896;55225;55671;100,8;32,5;3157,7
2014;3556602;Vera Cruz;10604;5208;5396;103,6;37,4;42,8
2014;3556701;Vinhedo;68095;33532;34563;103,1;35,4;841,2
2014;3556800;Viradouro;17469;8741;8728;99,9;34,9;80,2
2014;3556909;Vista Alegre do Alto;7278;3719;3559;95,7;33,6;76,3
2014;3556958;Vitória Brasil;1778;908;870;95,8;37,1;35,7
2014;3557006;Votorantim;115506;57030;58476;102,5;33,2;627,1
2014;3557105;Votuporanga;88753;43132;45621;105,8;37,2;211
2014;3557154;Zacarias;2477;1243;1234;99,3;37;7,8
2014;3557204;Chavantes;12265;6055;6210;102,6;35,1;65
2014;3557303;Estiva Gerbi;10471;5271;5200;98,7;34;141,2
2015;3500105;Adamantina;34285;16565;17720;107;39,1;83,2
2015;3500204;Adolfo;3903;1945;1958;100,7;37,8;18,5
2015;3500303;Aguaí;32192;16110;16082;99,8;34,6;67,8
2015;3500402;Águas da Prata;7558;3692;3866;104,7;39,9;53
2015;3500501;Águas de Lindóia;17690;8639;9051;104,8;37,9;294,2
2015;3500550;Águas de Santa Bárbara;6313;3138;3175;101,2;36,7;15,6
2015;3500600;Águas de São Pedro;2734;1277;1457;114,1;43,1;756,9
2015;3500709;Agudos;35986;17738;18248;102,9;34,6;37,2
2015;3500758;Alambari;5395;2715;2680;98,7;34;33,8
2015;3500808;Alfredo Marcondes;4138;2081;2057;98,8;39,8;34,8
2015;3500907;Altair;3693;1941;1752;90,3;34;11,8
2015;3501004;Altinópolis;16155;8037;8118;101;36,4;17,4
2015;3501103;Alto Alegre;4059;2061;1998;96,9;40,1;12,7
2015;3501152;Alumínio;17166;8604;8562;99,5;33;205,3
2015;3501202;Álvares Florence;3935;2013;1922;95,5;41,4;10,9
2015;3501301;Álvares Machado;25208;12369;12839;103,8;35,6;72,5
2015;3501400;Álvaro de Carvalho;4731;3071;1660;54,1;34,3;30,8
2015;3501509;Alvinlândia;2978;1470;1508;102,6;34,8;35,1
2015;3501608;Americana;222291;108228;114063;105,4;36,8;1660
2015;3501707;Américo Brasiliense;34218;17087;17131;100,3;32,8;278,3
2015;3501806;Américo de Campos;5831;2880;2951;102,5;38,8;23,1
2015;3501905;Amparo;67088;32877;34211;104,1;37,3;150,7
2015;3502002;Analândia;4410;2244;2166;96,5;35,7;13,5
2015;3502101;Andradina;57588;28440;29148;102,5;37,4;59,7
2015;3502200;Angatuba;23016;11610;11406;98,2;34,7;22,4
2015;3502309;Anhembi;5697;2916;2781;95,4;34,2;7,7
2015;3502408;Anhumas;3844;1903;1941;102;36;12
2015;3502507;Aparecida;34268;16510;17758;107,6;35,9;283,5
2015;3502606;Aparecida d'Oeste;4321;2131;2190;102,8;40,1;24,1
2015;3502705;Apiaí;25199;12604;12595;99,9;33,6;25,9
2015;3502754;Araçariguama;18893;9570;9323;97,4;31,3;130,1
2015;3502804;Araçatuba;190349;91120;99229;108,9;37,2;163,1
2015;3502903;Araçoiaba da Serra;29554;14723;14831;100,7;36,3;115,8
2015;3503000;Aramina;5316;2637;2679;101,6;36,8;26,2
2015;3503109;Arandu;6424;3229;3195;98,9;34,6;22,5
2015;3503158;Arapeí;2454;1234;1220;98,9;36,4;15,6
2015;3503208;Araraquara;223325;107473;115852;107,8;36,8;222,5
2015;3503307;Araras;124270;60874;63396;104,1;36,1;192,7
2015;3503356;Arco-Íris;1998;1012;986;97,4;37,8;7,5
2015;3503406;Arealva;7985;4030;3955;98,1;39,1;15,8
2015;3503505;Areias;3678;1842;1836;99,7;34,6;12,1
2015;3503604;Areiópolis;10487;5360;5127;95,7;32,4;122,1
2015;3503703;Ariranha;8258;4164;4094;98,3;36,6;62,3
2015;3503802;Artur Nogueira;47301;23501;23800;101,3;33,7;265,7
2015;3503901;Arujá;79936;39200;40736;103,9;32,9;831,2
2015;3503950;Aspásia;1820;914;906;99,1;38,9;26,2
2015;3504008;Assis;98216;47603;50613;106,3;36,8;213,2
2015;3504107;Atibaia;140284;68521;71763;104,7;35,6;293,2
2015;3504206;Auriflama;14094;7007;7087;101,1;37,8;32,4
2015;3504305;Avaí;4777;2395;2382;99,5;34,9;8,8
2015;3504404;Avanhandava;11344;6258;5086;81,3;33,3;33,5
2015;3504503;Avaré;87433;43357;44076;101,7;35,4;72,1
2015;3504602;Bady Bassitt;19764;9753;10011;102,6;34,9;179,1
2015;3504701;Balbinos;3764;3052;712;23,3;35;41,1
2015;3504800;Bálsamo;8813;4303;4510;104,8;38,3;58,8
2015;3504909;Bananal;10184;5001;5183;103,6;36,2;16,5
2015;3505005;Barão de Antonina;3286;1659;1627;98,1;35,9;21,5
2015;3505104;Barbosa;6220;3097;3123;100,8;35,1;30,3
2015;3505203;Bariri;31702;15727;15975;101,6;36,8;71,3
2015;3505302;Barra Bonita;35146;17084;18062;105,7;37,9;234,1
2015;3505351;Barra do Chapéu;5216;2730;2486;91,1;33,2;12,9
2015;3505401;Barra do Turvo;7425;3850;3575;92,9;34,3;7,4
2015;3505500;Barretos;116789;56260;60529;107,6;36,2;74,6
2015;3505609;Barrinha;30141;15034;15107;100,5;31,5;206,4
2015;3505708;Barueri;273650;132090;141560;107,2;32,2;4165,1
2015;3505807;Bastos;20987;10280;10707;104,2;35,8;122,8
2015;3505906;Batatais;57420;28085;29335;104,5;36,5;67,6
2015;3506003;Bauru;360149;174396;185753;106,5;36;539,4
2015;3506102;Bebedouro;75910;36878;39032;105,8;36,6;111,1
2015;3506201;Bento de Abreu;2679;1357;1322;97,4;35,1;8,9
2015;3506300;Bernardino de Campos;11143;5602;5541;98,9;37,5;45,6
2015;3506359;Bertioga;54494;27230;27264;100,1;31,7;110,9
2015;3506409;Bilac;7226;3562;3664;102,9;38,4;45,7
2015;3506508;Birigui;113701;55317;58384;105,5;36,3;214,5
2015;3506607;Biritiba Mirim;29188;14655;14533;99,2;33,9;92
2015;3506706;Boa Esperança do Sul;13480;6735;6745;100,1;33,7;19,5
2015;3506805;Bocaina;11097;5484;5613;102,4;35,4;30,5
2015;3506904;Bofete;10017;5105;4912;96,2;36,3;15,3
2015;3507001;Boituva;53695;26794;26901;100,4;33,9;215,7
2015;3507100;Bom Jesus dos Perdões;20630;10321;10309;99,9;33,6;190,4
2015;3507159;Bom Sucesso de Itararé;3568;1824;1744;95,6;30,4;26,7
2015;3507209;Borá;857;436;421;96,6;35,4;7,2
2015;3507308;Boracéia;4469;2275;2194;96,4;34,3;36,6
2015;3507407;Borborema;14481;7260;7221;99,5;37,5;26,2
2015;3507456;Borebi;2483;1222;1261;103,2;33,2;7,1
2015;3507506;Botucatu;135279;65400;69879;106,8;35,8;91,2
2015;3507605;Bragança Paulista;159628;77997;81631;104,7;35,7;311,4
2015;3507704;Braúna;5157;2583;2574;99,7;36,9;26,4
2015;3507753;Brejo Alegre;2592;1332;1260;94,6;36;24,5
2015;3507803;Brodowski;22859;11282;11577;102,6;35,2;82,1
2015;3507902;Brotas;22600;11117;11483;103,3;35,6;20,5
2015;3508009;Buri;19369;9825;9544;97,1;32,1;16,2
2015;3508108;Buritama;16359;8092;8267;102,2;37,2;50
2015;3508207;Buritizal;4186;2100;2086;99,3;36,9;15,7
2015;3508306;Cabrália Paulista;4379;2224;2155;96,9;34,7;18,2
2015;3508405;Cabreúva;43836;22002;21834;99,2;32;168,4
2015;3508504;Caçapava;90071;44411;45660;102,8;35;244,1
2015;3508603;Cachoeira Paulista;30835;15026;15809;105,2;35,6;107,1
2015;3508702;Caconde;17961;8970;8991;100,2;36,4;38,4
2015;3508801;Cafelândia;16729;8167;8562;104,8;36,7;18,2
2015;3508900;Caiabu;3984;2024;1960;96,8;37,6;15,7
2015;3509007;Caieiras;90428;44060;46368;105,2;33,1;926,1
2015;3509106;Caiuá;5221;2905;2316;79,7;36,7;9,5
2015;3509205;Cajamar;75882;37612;38270;101,7;31,4;577,6
2015;3509254;Cajati;28660;14449;14211;98,4;32,6;63,1
2015;3509304;Cajobi;9572;4845;4727;97,6;36,9;54,1
2015;3509403;Cajuru;23651;11804;11847;100,4;34,8;35,8
2015;3509452;Campina do Monte Alegre;5730;2913;2817;96,7;34,9;31,1
2015;3509502;Campinas;1110271;533174;577097;108,2;36,1;1397,3
2015;3509601;Campo Limpo Paulista;76290;37419;38871;103,9;33,8;960,8
2015;3509700;Campos do Jordão;47679;23331;24348;104,4;33,5;164,4
2015;3509809;Campos Novos Paulista;4699;2401;2298;95,7;35,3;9,7
2015;3509908;Cananéia;12334;6120;6214;101,5;34,7;10
2015;3509957;Canas;4621;2322;2299;99;32,2;86,8
2015;3510005;Cândido Mota;29881;14603;15278;104,6;36,7;50,2
2015;3510104;Cândido Rodrigues;2779;1375;1404;102,1;39,8;39,2
2015;3510153;Canitar;5161;2579;2582;100,1;31,1;89,8
2015;3510203;Capão Bonito;46574;23165;23409;101,1;33,9;28,4
2015;3510302;Capela do Alto;19759;10443;9316;89,2;33,2;116,3
2015;3510401;Capivari;49345;24507;24838;101,4;34,3;152,8
2015;3510500;Caraguatatuba;115117;56626;58491;103,3;34,2;237,4
2015;3510609;Carapicuíba;379276;183412;195864;106,8;32,6;10978,9
2015;3510708;Cardoso;11741;5771;5970;103,4;38,7;18,4
2015;3510807;Casa Branca;28402;14908;13494;90,5;36,4;32,9
2015;3510906;Cássia dos Coqueiros;2721;1398;1323;94,6;37,7;14,2
2015;3511003;Castilho;19017;9434;9583;101,6;35,6;17,9
2015;3511102;Catanduva;114638;55346;59292;107,1;37,6;394,5
2015;3511201;Catiguá;7109;3589;3520;98,1;36;47,9
2015;3511300;Cedral;9857;4896;4961;101,3;37,4;49,8
2015;3511409;Cerqueira César;19259;9721;9538;98,1;34,9;37,6
2015;3511508;Cerquilho;41900;20625;21275;103,2;35,4;327,8
2015;3511607;Cesário Lange;17013;8782;8231;93,7;34,4;89,4
2015;3511706;Charqueada;15338;7739;7599;98,2;34,4;87,2
2015;3511904;Clementina;7120;3623;3497;96,5;33,8;42,2
2015;3512001;Colina;17944;8809;9135;103,7;35,8;42,5
2015;3512100;Colômbia;6362;3224;3138;97,3;34,3;8,7
2015;3512209;Conchal;26546;13349;13197;98,9;33,1;145,2
2015;3512308;Conchas;15931;7997;7934;99,2;36,6;34,2
2015;3512407;Cordeirópolis;22553;11256;11297;100,4;34,4;163,9
2015;3512506;Coroados;5362;2670;2692;100,8;36,2;21,7
2015;3512605;Coronel Macedo;4748;2418;2330;96,4;36,2;15,6
2015;3512704;Corumbataí;4029;2030;1999;98,5;35;14,5
2015;3512803;Cosmópolis;59703;29641;30062;101,4;33,7;386
2015;3512902;Cosmorama;7835;3936;3899;99,1;38,7;17,7
2015;3513009;Cotia;231872;113107;118765;105;32,6;715,7
2015;3513108;Cravinhos;32572;16203;16369;101;35;104,6
2015;3513207;Cristais Paulista;8270;4167;4103;98,5;34,7;21,5
2015;3513306;Cruzália;2207;1084;1123;103,6;38,5;14,8
2015;3513405;Cruzeiro;76914;37217;39697;106,7;35,8;251,6
2015;3513504;Cubatão;117369;57679;59690;103,5;32,7;821,5
2015;3513603;Cunha;22052;11246;10806;96,1;36,4;15,7
2015;3513702;Descalvado;31536;15528;16008;103,1;36,9;41,8
2015;3513801;Diadema;393194;189363;203831;107,6;33;12794,3
2015;3513850;Dirce Reis;1665;859;806;93,8;39,4;18,9
2015;3513900;Divinolândia;11270;5601;5669;101,2;38,4;50,4
2015;3514007;Dobrada;8362;4252;4110;96,7;32,1;55,8
2015;3514106;Dois Córregos;24837;12366;12471;100,8;35,4;39,2
2015;3514205;Dolcinópolis;2139;1099;1040;94,6;39,2;27,4
2015;3514304;Dourado;8441;4238;4203;99,2;38;41
2015;3514403;Dracena;44400;21895;22505;102,8;38,5;91
2015;3514502;Duartina;12352;6023;6329;105,1;38,4;46,7
2015;3514601;Dumont;8649;4331;4318;99,7;33,9;77,7
2015;3514700;Echaporã;6292;3098;3194;103,1;36,4;12,2
2015;3514809;Eldorado;14072;7140;6932;97,1;33,1;8,5
2015;3514908;Elias Fausto;16606;8491;8115;95,6;33,6;82,1
2015;3514924;Elisiário;3148;1628;1520;93,4;36,8;33,5
2015;3514957;Embaúba;2395;1234;1161;94,1;37,5;28,8
2015;3515004;Embu das Artes;246842;119637;127205;106,3;31,6;3506,4
2015;3515103;Embu-Guaçu;65027;32224;32803;101,8;33,1;417,8
2015;3515129;Emilianópolis;3053;1529;1524;99,7;38,5;13,6
2015;3515152;Engenheiro Coelho;17266;8883;8383;94,4;31;157
2015;3515186;Espírito Santo do Pinhal;41294;20135;21159;105,1;37,4;106,1
2015;3515194;Espírito Santo do Turvo;4215;2122;2093;98,6;32,5;21,8
2015;3515202;Estrela d'Oeste;8725;4408;4317;97,9;37,6;29,4
2015;3515301;Estrela do Norte;2706;1363;1343;98,5;35,1;10,2
2015;3515350;Euclides da Cunha Paulista;8979;4490;4489;100;34,5;15,6
2015;3515400;Fartura;15953;7746;8207;106;36,6;37,2
2015;3515509;Fernandópolis;67707;32802;34905;106,4;38;123,1
2015;3515608;Fernando Prestes;5714;2821;2893;102,6;39,1;33,6
2015;3515657;Fernão;1606;817;789;96,6;36,7;16
2015;3515707;Ferraz de Vasconcelos;173487;84408;89079;105,5;31,7;5871,5
2015;3515806;Flora Rica;1656;831;825;99,3;40,8;7,4
2015;3515905;Floreal;2911;1438;1473;102,4;42;14,3
2015;3516002;Flórida Paulista;12933;7096;5837;82,3;36,3;24,7
2015;3516101;Florínea;3299;1814;1485;81,9;37,1;14,6
2015;3516200;Franca;333905;162513;171392;105,5;34,9;551,3
2015;3516309;Francisco Morato;159620;78791;80829;102,6;30,7;3257,5
2015;3516408;Franco da Rocha;137457;69899;67558;96,7;32,1;1035,3
2015;3516507;Gabriel Monteiro;2760;1388;1372;98,8;39,1;19,9
2015;3516606;Gália;6819;3381;3438;101,7;38,3;19,2
2015;3516705;Garça;43039;20859;22180;106,3;36,9;77,4
2015;3516804;Gastão Vidigal;3863;1989;1874;94,2;36,3;21,4
2015;3516853;Gavião Peixoto;4554;2314;2240;96,8;33,6;18,7
2015;3516903;General Salgado;10604;5295;5309;100,3;38,2;21,4
2015;3517000;Getulina;10625;5792;4833;83,4;36,4;15,7
2015;3517109;Glicério;4436;2198;2238;101,8;36,7;16,3
2015;3517208;Guaiçara;10966;5479;5487;100,1;34,3;39,6
2015;3517307;Guaimbê;5487;2730;2757;101;35,5;25,2
2015;3517406;Guaíra;38392;18882;19510;103,3;35,7;30,5
2015;3517505;Guapiaçu;19431;9734;9697;99,6;35,5;59,8
2015;3517604;Guapiara;17794;9031;8763;97;34,6;43,6
2015;3517703;Guará;19480;9619;9861;102,5;33,9;53,8
2015;3517802;Guaraçaí;8112;4025;4087;101,5;39,3;14,3
2015;3517901;Guaraci;10212;5164;5048;97,8;35,4;15,9
2015;3518008;Guarani d'Oeste;1982;979;1003;102,5;38,5;23,1
2015;3518107;Guarantã;6443;3210;3233;100,7;34,3;14
2015;3518206;Guararapes;30994;15202;15792;103,9;37,2;32,4
2015;3518305;Guararema;28170;14068;14102;100,2;34,7;104
2015;3518404;Guaratinguetá;114906;55213;59693;108,1;36,3;152,7
2015;3518503;Guareí;14814;8995;5819;64,7;34,4;26,1
2015;3518602;Guariba;36659;18147;18512;102;33,2;135,6
2015;3518701;Guarujá;291885;141496;150389;106,3;33,3;2015,9
2015;3518800;Guarulhos;1258417;609863;648554;106,3;32,8;3948,9
2015;3518859;Guatapará;7161;3648;3513;96,3;34,4;17,3
2015;3518909;Guzolândia;4586;2352;2234;95;35,6;18,2
2015;3519006;Herculândia;8925;4429;4496;101,5;35,4;24,5
2015;3519055;Holambra;12793;6435;6358;98,8;34;195,1
2015;3519071;Hortolândia;211298;106057;105241;99,2;32,5;3385,3
2015;3519105;Iacanga;10202;5173;5029;97,2;36;18,6
2015;3519204;Iacri;6360;3200;3160;98,8;37,5;19,8
2015;3519253;Iaras;7055;4682;2373;50,7;34,8;17,6
2015;3519303;Ibaté;31453;15974;15479;96,9;32,7;108,1
2015;3519402;Ibirá;11252;5553;5699;102,6;37,4;41,4
2015;3519501;Ibirarema;6641;3332;3309;99,3;36;29,1
2015;3519600;Ibitinga;56202;27658;28544;103,2;35,6;81,5
2015;3519709;Ibiúna;73346;37125;36221;97,6;34;69,3
2015;3519808;Icém;7681;4051;3630;89,6;35;21,2
2015;3519907;Iepê;7660;3761;3899;103,7;37,2;12,9
2015;3520004;Igaraçu do Tietê;23377;11656;11721;100,6;34,7;239,2
2015;3520103;Igarapava;27364;13398;13966;104,2;36;58,4
2015;3520202;Igaratá;9630;4888;4742;97;35;32,9
2015;3520301;Iguape;29135;14626;14509;99,2;36,3;14,7
2015;3520400;Ilhabela;30927;15553;15374;98,8;32,7;89,3
2015;3520426;Ilha Comprida;10895;5400;5495;101,8;38,4;55,4
2015;3520442;Ilha Solteira;25501;12411;13090;105,5;37,8;39,1
2015;3520509;Indaiatuba;224024;110554;113470;102,6;34,8;719,1
2015;3520608;Indiana;4979;2501;2478;99,1;37,1;38,5
2015;3520707;Indiaporã;3997;1956;2041;104,3;39,9;14,3
2015;3520806;Inúbia Paulista;3652;1813;1839;101,4;37,1;41,9
2015;3520905;Ipaussu;13724;6841;6883;100,6;34,9;65,5
2015;3521002;Iperó;31754;17047;14707;86,3;32,4;186,5
2015;3521101;Ipeúna;6432;3283;3149;95,9;33,6;33,9
2015;3521150;Ipiguá;5395;2728;2667;97,8;36,5;39,7
2015;3521200;Iporanga;4220;2132;2088;97,9;33,2;3,7
2015;3521309;Ipuã;14362;7245;7117;98,2;33,6;30,8
2015;3521408;Iracemápolis;20873;10426;10447;100,2;34,6;181,3
2015;3521507;Irapuã;7164;3684;3480;94,5;35,8;27,8
2015;3521606;Irapuru;7565;4376;3189;72,9;38,2;35,3
2015;3521705;Itaberá;17990;9054;8936;98,7;34,8;16,4
2015;3521804;Itaí;24616;12939;11677;90,2;34,1;22,5
2015;3521903;Itajobi;15580;7834;7746;98,9;38,1;31
2015;3522000;Itaju;3389;1744;1645;94,3;35,5;14,7
2015;3522109;Itanhaém;98315;47534;50781;106,8;36;163,4
2015;3522158;Itaoca;3308;1699;1609;94,7;35,9;18,1
2015;3522208;Itapecerica da Serra;156475;77520;78955;101,9;31,8;1038
2015;3522307;Itapetininga;150535;75215;75320;100,1;34,1;84,1
2015;3522406;Itapeva;89140;43870;45270;103,2;33,3;48,8
2015;3522505;Itapevi;214660;105211;109449;104;30,7;2597
2015;3522604;Itapira;70285;34667;35618;102,7;37,2;135,6
2015;3522653;Itapirapuã Paulista;4037;2085;1952;93,6;31,7;9,9
2015;3522703;Itápolis;40062;19767;20295;102,7;37,2;40,2
2015;3522802;Itaporanga;14504;7200;7304;101,4;35,9;28,6
2015;3522901;Itapuí;12812;6436;6376;99,1;34,3;91,5
2015;3523008;Itapura;4238;2166;2072;95,7;35,8;14
2015;3523107;Itaquaquecetuba;342265;168138;174127;103,6;30,7;4142,6
2015;3523206;Itararé;46895;22952;23943;104,3;34,4;46,7
2015;3523305;Itariri;15551;7792;7759;99,6;33;56,8
2015;3523404;Itatiba;110290;54312;55978;103,1;35,3;342,2
2015;3523503;Itatinga;18629;9670;8959;92,6;32,5;19
2015;3523602;Itirapina;15819;9310;6509;69,9;34,1;28
2015;3523701;Itirapuã;5881;2994;2887;96,4;34,3;36,5
2015;3523800;Itobi;7750;3981;3769;94,7;35,5;55,8
2015;3523909;Itu;160946;79209;81737;103,2;34,5;251,2
2015;3524006;Itupeva;55568;28081;27487;97,9;32,2;276,6
2015;3524105;Ituverava;38398;18660;19738;105,8;36,7;54,5
2015;3524204;Jaborandi;6500;3257;3243;99,6;35,9;23,8
2015;3524303;Jaboticabal;72182;34786;37396;107,5;36,8;102,2
2015;3524402;Jacareí;224970;109304;115666;105,8;34,9;484,6
2015;3524501;Jaci;6452;3281;3171;96,6;34,1;44,5
2015;3524600;Jacupiranga;16805;8474;8331;98,3;34,1;23,9
2015;3524709;Jaguariúna;50476;24837;25639;103,2;34,4;357
2015;3524808;Jales;48032;23383;24649;105,4;38,4;130,3
2015;3524907;Jambeiro;5793;2955;2838;96;35;31,4
2015;3525003;Jandira;112919;55101;57818;104,9;31,8;6471,3
2015;3525102;Jardinópolis;40766;20760;20006;96,4;34,2;81,2
2015;3525201;Jarinu;29569;14878;14691;98,7;33,7;142,5
2015;3525300;Jaú;132625;64624;68001;105,2;36,3;193
2015;3525409;Jeriquara;3452;1775;1677;94,5;32,8;24,3
2015;3525508;Joanópolis;12253;6191;6062;97,9;36,7;32,7
2015;3525607;João Ramalho;4265;2149;2116;98,5;33,8;10,3
2015;3525706;José Bonifácio;34482;17120;17362;101,4;35,6;40,1
2015;3525805;Júlio Mesquita;4383;2149;2234;104;35,2;34,2
2015;3525854;Jumirim;2911;1474;1437;97,5;34,1;51,4
2015;3525904;Jundiaí;400386;194100;206286;106,3;36,6;928,5
2015;3526001;Junqueirópolis;19553;10293;9260;90;37,7;33,6
2015;3526100;Juquiá;18558;9368;9190;98,1;34,9;22,8
2015;3526209;Juquitiba;28353;14322;14031;98;33,3;54,3
2015;3526308;Lagoinha;4930;2511;2419;96,3;38,7;19,3
2015;3526407;Laranjal Paulista;25698;12625;13073;103,5;36,2;66,9
2015;3526506;Lavínia;9144;6587;2557;38,8;35,5;17
2015;3526605;Lavrinhas;6881;3445;3436;99,7;32,3;41,2
2015;3526704;Leme;95042;47246;47796;101,2;34,3;235,9
2015;3526803;Lençóis Paulista;63892;31622;32270;102;34,6;78,9
2015;3526902;Limeira;283637;138924;144713;104,2;35,7;488,4
2015;3527009;Lindóia;6883;3408;3475;102;36,5;141,2
2015;3527108;Lins;73226;35381;37845;107;36,9;128,5
2015;3527207;Lorena;83780;40311;43469;107,8;35,4;202,3
2015;3527256;Lourdes;2080;1058;1022;96,6;38,6;18,3
2015;3527306;Louveira;43040;21626;21414;99;32;772,2
2015;3527405;Lucélia;20100;10865;9235;85;37,5;63,8
2015;3527504;Lucianópolis;2299;1150;1149;99,9;36,5;12,1
2015;3527603;Luís Antônio;11761;5981;5780;96,6;31,9;19,7
2015;3527702;Luiziânia;4924;2510;2414;96,2;35,4;29,6
2015;3527801;Lupércio;4222;2056;2166;105,4;35,4;27,2
2015;3527900;Lutécia;2727;1359;1368;100,7;36,5;5,7
2015;3528007;Macatuba;16645;8299;8346;100,6;34,6;74,1
2015;3528106;Macaubal;7596;3819;3777;98,9;39,4;30,6
2015;3528205;Macedônia;3793;1901;1892;99,5;39,1;11,6
2015;3528304;Magda;3239;1636;1603;98;39,7;10,4
2015;3528403;Mairinque;46348;23206;23142;99,7;34;220,5
2015;3528502;Mairiporã;86768;43594;43174;99;34,2;270,6
2015;3528601;Manduri;9399;4692;4707;100,3;36,3;41
2015;3528700;Marabá Paulista;4724;2977;1747;58,7;34,9;5,1
2015;3528809;Maracaí;13149;6542;6607;101;35,8;24,6
2015;3528858;Marapoama;2914;1492;1422;95,3;36,9;26,2
2015;3528908;Mariápolis;3769;1917;1852;96,6;37,3;20,2
2015;3529005;Marília;226035;108857;117178;107,6;36,4;193,1
2015;3529104;Marinópolis;2037;1032;1005;97,4;38;26,2
2015;3529203;Martinópolis;24596;12731;11865;93,2;36,3;19,6
2015;3529302;Matão;78293;38657;39636;102,5;36;149,2
2015;3529401;Mauá;420186;204450;215736;105,5;33,3;6784,1
2015;3529500;Mendonça;5265;2659;2606;98;37,2;27
2015;3529609;Meridiano;4187;2050;2137;104,2;37,8;18,3
2015;3529658;Mesópolis;1909;971;938;96,6;36,8;12,8
2015;3529708;Miguelópolis;20229;10021;10208;101,9;34,3;24,6
2015;3529807;Mineiros do Tietê;11803;5870;5933;101,1;35,5;55,4
2015;3529906;Miracatu;19876;9998;9878;98,8;33,6;19,8
2015;3530003;Mira Estrela;2950;1470;1480;100,7;39,2;13,6
2015;3530102;Mirandópolis;27936;15539;12397;79,8;38,2;30,4
2015;3530201;Mirante do Paranapanema;16771;8454;8317;98,4;37;13,5
2015;3530300;Mirassol;57909;28274;29635;104,8;36,6;238,1
2015;3530409;Mirassolândia;4436;2254;2182;96,8;36,6;26,7
2015;3530508;Mococa;67303;33320;33983;102;36,8;78,7
2015;3530607;Mogi das Cruzes;415715;201510;214205;106,3;33,9;583,4
2015;3530706;Mogi Guaçu;144772;71331;73441;103;35,5;178,1
2015;3530805;Mogi Mirim;89677;43943;45734;104,1;36,6;180,2
2015;3530904;Mombuca;3462;1735;1727;99,5;33,5;25,9
2015;3531001;Monções;2073;1056;1017;96,3;40,2;19,9
2015;3531100;Mongaguá;52977;26666;26311;98,7;36,3;371,1
2015;3531209;Monte Alegre do Sul;7820;3888;3932;101,1;38,4;70,9
2015;3531308;Monte Alto;47296;23245;24051;103,5;37,6;136,3
2015;3531407;Monte Aprazível;22069;10898;11171;102,5;37,7;44,5
2015;3531506;Monte Azul Paulista;18721;9388;9333;99,4;37;71,1
2015;3531605;Monte Castelo;4144;2055;2089;101,7;38,7;17,7
2015;3531704;Monteiro Lobato;4164;2133;2031;95,2;36,5;12,5
2015;3531803;Monte Mor;55593;27640;27953;101,1;32,7;231,1
2015;3531902;Morro Agudo;28949;14531;14418;99,2;33,1;20,9
2015;3532009;Morungaba;12658;6276;6382;101,7;34,6;86,3
2015;3532058;Motuca;4193;2120;2073;97,8;35;18,3
2015;3532108;Murutinga do Sul;4027;2016;2011;99,8;40,3;16,1
2015;3532157;Nantes;2704;1344;1360;101,2;33,2;9,4
2015;3532207;Narandiba;4910;2470;2440;98,8;33,1;13,7
2015;3532306;Natividade da Serra;6833;3566;3267;91,6;38,1;8,2
2015;3532405;Nazaré Paulista;17291;8854;8437;95,3;35,9;53
2015;3532504;Neves Paulista;9169;4551;4618;101,5;39,8;41,9
2015;3532603;Nhandeara;10434;5086;5348;105,2;40,3;23,9
2015;3532702;Nipoã;4475;2332;2143;91,9;34,5;32,5
2015;3532801;Nova Aliança;6224;3078;3146;102,2;37;28,6
2015;3532827;Nova Campina;8526;4311;4215;97,8;30,7;22,1
2015;3532843;Nova Canaã Paulista;2087;1059;1028;97,1;41,9;16,8
2015;3532868;Nova Castilho;1116;554;562;101,4;36,4;6,1
2015;3532900;Nova Europa;9374;4695;4679;99,7;34,2;58,5
2015;3533007;Nova Granada;19337;9677;9660;99,8;36,1;36,4
2015;3533106;Nova Guataporanga;2176;1086;1090;100,4;39,1;63,7
2015;3533205;Nova Independência;3704;1913;1791;93,6;33,4;14
2015;3533254;Novais;4542;2380;2162;90,8;32,3;38,6
2015;3533304;Nova Luzitânia;3241;1672;1569;93,8;36;43,9
2015;3533403;Nova Odessa;55874;27517;28357;103,1;35,3;757,2
2015;3533502;Novo Horizonte;37483;18608;18875;101,4;36,7;40,2
2015;3533601;Nuporanga;7059;3516;3543;100,8;36;20,3
2015;3533700;Ocauçu;4231;2167;2064;95,2;36,1;14,1
2015;3533809;Óleo;2614;1322;1292;97,7;38,4;13,1
2015;3533908;Olímpia;52396;25689;26707;104;36,4;65,3
2015;3534005;Onda Verde;4252;2169;2083;96;34,6;17,5
2015;3534104;Oriente;6142;2982;3160;106;37,7;28,1
2015;3534203;Orindiúva;5858;2959;2899;98;33;23,7
2015;3534302;Orlândia;39497;19252;20245;105,2;35,7;135,4
2015;3534401;Osasco;698037;334258;363779;108,8;34,1;10746,6
2015;3534500;Oscar Bressane;2533;1223;1310;107,1;40,3;11,4
2015;3534609;Osvaldo Cruz;31215;15628;15587;99,7;38,7;125,8
2015;3534708;Ourinhos;104198;50159;54039;107,7;36;352,2
2015;3534757;Ouroeste;9273;4605;4668;101,4;36,1;32,1
2015;3534807;Ouro Verde;7874;3852;4022;104,4;35,3;29,5
2015;3534906;Pacaembu;13966;8619;5347;62;37,8;41,2
2015;3535002;Palestina;11252;5655;5597;99;37,6;16,1
2015;3535101;Palmares Paulista;10466;5439;5027;92,4;32;127,4
2015;3535200;Palmeira d'Oeste;9363;4686;4677;99,8;40,1;29,4
2015;3535309;Palmital;20684;10095;10589;104,9;38,2;37,7
2015;3535408;Panorama;14917;7436;7481;100,6;34,2;41,9
2015;3535507;Paraguaçu Paulista;42004;21060;20944;99,4;35,6;41,9
2015;3535606;Paraibuna;17625;8944;8681;97,1;35,6;21,8
2015;3535705;Paraíso;6017;3056;2961;96,9;36,9;38,8
2015;3535804;Paranapanema;18494;9413;9081;96,5;33,3;18,2
2015;3535903;Paranapuã;3911;1981;1930;97,4;36,9;27,9
2015;3536000;Parapuã;10805;5448;5357;98,3;38,5;29,5
2015;3536109;Pardinho;6287;3192;3095;97;34,1;30
2015;3536208;Pariquera-Açu;18863;9346;9517;101,8;34,5;52,5
2015;3536257;Parisi;2377;1187;1190;100,3;38,3;28,1
2015;3536307;Patrocínio Paulista;13696;6931;6765;97,6;34,3;22,7
2015;3536406;Paulicéia;7061;3615;3446;95,3;34;18,9
2015;3536505;Paulínia;93778;46071;47707;103,6;33,6;675,7
2015;3536570;Paulistânia;1896;967;929;96,1;35,7;7,4
2015;3536604;Paulo de Faria;8158;4094;4064;99,3;36,5;11,1
2015;3536703;Pederneiras;43124;21570;21554;99,9;34,7;59,3
2015;3536802;Pedra Bela;6097;3183;2914;91,5;37,1;38,4
2015;3536901;Pedranópolis;2674;1359;1315;96,8;39,8;10,3
2015;3537008;Pedregulho;15709;7941;7768;97,8;34,6;22
2015;3537107;Pedreira;42397;20920;21477;102,7;35,9;389,6
2015;3537156;Pedrinhas Paulista;2879;1421;1458;102,6;37,5;18,9
2015;3537206;Pedro de Toledo;10730;5460;5270;96,5;35;16
2015;3537305;Penápolis;60027;29136;30891;106;37,2;84,4
2015;3537404;Pereira Barreto;24881;12153;12728;104,7;37,1;25,5
2015;3537503;Pereiras;7978;4015;3963;98,7;35,6;35,8
2015;3537602;Peruíbe;63719;30943;32776;105,9;36,1;195,3
2015;3537701;Piacatu;5458;2739;2719;99,3;37;23,5
2015;3537800;Piedade;52684;26698;25986;97,3;35,5;70,5
2015;3537909;Pilar do Sul;27092;13752;13340;97;34,4;39,8
2015;3538006;Pindamonhangaba;155234;75898;79336;104,5;34,2;212,3
2015;3538105;Pindorama;14935;7556;7379;97,7;37,8;80,8
2015;3538204;Pinhalzinho;14012;7022;6990;99,5;37,5;90,7
2015;3538303;Piquerobi;3451;1684;1767;104,9;37,7;7,1
2015;3538501;Piquete;13568;6541;7027;107,4;37,4;77,1
2015;3538600;Piracaia;25611;12653;12958;102,4;36,5;66,4
2015;3538709;Piracicaba;390420;190162;200258;105,3;35,7;283,3
2015;3538808;Piraju;29031;14065;14966;106,4;36,9;57,5
2015;3538907;Pirajuí;22715;12268;10447;85,2;36,7;27,6
2015;3539004;Pirangi;10759;5421;5338;98,5;37,9;49,9
2015;3539103;Pirapora do Bom Jesus;16756;8332;8424;101,1;30,8;154,4
2015;3539202;Pirapozinho;25050;12228;12822;104,9;35,9;52,4
2015;3539301;Pirassununga;71781;34922;36859;105,5;36,8;98,7
2015;3539400;Piratininga;13346;6560;6786;103,4;36,7;33,2
2015;3539509;Pitangueiras;34906;17619;17287;98,1;33;81,1
2015;3539608;Planalto;4476;2273;2203;96,9;34,7;15,4
2015;3539707;Platina;3165;1625;1540;94,8;35,4;9,7
2015;3539806;Poá;106118;51201;54917;107,3;33,4;6146,9
2015;3539905;Poloni;5511;2709;2802;103,4;38,2;40,8
2015;3540002;Pompéia;20150;9882;10268;103,9;36,7;25,7
2015;3540101;Pongaí;3461;1769;1692;95,6;39,5;18,9
2015;3540200;Pontal;39325;20317;19008;93,6;31,6;110,3
2015;3540259;Pontalinda;4128;2201;1927;87,6;34,8;19,7
2015;3540309;Pontes Gestal;2504;1246;1258;101;37,8;11,5
2015;3540408;Populina;4228;2121;2107;99,3;38,9;13,4
2015;3540507;Porangaba;9253;4743;4510;95,1;38,1;34,8
2015;3540606;Porto Feliz;52169;26338;25831;98,1;35,1;93,7
2015;3540705;Porto Ferreira;52179;25694;26485;103,1;35,9;213,1
2015;3540754;Potim;19867;11215;8652;77,1;31,7;445
2015;3540804;Potirendaba;16740;8399;8341;99,3;37;48,9
2015;3540853;Pracinha;2753;1991;762;38,3;33,2;43,7
2015;3540903;Pradópolis;17370;8750;8620;98,5;33,9;103,8
2015;3541000;Praia Grande;299803;143380;156423;109,1;34,9;2003,3
2015;3541059;Pratânia;4831;2458;2373;96,5;32,5;27,6
2015;3541109;Presidente Alves;4033;1999;2034;101,8;37,1;14,1
2015;3541208;Presidente Bernardes;14041;7298;6743;92,4;39,1;18,7
2015;3541307;Presidente Epitácio;40861;19901;20960;105,3;35,7;32,4
2015;3541406;Presidente Prudente;215934;103690;112244;108,2;36,7;385,2
2015;3541505;Presidente Venceslau;37074;18259;18815;103;38,2;49,1
2015;3541604;Promissão;35802;17724;18078;102;35,5;45,9
2015;3541653;Quadra;3302;1721;1581;91,9;36,1;16,1
2015;3541703;Quatá;13008;6485;6523;100,6;34,8;20
2015;3541802;Queiroz;2980;1503;1477;98,3;33;12,7
2015;3541901;Queluz;10434;5258;5176;98,4;34;41,8
2015;3542008;Quintana;6422;3160;3262;103,2;35,8;20,1
2015;3542107;Rafard;8770;4336;4434;102,3;35,2;72,1
2015;3542206;Rancharia;28832;14072;14760;104,9;36,4;18,2
2015;3542305;Redenção da Serra;4159;2171;1988;91,6;37,2;13,4
2015;3542404;Regente Feijó;19264;9536;9728;102;36,5;73,2
2015;3542503;Reginópolis;7473;4703;2770;58,9;34,2;18,2
2015;3542602;Registro;57017;28149;28868;102,6;34,5;78,9
2015;3542701;Restinga;6509;3246;3263;100,5;32,7;26,5
2015;3542800;Ribeira;3275;1687;1588;94,1;35,8;9,8
2015;3542909;Ribeirão Bonito;11771;5881;5890;100,2;34,9;25
2015;3543006;Ribeirão Branco;18425;9439;8986;95,2;31,5;26,4
2015;3543105;Ribeirão Corrente;4422;2260;2162;95,7;33,1;29,8
2015;3543204;Ribeirão do Sul;4554;2290;2264;98,9;37,8;22,4
2015;3543238;Ribeirão dos Índios;2133;1054;1079;102,4;39,3;10,9
2015;3543253;Ribeirão Grande;7522;3862;3660;94,8;34,8;22,6
2015;3543303;Ribeirão Pires;114994;55979;59015;105,4;35,6;1161,9
2015;3543402;Ribeirão Preto;646211;309025;337186;109,1;35,8;992,8
2015;3543501;Riversul;5956;2979;2977;99,9;36,1;15,4
2015;3543600;Rifaina;3696;1849;1847;99,9;36,8;22,7
2015;3543709;Rincão;9955;4985;4970;99,7;35;31,4
2015;3543808;Rinópolis;9731;4888;4843;99,1;38,5;27,1
2015;3543907;Rio Claro;193203;93692;99511;106,2;36,3;387,6
2015;3544004;Rio das Pedras;30413;15283;15130;99;33,4;134,2
2015;3544103;Rio Grande da Serra;44415;21911;22504;102,7;32,5;1222,2
2015;3544202;Riolândia;10503;6177;4326;70;34;16,6
2015;3544251;Rosana;18945;9407;9538;101,4;35,2;25,5
2015;3544301;Roseira;10164;5113;5051;98,8;33,9;78,3
2015;3544400;Rubiácea;2727;1381;1346;97,5;34,7;11,5
2015;3544509;Rubinéia;3276;1619;1657;102,3;40,5;13,5
2015;3544608;Sabino;5241;2593;2648;102,1;38,4;17,2
2015;3544707;Sagres;2451;1200;1251;104,3;36,8;16,6
2015;3544806;Sales;5923;2977;2946;99;37,6;19,2
2015;3544905;Sales Oliveira;10973;5375;5598;104,1;36,4;35,9
2015;3545001;Salesópolis;15522;7785;7737;99,4;34,9;36,5
2015;3545100;Salmourão;4813;2453;2360;96,2;36,2;27,8
2015;3545159;Saltinho;7536;3726;3810;102,3;37,1;75,6
2015;3545209;Salto;117445;57829;59616;103,1;34,6;882,7
2015;3545308;Salto de Pirapora;41884;20810;21074;101,3;34,6;149,4
2015;3545407;Salto Grande;8965;4407;4558;103,4;36,4;47,6
2015;3545506;Sandovalina;3710;1877;1833;97,7;33,7;8,1
2015;3545605;Santa Adélia;14230;7067;7163;101,4;36,4;43,1
2015;3545704;Santa Albertina;6029;3036;2993;98,6;39,1;22,1
2015;3545803;Santa Bárbara d'Oeste;182139;89959;92180;102,5;35,7;672
2015;3546009;Santa Branca;13943;6956;6987;100,4;36,3;51,2
2015;3546108;Santa Clara d'Oeste;2315;1179;1136;96,4;37,8;12,6
2015;3546207;Santa Cruz da Conceição;4168;2050;2118;103,3;38,6;27,8
2015;3546256;Santa Cruz da Esperança;2066;1025;1041;101,6;35,9;14
2015;3546306;Santa Cruz das Palmeiras;29717;14946;14771;98,8;34,4;100,6
2015;3546405;Santa Cruz do Rio Pardo;45109;22037;23072;104,7;36,2;40,5
2015;3546504;Santa Ernestina;5830;2964;2866;96,7;33,4;43,4
2015;3546603;Santa Fé do Sul;31550;15199;16351;107,6;38;152,8
2015;3546702;Santa Gertrudes;22577;11420;11157;97,7;32,2;229,7
2015;3546801;Santa Isabel;51918;25861;26057;100,8;34,4;142,9
2015;3546900;Santa Lúcia;7899;3939;3960;100,5;33,9;51,3
2015;3547007;Santa Maria da Serra;5352;2706;2646;97,8;33,8;21,2
2015;3547106;Santa Mercedes;2910;1451;1459;100,6;36,3;17,5
2015;3547205;Santana da Ponte Pensa;1659;843;816;96,8;42,5;12,8
2015;3547304;Santana de Parnaíba;127326;62411;64915;104;32,6;707,6
2015;3547403;Santa Rita d'Oeste;2641;1304;1337;102,5;41,6;12,6
2015;3547502;Santa Rita do Passa Quatro;25946;12499;13447;107,6;39,8;34,4
2015;3547601;Santa Rosa de Viterbo;23893;11687;12206;104,4;36,6;82,8
2015;3547650;Santa Salete;1534;774;760;98,2;40,1;19,4
2015;3547700;Santo Anastácio;19543;9473;10070;106,3;38,1;35,3
2015;3547809;Santo André;710758;339462;371296;109,4;36,9;4043,4
2015;3547908;Santo Antônio da Alegria;6486;3340;3146;94,2;36,8;20,9
2015;3548005;Santo Antônio de Posse;21768;10938;10830;99;34;141,2
2015;3548054;Santo Antônio do Aracanguá;7997;4033;3964;98,3;35,7;6,1
2015;3548104;Santo Antônio do Jardim;6032;3068;2964;96,6;37,2;54,9
2015;3548203;Santo Antônio do Pinhal;6788;3417;3371;98,7;35,5;51
2015;3548302;Santo Expedito;2887;1433;1454;101,5;38,2;30,6
2015;3548401;Santópolis do Aguapeí;4151;2074;2077;100,1;34,4;32,4
2015;3548500;Santos;422420;192577;229843;119,4;40,2;1503,1
2015;3548609;São Bento do Sapucaí;11069;5541;5528;99,8;37,4;43,8
2015;3548708;São Bernardo do Campo;790414;379514;410900;108,3;35,1;1930
2015;3548807;São Caetano do Sul;156991;72140;84851;117,6;40,4;10240,3
2015;3548906;São Carlos;235989;115439;120550;104,4;36,1;207,6
2015;3549003;São Francisco;2740;1360;1380;101,5;39,8;36,3
2015;3549102;São João da Boa Vista;87616;42334;45282;107;37,5;169,7
2015;3549201;São João das Duas Pontes;2608;1299;1309;100,8;37,7;20,1
2015;3549250;São João de Iracema;1801;900;901;100,1;36,9;10,1
2015;3549300;São João do Pau d'Alho;2171;1075;1096;102;41;18,5
2015;3549409;São Joaquim da Barra;47661;23246;24415;105;35,7;116
2015;3549508;São José da Bela Vista;8122;4133;3989;96,5;33,1;29,3
2015;3549607;São José do Barreiro;4008;2017;1991;98,7;35,5;7
2015;3549706;São José do Rio Pardo;52248;25491;26757;105;37,3;124,5
2015;3549805;São José do Rio Preto;440020;210807;229213;108,7;36,9;1018,7
2015;3549904;São José dos Campos;661251;321821;339430;105,5;34,5;601,5
2015;3549953;São Lourenço da Serra;14897;7529;7368;97,9;34;79,9
2015;3550001;São Luiz do Paraitinga;10437;5310;5127;96,6;37,9;16,9
2015;3550100;São Manuel;38086;18654;19432;104,2;35,6;58,5
2015;3550209;São Miguel Arcanjo;31893;16168;15725;97,3;34;34,3
2015;3550308;São Paulo;11418821;5395293;6023528;111,6;35,5;7506,4
2015;3550407;São Pedro;34508;16798;17710;105,4;37,3;56,5
2015;3550506;São Pedro do Turvo;7207;3665;3542;96,6;35,2;9,9
2015;3550605;São Roque;79277;38888;40389;103,9;35,9;258,3
2015;3550704;São Sebastião;77361;38308;39053;101,9;32,6;192,3
2015;3550803;São Sebastião da Grama;11534;5833;5701;97,7;36,4;45,7
2015;3550902;São Simão;14094;6936;7158;103,2;36,8;22,8
2015;3551009;São Vicente;334786;161044;173742;107,9;34,7;2259,8
2015;3551108;Sarapuí;9646;4895;4751;97,1;34,6;27,4
2015;3551207;Sarutaiá;3683;1847;1836;99,4;35,6;26
2015;3551306;Sebastianópolis do Sul;3098;1527;1571;102,9;38,2;18,5
2015;3551405;Serra Azul;11921;7418;4503;60,7;34;42,1
2015;3551504;Serrana;41155;20459;20696;101,2;32,2;326,5
2015;3551603;Serra Negra;27985;13585;14400;106;38,6;137,4
2015;3551702;Sertãozinho;117777;57955;59822;103,2;34,2;292,2
2015;3551801;Sete Barras;12964;6640;6324;95,2;34,2;12,2
2015;3551900;Severínia;15216;7867;7349;93,4;33,6;108,3
2015;3552007;Silveiras;5986;3007;2979;99,1;35,2;14,4
2015;3552106;Socorro;38269;18915;19354;102,3;38,6;85,2
2015;3552205;Sorocaba;645481;314263;331218;105,4;34,8;1434,8
2015;3552304;Sud Mennucci;7439;3719;3720;100;35,7;12,5
2015;3552403;Sumaré;258079;127393;130686;102,6;33,1;1681,7
2015;3552502;Suzano;282191;137634;144557;105;32,8;1368,3
2015;3552551;Suzanápolis;3423;1764;1659;94;36,6;10,4
2015;3552601;Tabapuã;11452;5725;5727;100;37,9;33,1
2015;3552700;Tabatinga;14733;7449;7284;97,8;34,9;40
2015;3552809;Taboão da Serra;258762;123390;135372;109,7;32,9;12692
2015;3552908;Taciba;5969;2962;3007;101,5;35,1;9,8
2015;3553005;Taguaí;11615;5762;5853;101,6;33;79,9
2015;3553104;Taiaçu;5832;2952;2880;97,6;36,3;54,5
2015;3553203;Taiúva;5928;3107;2821;90,8;37,9;44,8
2015;3553302;Tambaú;22140;10969;11171;101,8;36,1;39,4
2015;3553401;Tanabi;24771;12304;12467;101,3;37,9;33,2
2015;3553500;Tapiraí;8042;4054;3988;98,4;33,4;10,7
2015;3553609;Tapiratiba;12424;6112;6312;103,3;36,7;56
2015;3553658;Taquaral;2739;1366;1373;100,5;36,3;50,8
2015;3553708;Taquaritinga;53633;26315;27318;103,8;36,4;90,2
2015;3553807;Taquarituba;23252;11763;11489;97,7;35;51,8
2015;3553856;Taquarivaí;5818;2933;2885;98,4;31,1;25,1
2015;3553906;Tarabai;6606;3270;3336;102;34,1;32,8
2015;3553955;Tarumã;13804;6970;6834;98;33,3;45,6
2015;3554003;Tatuí;114877;56490;58387;103,4;34,5;219,3
2015;3554102;Taubaté;293605;142996;150609;105,3;35,2;469,8
2015;3554201;Tejupá;4551;2329;2222;95,4;33,6;15,4
2015;3554300;Teodoro Sampaio;21841;10846;10995;101,4;33,6;14
2015;3554409;Terra Roxa;8304;4175;4129;98,9;35,8;37,5
2015;3554508;Tietê;37260;18418;18842;102,3;36;92,1
2015;3554607;Timburi;2590;1314;1276;97,1;38,4;13,2
2015;3554656;Torre de Pedra;2183;1129;1054;93,4;37,9;30,6
2015;3554706;Torrinha;9315;4680;4635;99;37,8;29,5
2015;3554755;Trabiju;1605;806;799;99,1;34,2;25,3
2015;3554805;Tremembé;45372;24104;21268;88,2;34,4;237,4
2015;3554904;Três Fronteiras;6027;3022;3005;99,4;38,5;39,8
2015;3554953;Tuiuti;6336;3206;3130;97,6;38,6;50
2015;3555000;Tupã;63952;30794;33158;107,7;38,6;101,8
2015;3555109;Tupi Paulista;15030;7835;7195;91,8;40,3;61,4
2015;3555208;Turiúba;1900;970;930;95,9;40,2;12,4
2015;3555307;Turmalina;1855;914;941;103;42,8;12,6
2015;3555356;Ubarana;5350;2739;2611;95,3;33;25,5
2015;3555406;Ubatuba;84447;41895;42552;101,6;33,6;119,3
2015;3555505;Ubirajara;4705;2433;2272;93,4;34,9;16,7
2015;3555604;Uchoa;9940;4915;5025;102,2;38,1;39,4
2015;3555703;União Paulista;1622;823;799;97,1;34,8;20,5
2015;3555802;Urânia;8871;4391;4480;102;38,8;42,4
2015;3555901;Uru;1329;672;657;97,8;38,3;9
2015;3556008;Urupês;13203;6530;6673;102,2;38,7;40,8
2015;3556107;Valentim Gentil;12318;6163;6155;99,9;35,4;82,3
2015;3556206;Valinhos;115252;56585;58667;103,7;36,6;775,9
2015;3556305;Valparaíso;23429;12936;10493;81,1;34,4;27,3
2015;3556354;Vargem;9490;4861;4629;95,2;35,8;66,6
2015;3556404;Vargem Grande do Sul;39711;19643;20068;102,2;35,7;148,6
2015;3556453;Vargem Grande Paulista;46404;22894;23510;102,7;33,3;1092,1
2015;3556503;Várzea Paulista;111889;55690;56199;100,9;32,8;3185,9
2015;3556602;Vera Cruz;10567;5188;5379;103,7;37,7;42,7
2015;3556701;Vinhedo;69232;34045;35187;103,4;35,7;855,2
2015;3556800;Viradouro;17490;8739;8751;100,1;35,2;80,3
2015;3556909;Vista Alegre do Alto;7379;3765;3614;96;33,8;77,3
2015;3556958;Vitória Brasil;1785;912;873;95,7;37,5;35,8
2015;3557006;Votorantim;117218;57790;59428;102,8;33,6;636,4
2015;3557105;Votuporanga;89851;43624;46227;106;37,4;213,6
2015;3557154;Zacarias;2518;1260;1258;99,8;37,3;7,9
2015;3557204;Chavantes;12299;6060;6239;103;35,5;65,2
2015;3557303;Estiva Gerbi;10568;5315;5253;98,8;34,4;142,5
2016;3500105;Adamantina;34366;16598;17768;107;39,4;83,4
2016;3500204;Adolfo;3972;1978;1994;100,8;38;18,8
2016;3500303;Aguaí;32179;16078;16101;100,1;34,9;67,8
2016;3500402;Águas da Prata;7542;3675;3867;105,2;40,3;52,9
2016;3500501;Águas de Lindóia;17753;8666;9087;104,9;38,3;295,3
2016;3500550;Águas de Santa Bárbara;6462;3216;3246;100,9;37,1;16
2016;3500600;Águas de São Pedro;2744;1283;1461;113,9;43,4;759,7
2016;3500709;Agudos;36235;17850;18385;103;34,9;37,5
2016;3500758;Alambari;5507;2771;2736;98,7;34,4;34,5
2016;3500808;Alfredo Marcondes;4187;2102;2085;99,2;40;35,2
2016;3500907;Altair;3668;1920;1748;91;34,5;11,7
2016;3501004;Altinópolis;16266;8082;8184;101,3;36,7;17,5
2016;3501103;Alto Alegre;4040;2049;1991;97,2;40,5;12,7
2016;3501152;Alumínio;17221;8623;8598;99,7;33,4;205,9
2016;3501202;Álvares Florence;3943;2014;1929;95,8;41,7;10,9
2016;3501301;Álvares Machado;25556;12521;13035;104,1;35,9;73,5
2016;3501400;Álvaro de Carvalho;4750;3094;1656;53,5;34,7;30,9
2016;3501509;Alvinlândia;2968;1464;1504;102,7;35,2;35
2016;3501608;Americana;224716;109275;115441;105,6;37,1;1678,1
2016;3501707;Américo Brasiliense;34109;17011;17098;100,5;33,2;277,4
2016;3501806;Américo de Campos;5850;2880;2970;103,1;39,1;23,1
2016;3501905;Amparo;67300;32943;34357;104,3;37,6;151,1
2016;3502002;Analândia;4448;2258;2190;97;36;13,6
2016;3502101;Andradina;58019;28680;29339;102,3;37,6;60,2
2016;3502200;Angatuba;23190;11689;11501;98,4;35,1;22,6
2016;3502309;Anhembi;5698;2913;2785;95,6;34,6;7,7
2016;3502408;Anhumas;3870;1908;1962;102,8;36,4;12,1
2016;3502507;Aparecida;34110;16427;17683;107,6;36,2;282,2
2016;3502606;Aparecida d'Oeste;4303;2126;2177;102,4;40,5;24
2016;3502705;Apiaí;25156;12584;12572;99,9;34;25,8
2016;3502754;Araçariguama;19229;9727;9502;97,7;31,7;132,4
2016;3502804;Araçatuba;192027;91844;100183;109,1;37,5;164,5
2016;3502903;Araçoiaba da Serra;30054;14970;15084;100,8;36,8;117,7
2016;3503000;Aramina;5344;2644;2700;102,1;37,2;26,3
2016;3503109;Arandu;6485;3258;3227;99;34,9;22,7
2016;3503158;Arapeí;2438;1224;1214;99,2;36,8;15,5
2016;3503208;Araraquara;226306;108851;117455;107,9;37,1;225,5
2016;3503307;Araras;125350;61295;64055;104,5;36,4;194,4
2016;3503356;Arco-Íris;2010;1015;995;98;38;7,6
2016;3503406;Arealva;8016;4043;3973;98,3;39,4;15,8
2016;3503505;Areias;3662;1836;1826;99,5;35;12
2016;3503604;Areiópolis;10454;5335;5119;96;32,8;121,7
2016;3503703;Ariranha;8171;4110;4061;98,8;37;61,6
2016;3503802;Artur Nogueira;47937;23789;24148;101,5;34;269,3
2016;3503901;Arujá;81028;39683;41345;104,2;33,3;842,6
2016;3503950;Aspásia;1828;915;913;99,8;39,2;26,4
2016;3504008;Assis;98865;47875;50990;106,5;37,1;214,6
2016;3504107;Atibaia;143086;69806;73280;105;36;299
2016;3504206;Auriflama;14063;6985;7078;101,3;38,2;32,4
2016;3504305;Avaí;4744;2374;2370;99,8;35,2;8,8
2016;3504404;Avanhandava;11351;6262;5089;81,3;33,6;33,5
2016;3504503;Avaré;88347;43802;44545;101,7;35,6;72,8
2016;3504602;Bady Bassitt;20794;10253;10541;102,8;35;188,4
2016;3504701;Balbinos;3784;3071;713;23,2;35,3;41,3
2016;3504800;Bálsamo;8941;4361;4580;105;38,5;59,7
2016;3504909;Bananal;10184;4994;5190;103,9;36,5;16,5
2016;3505005;Barão de Antonina;3323;1674;1649;98,5;36,1;21,7
2016;3505104;Barbosa;6152;3057;3095;101,2;35,5;30
2016;3505203;Bariri;31729;15711;16018;102;37,1;71,4
2016;3505302;Barra Bonita;35065;17020;18045;106;38,3;233,6
2016;3505351;Barra do Chapéu;5211;2724;2487;91,3;33,5;12,8
2016;3505401;Barra do Turvo;7371;3812;3559;93,4;34,8;7,3
2016;3505500;Barretos;117687;56662;61025;107,7;36,5;75,1
2016;3505609;Barrinha;30467;15172;15295;100,8;31,9;208,6
2016;3505708;Barueri;280088;134992;145096;107,5;32,5;4263,1
2016;3505807;Bastos;21108;10337;10771;104,2;36,2;123,5
2016;3505906;Batatais;57603;28146;29457;104,7;36,8;67,8
2016;3506003;Bauru;363436;175953;187483;106,6;36,3;544,3
2016;3506102;Bebedouro;76047;36924;39123;106;36,9;111,3
2016;3506201;Bento de Abreu;2675;1354;1321;97,6;35,4;8,9
2016;3506300;Bernardino de Campos;11220;5681;5539;97,5;37,7;46
2016;3506359;Bertioga;55929;27940;27989;100,2;32,1;113,8
2016;3506409;Bilac;7261;3575;3686;103,1;38,7;45,9
2016;3506508;Birigui;114644;55730;58914;105,7;36,6;216,3
2016;3506607;Biritiba Mirim;29292;14690;14602;99,4;34,3;92,3
2016;3506706;Boa Esperança do Sul;13401;6684;6717;100,5;34,1;19,4
2016;3506805;Bocaina;11140;5498;5642;102,6;35,7;30,6
2016;3506904;Bofete;10092;5140;4952;96,3;36,7;15,4
2016;3507001;Boituva;54808;27299;27509;100,8;34,3;220,2
2016;3507100;Bom Jesus dos Perdões;20859;10419;10440;100,2;34;192,5
2016;3507159;Bom Sucesso de Itararé;3581;1830;1751;95,7;30,7;26,8
2016;3507209;Borá;863;437;426;97,5;35,7;7,3
2016;3507308;Boracéia;4498;2286;2212;96,8;34,5;36,8
2016;3507407;Borborema;14462;7238;7224;99,8;37,9;26,2
2016;3507456;Borebi;2524;1241;1283;103,4;33,4;7,3
2016;3507506;Botucatu;136889;66132;70757;107;36,1;92,3
2016;3507605;Bragança Paulista;162244;79187;83057;104,9;36;316,5
2016;3507704;Braúna;5186;2588;2598;100,4;37,1;26,6
2016;3507753;Brejo Alegre;2599;1332;1267;95,1;36,5;24,6
2016;3507803;Brodowski;23195;11437;11758;102,8;35,6;83,3
2016;3507902;Brotas;22814;11201;11613;103,7;36;20,7
2016;3508009;Buri;19527;9889;9638;97,5;32,4;16,3
2016;3508108;Buritama;16511;8146;8365;102,7;37,6;50,5
2016;3508207;Buritizal;4215;2103;2112;100,4;37,2;15,8
2016;3508306;Cabrália Paulista;4386;2225;2161;97,1;35;18,3
2016;3508405;Cabreúva;44378;22234;22144;99,6;32,3;170,5
2016;3508504;Caçapava;91060;44854;46206;103;35,3;246,8
2016;3508603;Cachoeira Paulista;30981;15078;15903;105,5;35,9;107,6
2016;3508702;Caconde;17850;8907;8943;100,4;36,8;38,1
2016;3508801;Cafelândia;16747;8162;8585;105,2;36,9;18,2
2016;3508900;Caiabu;3938;1994;1944;97,5;38;15,5
2016;3509007;Caieiras;91217;44411;46806;105,4;33,6;934,2
2016;3509106;Caiuá;5257;2958;2299;77,7;37;9,5
2016;3509205;Cajamar;78337;38772;39565;102;31,7;596,2
2016;3509254;Cajati;28689;14457;14232;98,4;32,9;63,1
2016;3509304;Cajobi;9510;4797;4713;98,2;37,3;53,8
2016;3509403;Cajuru;23728;11837;11891;100,5;35,2;35,9
2016;3509452;Campina do Monte Alegre;5773;2931;2842;97;35,3;31,3
2016;3509502;Campinas;1116727;535776;580951;108,4;36,4;1405,4
2016;3509601;Campo Limpo Paulista;76699;37601;39098;104;34,2;965,9
2016;3509700;Campos do Jordão;47647;23311;24336;104,4;33,9;164,3
2016;3509809;Campos Novos Paulista;4720;2404;2316;96,3;35,6;9,7
2016;3509908;Cananéia;12358;6120;6238;101,9;35,1;10
2016;3509957;Canas;4655;2333;2322;99,5;32,5;87,4
2016;3510005;Cândido Mota;29877;14593;15284;104,7;37;50,1
2016;3510104;Cândido Rodrigues;2792;1381;1411;102,2;40,1;39,4
2016;3510153;Canitar;5317;2651;2666;100,6;31,4;92,5
2016;3510203;Capão Bonito;46633;23181;23452;101,2;34,2;28,4
2016;3510302;Capela do Alto;20229;10744;9485;88,3;33,5;119,1
2016;3510401;Capivari;49502;24539;24963;101,7;34,7;153,3
2016;3510500;Caraguatatuba;118095;57999;60096;103,6;34,6;243,5
2016;3510609;Carapicuíba;381333;184264;197069;106,9;33;11038,5
2016;3510708;Cardoso;11724;5759;5965;103,6;39,1;18,3
2016;3510807;Casa Branca;28384;14875;13509;90,8;36,7;32,8
2016;3510906;Cássia dos Coqueiros;2740;1409;1331;94,5;38,2;14,3
2016;3511003;Castilho;19193;9517;9676;101,7;36;18
2016;3511102;Catanduva;114988;55454;59534;107,4;37,9;395,7
2016;3511201;Catiguá;7111;3587;3524;98,2;36,3;47,9
2016;3511300;Cedral;10256;5091;5165;101,5;37,5;51,8
2016;3511409;Cerqueira César;19616;9941;9675;97,3;35,1;38,3
2016;3511508;Cerquilho;42375;20829;21546;103,4;35,8;331,6
2016;3511607;Cesário Lange;17326;8937;8389;93,9;34,7;91
2016;3511706;Charqueada;15394;7756;7638;98,5;34,8;87,5
2016;3511904;Clementina;7110;3606;3504;97,2;34,1;42,2
2016;3512001;Colina;18052;8847;9205;104;36,1;42,7
2016;3512100;Colômbia;6416;3247;3169;97,6;34,7;8,8
2016;3512209;Conchal;26767;13443;13324;99,1;33,4;146,4
2016;3512308;Conchas;15848;7952;7896;99,3;37;34
2016;3512407;Cordeirópolis;22848;11384;11464;100,7;34,6;166,1
2016;3512506;Coroados;5383;2680;2703;100,9;36,5;21,8
2016;3512605;Coronel Macedo;4692;2387;2305;96,6;36,7;15,4
2016;3512704;Corumbataí;4057;2043;2014;98,6;35,2;14,6
2016;3512803;Cosmópolis;59777;29633;30144;101,7;34,1;386,5
2016;3512902;Cosmorama;7965;3997;3968;99,3;38,8;18
2016;3513009;Cotia;238236;116111;122125;105,2;32,9;735,3
2016;3513108;Cravinhos;32741;16263;16478;101,3;35,4;105,1
2016;3513207;Cristais Paulista;8424;4235;4189;98,9;35;21,9
2016;3513306;Cruzália;2197;1082;1115;103;38,9;14,7
2016;3513405;Cruzeiro;76845;37140;39705;106,9;36,2;251,4
2016;3513504;Cubatão;117000;57317;59683;104,1;33;818,9
2016;3513603;Cunha;22066;11251;10815;96,1;36,8;15,7
2016;3513702;Descalvado;31619;15564;16055;103,2;37,2;42
2016;3513801;Diadema;394213;189640;204573;107,9;33,5;12827,4
2016;3513850;Dirce Reis;1656;854;802;93,9;39,7;18,8
2016;3513900;Divinolândia;11269;5599;5670;101,3;38,7;50,4
2016;3514007;Dobrada;8430;4272;4158;97,3;32,5;56,3
2016;3514106;Dois Córregos;24832;12348;12484;101,1;35,7;39,2
2016;3514205;Dolcinópolis;2147;1099;1048;95,4;39,5;27,5
2016;3514304;Dourado;8425;4218;4207;99,7;38,3;40,9
2016;3514403;Dracena;44637;21994;22643;103;38,8;91,5
2016;3514502;Duartina;12351;6025;6326;105;38,8;46,7
2016;3514601;Dumont;8761;4381;4380;100;34,2;78,7
2016;3514700;Echaporã;6286;3094;3192;103,2;36,7;12,2
2016;3514809;Eldorado;13964;7073;6891;97,4;33,5;8,4
2016;3514908;Elias Fausto;16796;8563;8233;96,1;34;83
2016;3514924;Elisiário;3162;1631;1531;93,9;37,1;33,6
2016;3514957;Embaúba;2388;1230;1158;94,1;37,8;28,7
2016;3515004;Embu das Artes;247941;120078;127863;106,5;32;3522
2016;3515103;Embu-Guaçu;65453;32407;33046;102;33,5;420,5
2016;3515129;Emilianópolis;3054;1528;1526;99,9;38,9;13,6
2016;3515152;Engenheiro Coelho;17605;9026;8579;95;31,4;160,1
2016;3515186;Espírito Santo do Pinhal;41098;20023;21075;105,3;37,8;105,6
2016;3515194;Espírito Santo do Turvo;4208;2116;2092;98,9;32,8;21,7
2016;3515202;Estrela d'Oeste;8831;4464;4367;97,8;37,9;29,8
2016;3515301;Estrela do Norte;2714;1363;1351;99,1;35,5;10,2
2016;3515350;Euclides da Cunha Paulista;8843;4415;4428;100,3;35,1;15,4
2016;3515400;Fartura;16074;7813;8261;105,7;36,9;37,5
2016;3515509;Fernandópolis;68338;33070;35268;106,6;38,3;124,3
2016;3515608;Fernando Prestes;5754;2839;2915;102,7;39,4;33,8
2016;3515657;Fernão;1612;821;791;96,3;36,9;16
2016;3515707;Ferraz de Vasconcelos;174657;84913;89744;105,7;32,1;5911,1
2016;3515806;Flora Rica;1636;820;816;99,5;41,3;7,3
2016;3515905;Floreal;2891;1427;1464;102,6;42,4;14,2
2016;3516002;Flórida Paulista;12947;7102;5845;82,3;36,7;24,7
2016;3516101;Florínea;3386;1907;1479;77,6;37,3;15
2016;3516200;Franca;337217;164043;173174;105,6;35,2;556,8
2016;3516309;Francisco Morato;160696;79231;81465;102,8;31;3279,4
2016;3516408;Franco da Rocha;138695;70407;68288;97;32,5;1044,6
2016;3516507;Gabriel Monteiro;2769;1390;1379;99,2;39,3;20
2016;3516606;Gália;6765;3350;3415;101,9;38,7;19
2016;3516705;Garça;42950;20801;22149;106,5;37,2;77,3
2016;3516804;Gastão Vidigal;3783;1927;1856;96,3;36,8;21
2016;3516853;Gavião Peixoto;4574;2317;2257;97,4;33,9;18,8
2016;3516903;General Salgado;10573;5272;5301;100,6;38,6;21,4
2016;3517000;Getulina;10587;5774;4813;83,4;36,8;15,6
2016;3517109;Glicério;4403;2177;2226;102,3;37,1;16,1
2016;3517208;Guaiçara;11021;5499;5522;100,4;34,6;39,8
2016;3517307;Guaimbê;5504;2734;2770;101,3;35,9;25,3
2016;3517406;Guaíra;38532;18923;19609;103,6;36;30,6
2016;3517505;Guapiaçu;19784;9893;9891;100;35,7;60,9
2016;3517604;Guapiara;17727;8999;8728;97;35;43,4
2016;3517703;Guará;19388;9558;9830;102,8;34,3;53,5
2016;3517802;Guaraçaí;8036;3986;4050;101,6;39,8;14,1
2016;3517901;Guaraci;10239;5169;5070;98,1;35,8;16
2016;3518008;Guarani d'Oeste;1981;979;1002;102,3;38,8;23,1
2016;3518107;Guarantã;6450;3207;3243;101,1;34,6;14
2016;3518206;Guararapes;31058;15219;15839;104,1;37,5;32,5
2016;3518305;Guararema;28644;14283;14361;100,5;35,1;105,8
2016;3518404;Guaratinguetá;115399;55426;59973;108,2;36,7;153,3
2016;3518503;Guareí;14844;8997;5847;65;34,8;26,1
2016;3518602;Guariba;36817;18157;18660;102,8;33,5;136,2
2016;3518701;Guarujá;291909;141337;150572;106,5;33,7;2016
2016;3518800;Guarulhos;1265621;612697;652924;106,6;33,2;3971,5
2016;3518859;Guatapará;7184;3654;3530;96,6;34,7;17,4
2016;3518909;Guzolândia;4548;2331;2217;95,1;36;18
2016;3519006;Herculândia;8968;4443;4525;101,8;35,7;24,6
2016;3519055;Holambra;13141;6600;6541;99,1;34,4;200,4
2016;3519071;Hortolândia;215168;107827;107341;99,5;32,9;3447,3
2016;3519105;Iacanga;10240;5176;5064;97,8;36,4;18,7
2016;3519204;Iacri;6338;3182;3156;99,2;37,8;19,7
2016;3519253;Iaras;7197;4785;2412;50,4;35,3;17,9
2016;3519303;Ibaté;31592;15999;15593;97,5;33,1;108,6
2016;3519402;Ibirá;11319;5582;5737;102,8;37,7;41,6
2016;3519501;Ibirarema;6623;3321;3302;99,4;36,4;29
2016;3519600;Ibitinga;56815;27945;28870;103,3;35,9;82,4
2016;3519709;Ibiúna;73799;37312;36487;97,8;34,4;69,7
2016;3519808;Icém;7718;4100;3618;88,2;35,4;21,3
2016;3519907;Iepê;7680;3760;3920;104,3;37,5;12,9
2016;3520004;Igaraçu do Tietê;23377;11653;11724;100,6;35,1;239,2
2016;3520103;Igarapava;27229;13302;13927;104,7;36,4;58,1
2016;3520202;Igaratá;9785;4956;4829;97,4;35,4;33,4
2016;3520301;Iguape;29198;14656;14542;99,2;36,7;14,8
2016;3520400;Ilhabela;31500;15805;15695;99,3;33,1;90,9
2016;3520426;Ilha Comprida;11280;5587;5693;101,9;38,9;57,4
2016;3520442;Ilha Solteira;25577;12444;13133;105,5;38,2;39,2
2016;3520509;Indaiatuba;228645;112674;115971;102,9;35,1;733,9
2016;3520608;Indiana;4987;2511;2476;98,6;37,3;38,5
2016;3520707;Indiaporã;4013;1965;2048;104,2;40,2;14,4
2016;3520806;Inúbia Paulista;3651;1811;1840;101,6;37,5;41,9
2016;3520905;Ipaussu;13723;6823;6900;101,1;35,2;65,5
2016;3521002;Iperó;32492;17440;15052;86,3;32,8;190,8
2016;3521101;Ipeúna;6498;3307;3191;96,5;34;34,2
2016;3521150;Ipiguá;5588;2826;2762;97,7;36,6;41,1
2016;3521200;Iporanga;4199;2123;2076;97,8;33,6;3,6
2016;3521309;Ipuã;14397;7249;7148;98,6;33,9;30,9
2016;3521408;Iracemápolis;21067;10515;10552;100,4;34,9;183
2016;3521507;Irapuã;7130;3657;3473;95;36,2;27,7
2016;3521606;Irapuru;7502;4333;3169;73,1;38,5;35
2016;3521705;Itaberá;18011;9054;8957;98,9;35,2;16,4
2016;3521804;Itaí;24711;12963;11748;90,6;34,4;22,6
2016;3521903;Itajobi;15759;7919;7840;99;38,2;31,4
2016;3522000;Itaju;3429;1753;1676;95,6;35,8;14,9
2016;3522109;Itanhaém;100461;48540;51921;107;36,4;167
2016;3522158;Itaoca;3328;1703;1625;95,4;36,2;18,2
2016;3522208;Itapecerica da Serra;157034;77653;79381;102,2;32,2;1041,7
2016;3522307;Itapetininga;151756;75815;75941;100,2;34,4;84,8
2016;3522406;Itapeva;89393;43981;45412;103,3;33,7;48,9
2016;3522505;Itapevi;217623;106587;111036;104,2;31,1;2632,8
2016;3522604;Itapira;70625;34802;35823;102,9;37,5;136,2
2016;3522653;Itapirapuã Paulista;4072;2102;1970;93,7;32,1;10
2016;3522703;Itápolis;40004;19716;20288;102,9;37,5;40,1
2016;3522802;Itaporanga;14474;7175;7299;101,7;36,3;28,5
2016;3522901;Itapuí;12950;6498;6452;99,3;34,5;92,5
2016;3523008;Itapura;4223;2159;2064;95,6;36,3;14
2016;3523107;Itaquaquecetuba;346709;170193;176516;103,7;31,1;4196,3
2016;3523206;Itararé;46643;22814;23829;104,4;34,7;46,5
2016;3523305;Itariri;15558;7784;7774;99,9;33,4;56,9
2016;3523404;Itatiba;112037;55127;56910;103,2;35,6;347,7
2016;3523503;Itatinga;18720;9742;8978;92,2;32,8;19,1
2016;3523602;Itirapina;15860;9336;6524;69,9;34,5;28,1
2016;3523701;Itirapuã;5867;2984;2883;96,6;34,6;36,4
2016;3523800;Itobi;7796;3997;3799;95;35,8;56,1
2016;3523909;Itu;162222;79753;82469;103,4;34,8;253,2
2016;3524006;Itupeva;57782;29167;28615;98,1;32,5;287,6
2016;3524105;Ituverava;38312;18600;19712;106;37,1;54,4
2016;3524204;Jaborandi;6477;3239;3238;100;36,3;23,7
2016;3524303;Jaboticabal;72283;34781;37502;107,8;37,1;102,3
2016;3524402;Jacareí;227617;110477;117140;106;35,3;490,3
2016;3524501;Jaci;6628;3365;3263;97;34,3;45,7
2016;3524600;Jacupiranga;16736;8417;8319;98,8;34,5;23,8
2016;3524709;Jaguariúna;51822;25447;26375;103,6;34,7;366,5
2016;3524808;Jales;48221;23455;24766;105,6;38,7;130,8
2016;3524907;Jambeiro;5888;2995;2893;96,6;35,4;31,9
2016;3525003;Jandira;113912;55533;58379;105,1;32,2;6528,2
2016;3525102;Jardinópolis;41444;21158;20286;95,9;34,5;82,6
2016;3525201;Jarinu;30719;15450;15269;98,8;34;148
2016;3525300;Jaú;132946;64702;68244;105,5;36,7;193,5
2016;3525409;Jeriquara;3511;1807;1704;94,3;33,1;24,7
2016;3525508;Joanópolis;12348;6242;6106;97,8;37;33
2016;3525607;João Ramalho;4309;2168;2141;98,8;34,1;10,4
2016;3525706;José Bonifácio;34840;17277;17563;101,7;35,9;40,5
2016;3525805;Júlio Mesquita;4365;2139;2226;104,1;35,5;34,1
2016;3525854;Jumirim;2939;1485;1454;97,9;34,3;51,8
2016;3525904;Jundiaí;406849;197088;209761;106,4;36,8;943,5
2016;3526001;Junqueirópolis;19711;10368;9343;90,1;38;33,8
2016;3526100;Juquiá;18387;9273;9114;98,3;35,4;22,6
2016;3526209;Juquitiba;28290;14284;14006;98,1;33,7;54,2
2016;3526308;Lagoinha;4949;2517;2432;96,6;39,2;19,4
2016;3526407;Laranjal Paulista;25808;12667;13141;103,7;36,4;67,2
2016;3526506;Lavínia;9217;6669;2548;38,2;35,8;17,1
2016;3526605;Lavrinhas;6933;3468;3465;99,9;32,7;41,5
2016;3526704;Leme;95650;47458;48192;101,5;34,7;237,4
2016;3526803;Lençóis Paulista;64317;31813;32504;102,2;34,9;79,4
2016;3526902;Limeira;285161;139562;145599;104,3;36,1;491,1
2016;3527009;Lindóia;6907;3420;3487;102;36,9;141,7
2016;3527108;Lins;73569;35512;38057;107,2;37,1;129,1
2016;3527207;Lorena;84050;40410;43640;108;35,8;202,9
2016;3527256;Lourdes;2071;1052;1019;96,9;38,9;18,2
2016;3527306;Louveira;44296;22223;22073;99,3;32,3;794,7
2016;3527405;Lucélia;20109;10912;9197;84,3;37,9;63,9
2016;3527504;Lucianópolis;2313;1160;1153;99,4;36,9;12,2
2016;3527603;Luís Antônio;11845;6007;5838;97,2;32,4;19,8
2016;3527702;Luiziânia;4902;2492;2410;96,7;35,7;29,4
2016;3527801;Lupércio;4198;2045;2153;105,3;35,8;27,1
2016;3527900;Lutécia;2721;1354;1367;101;36,8;5,7
2016;3528007;Macatuba;16686;8310;8376;100,8;35;74,3
2016;3528106;Macaubal;7589;3806;3783;99,4;39,8;30,6
2016;3528205;Macedônia;3822;1909;1913;100,2;39,4;11,7
2016;3528304;Magda;3243;1631;1612;98,8;40;10,4
2016;3528403;Mairinque;46958;23529;23429;99,6;34,4;223,5
2016;3528502;Mairiporã;87882;44084;43798;99,4;34,5;274
2016;3528601;Manduri;9472;4722;4750;100,6;36,7;41,4
2016;3528700;Marabá Paulista;4703;2959;1744;58,9;35,3;5,1
2016;3528809;Maracaí;13106;6514;6592;101,2;36,2;24,6
2016;3528858;Marapoama;2976;1525;1451;95,1;37,1;26,7
2016;3528908;Mariápolis;3737;1897;1840;97;37,7;20
2016;3529005;Marília;227951;109705;118246;107,8;36,7;194,7
2016;3529104;Marinópolis;2015;1023;992;97;38,4;25,9
2016;3529203;Martinópolis;24642;12742;11900;93,4;36,7;19,7
2016;3529302;Matão;78525;38741;39784;102,7;36,4;149,6
2016;3529401;Mauá;420901;204527;216374;105,8;33,7;6795,6
2016;3529500;Mendonça;5402;2727;2675;98,1;37,4;27,7
2016;3529609;Meridiano;4258;2088;2170;103,9;38;18,7
2016;3529658;Mesópolis;1920;969;951;98,1;37,1;12,9
2016;3529708;Miguelópolis;20152;9965;10187;102,2;34,7;24,6
2016;3529807;Mineiros do Tietê;11725;5829;5896;101,1;35,9;55
2016;3529906;Miracatu;19712;9903;9809;99,1;34,1;19,7
2016;3530003;Mira Estrela;2977;1483;1494;100,7;39,6;13,7
2016;3530102;Mirandópolis;28002;15624;12378;79,2;38,6;30,5
2016;3530201;Mirante do Paranapanema;16642;8376;8266;98,7;37,4;13,4
2016;3530300;Mirassol;58729;28643;30086;105;36,8;241,5
2016;3530409;Mirassolândia;4469;2260;2209;97,7;36,8;26,9
2016;3530508;Mococa;67462;33353;34109;102,3;37,2;78,9
2016;3530607;Mogi das Cruzes;421685;204195;217490;106,5;34,3;591,8
2016;3530706;Mogi Guaçu;146270;71959;74311;103,3;35,8;180
2016;3530805;Mogi Mirim;90313;44208;46105;104,3;36,9;181,5
2016;3530904;Mombuca;3506;1750;1756;100,3;33,7;26,2
2016;3531001;Monções;2061;1046;1015;97;40,6;19,8
2016;3531100;Mongaguá;54321;27389;26932;98,3;36,7;380,5
2016;3531209;Monte Alegre do Sul;7936;3938;3998;101,5;38,8;71,9
2016;3531308;Monte Alto;47396;23277;24119;103,6;38;136,6
2016;3531407;Monte Aprazível;22110;10901;11209;102,8;38;44,6
2016;3531506;Monte Azul Paulista;18650;9350;9300;99,5;37,4;70,8
2016;3531605;Monte Castelo;4164;2069;2095;101,3;38,8;17,8
2016;3531704;Monteiro Lobato;4157;2121;2036;96;36,9;12,5
2016;3531803;Monte Mor;56962;28288;28674;101,4;33;236,8
2016;3531902;Morro Agudo;28872;14442;14430;99,9;33,5;20,8
2016;3532009;Morungaba;12811;6338;6473;102,1;34,9;87,3
2016;3532058;Motuca;4193;2120;2073;97,8;35,4;18,3
2016;3532108;Murutinga do Sul;3985;1993;1992;99,9;40,7;15,9
2016;3532157;Nantes;2700;1340;1360;101,5;33,6;9,4
2016;3532207;Narandiba;5037;2525;2512;99,5;33,3;14,1
2016;3532306;Natividade da Serra;6845;3570;3275;91,7;38,5;8,2
2016;3532405;Nazaré Paulista;17439;8916;8523;95,6;36,2;53,5
2016;3532504;Neves Paulista;9254;4592;4662;101,5;40;42,2
2016;3532603;Nhandeara;10368;5045;5323;105,5;40,6;23,8
2016;3532702;Nipoã;4524;2354;2170;92,2;34,7;32,9
2016;3532801;Nova Aliança;6297;3110;3187;102,5;37,1;28,9
2016;3532827;Nova Campina;8546;4314;4232;98,1;31,1;22,2
2016;3532843;Nova Canaã Paulista;2086;1053;1033;98,1;42,4;16,8
2016;3532868;Nova Castilho;1116;552;564;102,2;36,7;6,1
2016;3532900;Nova Europa;9381;4694;4687;99,9;34,7;58,5
2016;3533007;Nova Granada;19364;9675;9689;100,1;36,4;36,4
2016;3533106;Nova Guataporanga;2170;1079;1091;101,1;39,3;63,5
2016;3533205;Nova Independência;3834;1996;1838;92,1;33,6;14,5
2016;3533254;Novais;4537;2366;2171;91,8;32,6;38,5
2016;3533304;Nova Luzitânia;3194;1642;1552;94,5;36,5;43,3
2016;3533403;Nova Odessa;56821;27954;28867;103,3;35,6;770,1
2016;3533502;Novo Horizonte;37689;18689;19000;101,7;37;40,5
2016;3533601;Nuporanga;7115;3540;3575;101;36,3;20,4
2016;3533700;Ocauçu;4242;2172;2070;95,3;36,4;14,1
2016;3533809;Óleo;2608;1315;1293;98,3;38,7;13,1
2016;3533908;Olímpia;52831;25867;26964;104,2;36,7;65,8
2016;3534005;Onda Verde;4323;2200;2123;96,5;34,9;17,8
2016;3534104;Oriente;6151;2985;3166;106,1;38,1;28,1
2016;3534203;Orindiúva;5876;2962;2914;98,4;33,4;23,8
2016;3534302;Orlândia;39403;19182;20221;105,4;36,2;135,1
2016;3534401;Osasco;704005;336826;367179;109;34,4;10838,5
2016;3534500;Oscar Bressane;2527;1220;1307;107,1;40,6;11,4
2016;3534609;Osvaldo Cruz;31230;15623;15607;99,9;39;125,9
2016;3534708;Ourinhos;104336;50143;54193;108,1;36,4;352,7
2016;3534757;Ouroeste;9447;4683;4764;101,7;36,4;32,7
2016;3534807;Ouro Verde;7873;3843;4030;104,9;35,5;29,5
2016;3534906;Pacaembu;14097;8788;5309;60,4;38;41,5
2016;3535002;Palestina;11286;5664;5622;99,3;37,8;16,2
2016;3535101;Palmares Paulista;10353;5350;5003;93,5;32,5;126,1
2016;3535200;Palmeira d'Oeste;9316;4658;4658;100;40,5;29,2
2016;3535309;Palmital;20560;10030;10530;105;38,5;37,5
2016;3535408;Panorama;14975;7457;7518;100,8;34,5;42,1
2016;3535507;Paraguaçu Paulista;41941;21014;20927;99,6;36;41,9
2016;3535606;Paraibuna;17666;8956;8710;97,3;36,1;21,8
2016;3535705;Paraíso;6036;3062;2974;97,1;37,3;38,9
2016;3535804;Paranapanema;18610;9470;9140;96,5;33,6;18,3
2016;3535903;Paranapuã;3920;1980;1940;98;37,1;27,9
2016;3536000;Parapuã;10800;5430;5370;98,9;38,9;29,5
2016;3536109;Pardinho;6432;3267;3165;96,9;34,4;30,6
2016;3536208;Pariquera-Açu;18946;9384;9562;101,9;34,9;52,7
2016;3536257;Parisi;2457;1223;1234;100,9;38,4;29
2016;3536307;Patrocínio Paulista;13831;6992;6839;97,8;34,5;22,9
2016;3536406;Paulicéia;7211;3682;3529;95,8;34,4;19,3
2016;3536505;Paulínia;96226;47194;49032;103,9;34;693,4
2016;3536570;Paulistânia;1921;978;943;96,4;36;7,5
2016;3536604;Paulo de Faria;8066;4046;4020;99,4;37;10,9
2016;3536703;Pederneiras;43414;21696;21718;100,1;35;59,7
2016;3536802;Pedra Bela;6151;3208;2943;91,7;37,5;38,8
2016;3536901;Pedranópolis;2695;1369;1326;96,9;40,2;10,4
2016;3537008;Pedregulho;15718;7936;7782;98,1;35;22,1
2016;3537107;Pedreira;42517;20957;21560;102,9;36,3;390,7
2016;3537156;Pedrinhas Paulista;2868;1413;1455;103;37,9;18,8
2016;3537206;Pedro de Toledo;10808;5505;5303;96,3;35,5;16,1
2016;3537305;Penápolis;60381;29273;31108;106,3;37,4;84,9
2016;3537404;Pereira Barreto;24830;12117;12713;104,9;37,5;25,5
2016;3537503;Pereiras;8104;4074;4030;98,9;35,9;36,3
2016;3537602;Peruíbe;64479;31283;33196;106,1;36,5;197,7
2016;3537701;Piacatu;5486;2752;2734;99,3;37,4;23,6
2016;3537800;Piedade;52801;26723;26078;97,6;35,8;70,7
2016;3537909;Pilar do Sul;27197;13798;13399;97,1;34,8;39,9
2016;3538006;Pindamonhangaba;156800;76569;80231;104,8;34,5;214,4
2016;3538105;Pindorama;14889;7515;7374;98,1;38,2;80,6
2016;3538204;Pinhalzinho;14199;7105;7094;99,8;37,9;91,9
2016;3538303;Piquerobi;3425;1665;1760;105,7;38;7,1
2016;3538501;Piquete;13442;6474;6968;107,6;37,9;76,4
2016;3538600;Piracaia;25686;12666;13020;102,8;36,9;66,6
2016;3538709;Piracicaba;395681;192546;203135;105,5;36;287,1
2016;3538808;Piraju;29139;14116;15023;106,4;37,2;57,7
2016;3538907;Pirajuí;22704;12203;10501;86,1;37;27,6
2016;3539004;Pirangi;10790;5428;5362;98,8;38,2;50
2016;3539103;Pirapora do Bom Jesus;16997;8450;8547;101,1;31,1;156,7
2016;3539202;Pirapozinho;25120;12254;12866;105;36,3;52,6
2016;3539301;Pirassununga;72141;35054;37087;105,8;37,2;99,2
2016;3539400;Piratininga;13606;6680;6926;103,7;36,9;33,8
2016;3539509;Pitangueiras;34789;17525;17264;98,5;33,4;80,8
2016;3539608;Planalto;4469;2261;2208;97,7;35,1;15,4
2016;3539707;Platina;3151;1614;1537;95,2;35,7;9,6
2016;3539806;Poá;106004;51106;54898;107,4;33,8;6140,3
2016;3539905;Poloni;5524;2715;2809;103,5;38,4;40,9
2016;3540002;Pompéia;20181;9893;10288;104;37;25,7
2016;3540101;Pongaí;3462;1766;1696;96;39,7;18,9
2016;3540200;Pontal;39134;20140;18994;94,3;32;109,8
2016;3540259;Pontalinda;4121;2195;1926;87,7;35,1;19,7
2016;3540309;Pontes Gestal;2490;1239;1251;101;38,1;11,4
2016;3540408;Populina;4212;2108;2104;99,8;39,1;13,3
2016;3540507;Porangaba;9437;4830;4607;95,4;38,6;35,5
2016;3540606;Porto Feliz;52833;26703;26130;97,9;35,4;94,9
2016;3540705;Porto Ferreira;52333;25727;26606;103,4;36,3;213,7
2016;3540754;Potim;19955;11257;8698;77,3;32,1;447
2016;3540804;Potirendaba;17013;8518;8495;99,7;37,2;49,7
2016;3540853;Pracinha;2728;1972;756;38,3;33,5;43,3
2016;3540903;Pradópolis;17349;8712;8637;99,1;34,4;103,7
2016;3541000;Praia Grande;307344;146833;160511;109,3;35,3;2053,7
2016;3541059;Pratânia;4884;2478;2406;97,1;32,7;27,9
2016;3541109;Presidente Alves;4005;1983;2022;102;37,5;14
2016;3541208;Presidente Bernardes;14123;7422;6701;90,3;39,4;18,8
2016;3541307;Presidente Epitácio;40779;19838;20941;105,6;36,1;32,4
2016;3541406;Presidente Prudente;217625;104445;113180;108,4;37;388,2
2016;3541505;Presidente Venceslau;36861;18111;18750;103,5;38,6;48,8
2016;3541604;Promissão;35789;17699;18090;102,2;35,9;45,9
2016;3541653;Quadra;3324;1725;1599;92,7;36,5;16,2
2016;3541703;Quatá;13062;6510;6552;100,6;35,2;20,1
2016;3541802;Queiroz;3013;1518;1495;98,5;33,2;12,8
2016;3541901;Queluz;10264;5164;5100;98,8;34,4;41,2
2016;3542008;Quintana;6505;3197;3308;103,5;36;20,4
2016;3542107;Rafard;8797;4350;4447;102,2;35,5;72,3
2016;3542206;Rancharia;28834;14052;14782;105,2;36,7;18,2
2016;3542305;Redenção da Serra;4211;2200;2011;91,4;37,7;13,6
2016;3542404;Regente Feijó;19422;9607;9815;102,2;36,8;73,8
2016;3542503;Reginópolis;7515;4714;2801;59,4;34,6;18,3
2016;3542602;Registro;57567;28447;29120;102,4;34,9;79,7
2016;3542701;Restinga;6505;3244;3261;100,5;33,2;26,5
2016;3542800;Ribeira;3255;1675;1580;94,3;36,1;9,7
2016;3542909;Ribeirão Bonito;11686;5829;5857;100,5;35,4;24,8
2016;3543006;Ribeirão Branco;18466;9453;9013;95,3;31,9;26,5
2016;3543105;Ribeirão Corrente;4445;2263;2182;96,4;33,4;30
2016;3543204;Ribeirão do Sul;4580;2304;2276;98,8;38,1;22,5
2016;3543238;Ribeirão dos Índios;2119;1044;1075;103;39,7;10,8
2016;3543253;Ribeirão Grande;7519;3860;3659;94,8;35,2;22,6
2016;3543303;Ribeirão Pires;115266;56047;59219;105,7;36;1164,6
2016;3543402;Ribeirão Preto;654524;312768;341756;109,3;36,1;1005,5
2016;3543501;Riversul;5917;2965;2952;99,6;36,4;15,3
2016;3543600;Rifaina;3745;1875;1870;99,7;37;23
2016;3543709;Rincão;9861;4935;4926;99,8;35,4;31,1
2016;3543808;Rinópolis;9668;4847;4821;99,5;38,8;27
2016;3543907;Rio Claro;194614;94299;100315;106,4;36,6;390,5
2016;3544004;Rio das Pedras;30593;15355;15238;99,2;33,7;135
2016;3544103;Rio Grande da Serra;44467;21909;22558;103;32,9;1223,6
2016;3544202;Riolândia;10487;6208;4279;68,9;34,3;16,6
2016;3544251;Rosana;18798;9327;9471;101,5;35,7;25,3
2016;3544301;Roseira;10270;5162;5108;99;34,2;79,1
2016;3544400;Rubiácea;2732;1380;1352;98;35;11,6
2016;3544509;Rubinéia;3358;1658;1700;102,5;41;13,8
2016;3544608;Sabino;5245;2589;2656;102,6;38,8;17,2
2016;3544707;Sagres;2456;1200;1256;104,7;37,1;16,6
2016;3544806;Sales;6018;3015;3003;99,6;38;19,5
2016;3544905;Sales Oliveira;11045;5396;5649;104,7;36,7;36,1
2016;3545001;Salesópolis;15474;7749;7725;99,7;35,3;36,4
2016;3545100;Salmourão;4819;2447;2372;96,9;36,5;27,9
2016;3545159;Saltinho;7635;3770;3865;102,5;37,4;76,6
2016;3545209;Salto;119971;59030;60941;103,2;34,9;901,7
2016;3545308;Salto de Pirapora;42239;20985;21254;101,3;35;150,6
2016;3545407;Salto Grande;8992;4409;4583;103,9;36,8;47,7
2016;3545506;Sandovalina;3705;1873;1832;97,8;34,1;8,1
2016;3545605;Santa Adélia;14213;7050;7163;101,6;36,8;43
2016;3545704;Santa Albertina;6093;3060;3033;99,1;39,3;22,3
2016;3545803;Santa Bárbara d'Oeste;182659;90139;92520;102,6;36,1;673,9
2016;3546009;Santa Branca;13961;6963;6998;100,5;36,7;51,3
2016;3546108;Santa Clara d'Oeste;2356;1196;1160;97;37,9;12,8
2016;3546207;Santa Cruz da Conceição;4194;2061;2133;103,5;39,1;27,9
2016;3546256;Santa Cruz da Esperança;2079;1033;1046;101,3;36,3;14
2016;3546306;Santa Cruz das Palmeiras;29643;14874;14769;99,3;34,8;100,4
2016;3546405;Santa Cruz do Rio Pardo;45321;22127;23194;104,8;36,5;40,7
2016;3546504;Santa Ernestina;5864;2979;2885;96,8;33,8;43,6
2016;3546603;Santa Fé do Sul;32026;15426;16600;107,6;38,2;155,1
2016;3546702;Santa Gertrudes;22779;11518;11261;97,8;32,5;231,8
2016;3546801;Santa Isabel;52212;25981;26231;101;34,8;143,7
2016;3546900;Santa Lúcia;7822;3893;3929;100,9;34,4;50,8
2016;3547007;Santa Maria da Serra;5338;2697;2641;97,9;34,1;21,1
2016;3547106;Santa Mercedes;2920;1452;1468;101,1;36,6;17,5
2016;3547205;Santana da Ponte Pensa;1660;841;819;97,4;42,7;12,8
2016;3547304;Santana de Parnaíba;131202;64219;66983;104,3;32,9;729,1
2016;3547403;Santa Rita d'Oeste;2655;1308;1347;103;41,8;12,7
2016;3547502;Santa Rita do Passa Quatro;25826;12430;13396;107,8;40,2;34,2
2016;3547601;Santa Rosa de Viterbo;23863;11655;12208;104,7;37;82,7
2016;3547650;Santa Salete;1553;782;771;98,6;40,3;19,6
2016;3547700;Santo Anastácio;19343;9365;9978;106,5;38,5;35
2016;3547809;Santo André;717260;342250;375010;109,6;37,2;4080,4
2016;3547908;Santo Antônio da Alegria;6520;3353;3167;94,5;37,1;21
2016;3548005;Santo Antônio de Posse;21985;11034;10951;99,2;34,3;142,6
2016;3548054;Santo Antônio do Aracanguá;8075;4063;4012;98,7;36,2;6,2
2016;3548104;Santo Antônio do Jardim;6043;3069;2974;96,9;37,5;55
2016;3548203;Santo Antônio do Pinhal;6845;3447;3398;98,6;35,9;51,5
2016;3548302;Santo Expedito;2906;1440;1466;101,8;38,5;30,8
2016;3548401;Santópolis do Aguapeí;4134;2063;2071;100,4;34,8;32,3
2016;3548500;Santos;422648;192530;230118;119,5;40,5;1503,9
2016;3548609;São Bento do Sapucaí;11183;5590;5593;100,1;37,8;44,3
2016;3548708;São Bernardo do Campo;795197;381322;413875;108,5;35,5;1941,7
2016;3548807;São Caetano do Sul;158519;72782;85737;117,8;40,6;10340
2016;3548906;São Carlos;238938;116797;122141;104,6;36,4;210,2
2016;3549003;São Francisco;2725;1352;1373;101,6;40,2;36,1
2016;3549102;São João da Boa Vista;88424;42687;45737;107,1;37,8;171,2
2016;3549201;São João das Duas Pontes;2607;1296;1311;101,2;38,1;20,1
2016;3549250;São João de Iracema;1808;900;908;100,9;37,1;10,1
2016;3549300;São João do Pau d'Alho;2181;1079;1102;102,1;41,3;18,5
2016;3549409;São Joaquim da Barra;47872;23324;24548;105,2;36;116,5
2016;3549508;São José da Bela Vista;8070;4101;3969;96,8;33,4;29,1
2016;3549607;São José do Barreiro;3989;2005;1984;99;36;7
2016;3549706;São José do Rio Pardo;52316;25480;26836;105,3;37,6;124,7
2016;3549805;São José do Rio Preto;446467;213790;232677;108,8;37,1;1033,6
2016;3549904;São José dos Campos;667316;324290;343026;105,8;34,8;607
2016;3549953;São Lourenço da Serra;15091;7620;7471;98;34,4;80,9
2016;3550001;São Luiz do Paraitinga;10433;5303;5130;96,7;38,4;16,9
2016;3550100;São Manuel;38041;18632;19409;104,2;35,9;58,5
2016;3550209;São Miguel Arcanjo;31959;16188;15771;97,4;34,4;34,4
2016;3550308;São Paulo;11447287;5405843;6041444;111,8;35,9;7525,2
2016;3550407;São Pedro;35086;17070;18016;105,5;37,6;57,4
2016;3550506;São Pedro do Turvo;7213;3665;3548;96,8;35,5;9,9
2016;3550605;São Roque;79426;38935;40491;104;36,2;258,8
2016;3550704;São Sebastião;78010;38566;39444;102,3;32,9;193,9
2016;3550803;São Sebastião da Grama;11404;5756;5648;98,1;36,9;45,2
2016;3550902;São Simão;14026;6900;7126;103,3;37,2;22,7
2016;3551009;São Vicente;335016;161182;173834;107,8;35,1;2261,3
2016;3551108;Sarapuí;9759;4951;4808;97,1;35;27,7
2016;3551207;Sarutaiá;3689;1847;1842;99,7;35,9;26,1
2016;3551306;Sebastianópolis do Sul;3105;1524;1581;103,7;38,4;18,5
2016;3551405;Serra Azul;12048;7522;4526;60,2;34,4;42,6
2016;3551504;Serrana;41608;20651;20957;101,5;32,5;330,1
2016;3551603;Serra Negra;28307;13727;14580;106,2;38,9;138,9
2016;3551702;Sertãozinho;119259;58568;60691;103,6;34,5;295,9
2016;3551801;Sete Barras;12930;6612;6318;95,6;34,6;12,2
2016;3551900;Severínia;15171;7840;7331;93,5;34;108
2016;3552007;Silveiras;6009;3016;2993;99,2;35,5;14,5
2016;3552106;Socorro;38575;19053;19522;102,5;38,9;85,9
2016;3552205;Sorocaba;657319;319693;337626;105,6;35,1;1461,1
2016;3552304;Sud Mennucci;7421;3707;3714;100,2;36,1;12,5
2016;3552403;Sumaré;261512;128918;132594;102,9;33,4;1704
2016;3552502;Suzano;285811;139236;146575;105,3;33,1;1385,8
2016;3552551;Suzanápolis;3429;1760;1669;94,8;37;10,4
2016;3552601;Tabapuã;11462;5719;5743;100,4;38,2;33,1
2016;3552700;Tabatinga;14746;7430;7316;98,5;35,2;40
2016;3552809;Taboão da Serra;261412;124573;136839;109,8;33,2;12822
2016;3552908;Taciba;6022;2979;3043;102,1;35,3;9,9
2016;3553005;Taguaí;11773;5841;5932;101,6;33,3;81
2016;3553104;Taiaçu;5823;2948;2875;97,5;36,6;54,4
2016;3553203;Taiúva;6015;3186;2829;88,8;38;45,4
2016;3553302;Tambaú;22083;10928;11155;102,1;36,5;39,3
2016;3553401;Tanabi;24895;12348;12547;101,6;38,1;33,3
2016;3553500;Tapiraí;8043;4053;3990;98,4;33,8;10,7
2016;3553609;Tapiratiba;12356;6062;6294;103,8;37,1;55,7
2016;3553658;Taquaral;2727;1357;1370;101;36,7;50,6
2016;3553708;Taquaritinga;53543;26236;27307;104,1;36,8;90,1
2016;3553807;Taquarituba;23423;11890;11533;97;35,3;52,2
2016;3553856;Taquarivaí;5956;3008;2948;98;31,5;25,7
2016;3553906;Tarabai;6609;3271;3338;102;34,5;32,8
2016;3553955;Tarumã;13987;7044;6943;98,6;33,7;46,2
2016;3554003;Tatuí;116254;57110;59144;103,6;34,8;222
2016;3554102;Taubaté;296492;144174;152318;105,6;35,6;474,4
2016;3554201;Tejupá;4499;2302;2197;95,4;34;15,2
2016;3554300;Teodoro Sampaio;21938;10881;11057;101,6;34;14,1
2016;3554409;Terra Roxa;8266;4153;4113;99;36,2;37,3
2016;3554508;Tietê;37329;18443;18886;102,4;36,3;92,3
2016;3554607;Timburi;2579;1305;1274;97,6;38,8;13,1
2016;3554656;Torre de Pedra;2164;1116;1048;93,9;38,3;30,3
2016;3554706;Torrinha;9322;4685;4637;99;38,1;29,6
2016;3554755;Trabiju;1608;810;798;98,5;34,4;25,4
2016;3554805;Tremembé;46292;24612;21680;88,1;34,7;242,2
2016;3554904;Três Fronteiras;6136;3077;3059;99,4;38,6;40,5
2016;3554953;Tuiuti;6420;3243;3177;98;38,9;50,7
2016;3555000;Tupã;64059;30810;33249;107,9;38,8;102
2016;3555109;Tupi Paulista;15194;7893;7301;92,5;40,5;62,1
2016;3555208;Turiúba;1895;966;929;96,2;40,6;12,4
2016;3555307;Turmalina;1831;902;929;103;43,3;12,4
2016;3555356;Ubarana;5339;2735;2604;95,2;33,4;25,4
2016;3555406;Ubatuba;85647;42466;43181;101,7;33,9;121
2016;3555505;Ubirajara;4766;2465;2301;93,3;35;16,9
2016;3555604;Uchoa;10008;4945;5063;102,4;38,4;39,6
2016;3555703;União Paulista;1620;820;800;97,6;34,8;20,5
2016;3555802;Urânia;8878;4388;4490;102,3;39,1;42,4
2016;3555901;Uru;1343;673;670;99,6;38,7;9,1
2016;3556008;Urupês;13293;6567;6726;102,4;39;41
2016;3556107;Valentim Gentil;12606;6304;6302;100;35,7;84,2
2016;3556206;Valinhos;116997;57380;59617;103,9;37;787,7
2016;3556305;Valparaíso;23598;13042;10556;80,9;34,7;27,5
2016;3556354;Vargem;9645;4935;4710;95,4;36;67,6
2016;3556404;Vargem Grande do Sul;39819;19683;20136;102,3;36;149
2016;3556453;Vargem Grande Paulista;47106;23208;23898;103;33,7;1108,7
2016;3556503;Várzea Paulista;112738;56082;56656;101;33,2;3210,1
2016;3556602;Vera Cruz;10526;5165;5361;103,8;38,1;42,5
2016;3556701;Vinhedo;70358;34545;35813;103,7;36,1;869,2
2016;3556800;Viradouro;17499;8729;8770;100,5;35,5;80,4
2016;3556909;Vista Alegre do Alto;7481;3810;3671;96,4;34;78,4
2016;3556958;Vitória Brasil;1787;914;873;95,5;37,7;35,9
2016;3557006;Votorantim;118878;58521;60357;103,1;33,9;645,4
2016;3557105;Votuporanga;90931;44104;46827;106,2;37,7;216,1
2016;3557154;Zacarias;2556;1279;1277;99,8;37,6;8
2016;3557204;Chavantes;12315;6053;6262;103,5;35,8;65,3
2016;3557303;Estiva Gerbi;10681;5367;5314;99;34,7;144,1
2017;3500105;Adamantina;34455;16630;17825;107,2;39,6;83,6
2017;3500204;Adolfo;4036;2009;2027;100,9;38,3;19,1
2017;3500303;Aguaí;32211;16069;16142;100,5;35,2;67,9
2017;3500402;Águas da Prata;7521;3652;3869;105,9;40,7;52,7
2017;3500501;Águas de Lindóia;17821;8694;9127;105;38,8;296,4
2017;3500550;Águas de Santa Bárbara;6604;3285;3319;101;37,5;16,3
2017;3500600;Águas de São Pedro;2759;1291;1468;113,7;43,8;763,8
2017;3500709;Agudos;36534;17982;18552;103,2;35,2;37,8
2017;3500758;Alambari;5623;2828;2795;98,8;34,8;35,2
2017;3500808;Alfredo Marcondes;4234;2123;2111;99,4;40,2;35,6
2017;3500907;Altair;3645;1900;1745;91,8;34,9;11,6
2017;3501004;Altinópolis;16358;8117;8241;101,5;36,9;17,6
2017;3501103;Alto Alegre;4026;2036;1990;97,7;40,9;12,6
2017;3501152;Alumínio;17276;8639;8637;100;33,8;206,6
2017;3501202;Álvares Florence;3944;2012;1932;96;42;10,9
2017;3501301;Álvares Machado;25875;12656;13219;104,4;36,2;74,4
2017;3501400;Álvaro de Carvalho;4767;3121;1646;52,7;35,1;31
2017;3501509;Alvinlândia;2956;1458;1498;102,7;35,5;34,8
2017;3501608;Americana;226995;110248;116747;105,9;37,4;1695,1
2017;3501707;Américo Brasiliense;33980;16923;17057;100,8;33,6;276,4
2017;3501806;Américo de Campos;5861;2877;2984;103,7;39,4;23,2
2017;3501905;Amparo;67483;32991;34492;104,5;37,9;151,5
2017;3502002;Analândia;4484;2276;2208;97;36,2;13,8
2017;3502101;Andradina;58387;28888;29499;102,1;37,9;60,6
2017;3502200;Angatuba;23359;11768;11591;98,5;35,4;22,7
2017;3502309;Anhembi;5703;2911;2792;95,9;34,9;7,7
2017;3502408;Anhumas;3901;1921;1980;103,1;36,7;12,2
2017;3502507;Aparecida;33977;16354;17623;107,8;36,6;281,1
2017;3502606;Aparecida d'Oeste;4280;2119;2161;102;40,8;23,9
2017;3502705;Apiaí;25088;12550;12538;99,9;34,4;25,7
2017;3502754;Araçariguama;19572;9887;9685;98;32,1;134,8
2017;3502804;Araçatuba;193683;92547;101136;109,3;37,8;165,9
2017;3502903;Araçoiaba da Serra;30537;15204;15333;100,8;37,3;119,6
2017;3503000;Aramina;5371;2647;2724;102,9;37,5;26,5
2017;3503109;Arandu;6558;3295;3263;99;35,2;22,9
2017;3503158;Arapeí;2424;1214;1210;99,7;37,3;15,4
2017;3503208;Araraquara;229206;110196;119010;108;37,3;228,4
2017;3503307;Araras;126363;61687;64676;104,8;36,7;196
2017;3503356;Arco-Íris;2013;1018;995;97,7;38,1;7,6
2017;3503406;Arealva;8038;4046;3992;98,7;39,7;15,9
2017;3503505;Areias;3642;1828;1814;99,2;35,5;11,9
2017;3503604;Areiópolis;10420;5306;5114;96,4;33,2;121,3
2017;3503703;Ariranha;8066;4050;4016;99,2;37,5;60,8
2017;3503802;Artur Nogueira;48592;24082;24510;101,8;34,4;272,9
2017;3503901;Arujá;82068;40136;41932;104,5;33,7;853,4
2017;3503950;Aspásia;1835;920;915;99,5;39,5;26,5
2017;3504008;Assis;99476;48125;51351;106,7;37,3;216
2017;3504107;Atibaia;145831;71060;74771;105,2;36,3;304,8
2017;3504206;Auriflama;14029;6960;7069;101,6;38,5;32,3
2017;3504305;Avaí;4703;2350;2353;100,1;35,6;8,7
2017;3504404;Avanhandava;11367;6268;5099;81,3;33,9;33,6
2017;3504503;Avaré;89214;44224;44990;101,7;35,9;73,5
2017;3504602;Bady Bassitt;21824;10752;11072;103;35,1;197,7
2017;3504701;Balbinos;3798;3085;713;23,1;35,7;41,4
2017;3504800;Bálsamo;9057;4414;4643;105,2;38,7;60,4
2017;3504909;Bananal;10163;4977;5186;104,2;36,9;16,5
2017;3505005;Barão de Antonina;3367;1690;1677;99,2;36,4;22
2017;3505104;Barbosa;6081;3016;3065;101,6;35,9;29,6
2017;3505203;Bariri;31752;15691;16061;102,4;37,4;71,4
2017;3505302;Barra Bonita;34966;16947;18019;106,3;38,7;232,9
2017;3505351;Barra do Chapéu;5210;2720;2490;91,5;33,9;12,8
2017;3505401;Barra do Turvo;7301;3764;3537;94;35,2;7,2
2017;3505500;Barretos;118578;57055;61523;107,8;36,8;75,7
2017;3505609;Barrinha;30780;15307;15473;101,1;32,2;210,8
2017;3505708;Barueri;286510;137874;148636;107,8;32,9;4360,8
2017;3505807;Bastos;21187;10372;10815;104,3;36,6;124
2017;3505906;Batatais;57770;28199;29571;104,9;37,2;68
2017;3506003;Bauru;366554;177432;189122;106,6;36,5;549
2017;3506102;Bebedouro;76222;36996;39226;106;37,3;111,6
2017;3506201;Bento de Abreu;2674;1353;1321;97,6;35,7;8,9
2017;3506300;Bernardino de Campos;11292;5757;5535;96,1;37,9;46,2
2017;3506359;Bertioga;57395;28659;28736;100,3;32,5;116,8
2017;3506409;Bilac;7286;3586;3700;103,2;39;46,1
2017;3506508;Birigui;115534;56121;59413;105,9;36,9;218
2017;3506607;Biritiba Mirim;29409;14730;14679;99,7;34,7;92,7
2017;3506706;Boa Esperança do Sul;13327;6635;6692;100,9;34,4;19,3
2017;3506805;Bocaina;11182;5514;5668;102,8;36,1;30,7
2017;3506904;Bofete;10165;5175;4990;96,4;37,1;15,6
2017;3507001;Boituva;55897;27790;28107;101,1;34,7;224,5
2017;3507100;Bom Jesus dos Perdões;21078;10515;10563;100,5;34,4;194,5
2017;3507159;Bom Sucesso de Itararé;3578;1830;1748;95,5;31,1;26,8
2017;3507209;Borá;872;441;431;97,7;36;7,3
2017;3507308;Boracéia;4538;2305;2233;96,9;34,7;37,2
2017;3507407;Borborema;14464;7225;7239;100,2;38,3;26,2
2017;3507456;Borebi;2563;1256;1307;104,1;33,7;7,4
2017;3507506;Botucatu;138371;66801;71570;107,1;36,4;93,3
2017;3507605;Bragança Paulista;164835;80362;84473;105,1;36,3;321,6
2017;3507704;Braúna;5234;2608;2626;100,7;37,3;26,8
2017;3507753;Brejo Alegre;2601;1331;1270;95,4;36,9;24,6
2017;3507803;Brodowski;23555;11603;11952;103;35,9;84,6
2017;3507902;Brotas;23004;11272;11732;104,1;36,4;20,9
2017;3508009;Buri;19664;9939;9725;97,8;32,7;16,4
2017;3508108;Buritama;16639;8185;8454;103,3;38;50,9
2017;3508207;Buritizal;4241;2108;2133;101,2;37,5;15,9
2017;3508306;Cabrália Paulista;4392;2227;2165;97,2;35,4;18,3
2017;3508405;Cabreúva;44898;22449;22449;100;32,7;172,5
2017;3508504;Caçapava;92018;45280;46738;103,2;35,7;249,4
2017;3508603;Cachoeira Paulista;31126;15127;15999;105,8;36,3;108,1
2017;3508702;Caconde;17753;8851;8902;100,6;37,3;37,9
2017;3508801;Cafelândia;16759;8154;8605;105,5;37,2;18,2
2017;3508900;Caiabu;3893;1968;1925;97,8;38,4;15,4
2017;3509007;Caieiras;92017;44765;47252;105,6;34;942,4
2017;3509106;Caiuá;5298;3015;2283;75,7;37,3;9,6
2017;3509205;Cajamar;80809;39933;40876;102,4;32;615,1
2017;3509254;Cajati;28733;14475;14258;98,5;33,3;63,2
2017;3509304;Cajobi;9449;4753;4696;98,8;37,8;53,4
2017;3509403;Cajuru;23785;11860;11925;100,5;35,5;36
2017;3509452;Campina do Monte Alegre;5810;2946;2864;97,2;35,7;31,5
2017;3509502;Campinas;1122477;538010;584467;108,6;36,7;1412,7
2017;3509601;Campo Limpo Paulista;77002;37727;39275;104,1;34,5;969,8
2017;3509700;Campos do Jordão;47611;23285;24326;104,5;34,3;164,2
2017;3509809;Campos Novos Paulista;4747;2412;2335;96,8;35,8;9,8
2017;3509908;Cananéia;12360;6109;6251;102,3;35,6;10
2017;3509957;Canas;4700;2352;2348;99,8;32,9;88,2
2017;3510005;Cândido Mota;29856;14568;15288;104,9;37,3;50,1
2017;3510104;Cândido Rodrigues;2805;1392;1413;101,5;40,3;39,6
2017;3510153;Canitar;5471;2719;2752;101,2;31,6;95,2
2017;3510203;Capão Bonito;46671;23187;23484;101,3;34,6;28,5
2017;3510302;Capela do Alto;20696;11049;9647;87,3;33,8;121,8
2017;3510401;Capivari;49634;24556;25078;102,1;35,1;153,7
2017;3510500;Caraguatatuba;121046;59354;61692;103,9;34,9;249,6
2017;3510609;Carapicuíba;383269;185045;198224;107,1;33,3;11094,5
2017;3510708;Cardoso;11711;5748;5963;103,7;39,5;18,3
2017;3510807;Casa Branca;28371;14842;13529;91,2;37;32,8
2017;3510906;Cássia dos Coqueiros;2762;1418;1344;94,8;38,6;14,4
2017;3511003;Castilho;19367;9592;9775;101,9;36,4;18,2
2017;3511102;Catanduva;115342;55562;59780;107,6;38,1;396,9
2017;3511201;Catiguá;7110;3580;3530;98,6;36,6;47,9
2017;3511300;Cedral;10640;5274;5366;101,7;37,6;53,8
2017;3511409;Cerqueira César;19959;10161;9798;96,4;35,4;39
2017;3511508;Cerquilho;42819;21018;21801;103,7;36,2;335
2017;3511607;Cesário Lange;17662;9103;8559;94;35;92,8
2017;3511706;Charqueada;15441;7768;7673;98,8;35,1;87,8
2017;3511904;Clementina;7097;3584;3513;98;34,5;42,1
2017;3512001;Colina;18144;8872;9272;104,5;36,4;43
2017;3512100;Colômbia;6457;3263;3194;97,9;35;8,9
2017;3512209;Conchal;27002;13544;13458;99,4;33,7;147,7
2017;3512308;Conchas;15764;7908;7856;99,3;37,4;33,8
2017;3512407;Cordeirópolis;23147;11515;11632;101;34,9;168,2
2017;3512506;Coroados;5409;2692;2717;100,9;36,9;21,9
2017;3512605;Coronel Macedo;4637;2356;2281;96,8;37,2;15,3
2017;3512704;Corumbataí;4086;2054;2032;98,9;35,5;14,7
2017;3512803;Cosmópolis;59842;29619;30223;102;34,6;386,9
2017;3512902;Cosmorama;8072;4048;4024;99,4;38,9;18,3
2017;3513009;Cotia;244579;119097;125482;105,4;33,3;754,9
2017;3513108;Cravinhos;32869;16300;16569;101,7;35,8;105,5
2017;3513207;Cristais Paulista;8581;4303;4278;99,4;35,3;22,3
2017;3513306;Cruzália;2191;1079;1112;103,1;39,3;14,7
2017;3513405;Cruzeiro;76671;37013;39658;107,1;36,5;250,8
2017;3513504;Cubatão;116504;56889;59615;104,8;33,4;815,4
2017;3513603;Cunha;22099;11262;10837;96,2;37,3;15,7
2017;3513702;Descalvado;31688;15590;16098;103,3;37,6;42
2017;3513801;Diadema;394964;189776;205188;108,1;33,9;12851,9
2017;3513850;Dirce Reis;1655;853;802;94;40;18,8
2017;3513900;Divinolândia;11263;5592;5671;101,4;39,1;50,3
2017;3514007;Dobrada;8495;4289;4206;98,1;32,9;56,7
2017;3514106;Dois Córregos;24825;12327;12498;101,4;36,1;39,2
2017;3514205;Dolcinópolis;2157;1100;1057;96,1;39,7;27,7
2017;3514304;Dourado;8396;4195;4201;100,1;38,7;40,8
2017;3514403;Dracena;44867;22086;22781;103,1;39,1;92
2017;3514502;Duartina;12341;6020;6321;105;39,1;46,6
2017;3514601;Dumont;8866;4430;4436;100,1;34,5;79,6
2017;3514700;Echaporã;6285;3092;3193;103,3;37;12,2
2017;3514809;Eldorado;13845;7005;6840;97,6;33,9;8,4
2017;3514908;Elias Fausto;16972;8628;8344;96,7;34,3;83,9
2017;3514924;Elisiário;3168;1626;1542;94,8;37,5;33,7
2017;3514957;Embaúba;2381;1225;1156;94,4;38,2;28,6
2017;3515004;Embu das Artes;248954;120466;128488;106,7;32,4;3536,4
2017;3515103;Embu-Guaçu;65884;32592;33292;102,1;33,8;423,3
2017;3515129;Emilianópolis;3054;1527;1527;100;39,3;13,6
2017;3515152;Engenheiro Coelho;17927;9158;8769;95,8;31,7;163,1
2017;3515186;Espírito Santo do Pinhal;40894;19907;20987;105,4;38,2;105,1
2017;3515194;Espírito Santo do Turvo;4199;2110;2089;99;33,1;21,7
2017;3515202;Estrela d'Oeste;8948;4526;4422;97,7;38,1;30,2
2017;3515301;Estrela do Norte;2713;1357;1356;99,9;35,9;10,2
2017;3515350;Euclides da Cunha Paulista;8705;4336;4369;100,8;35,6;15,2
2017;3515400;Fartura;16164;7861;8303;105,6;37,3;37,7
2017;3515509;Fernandópolis;68886;33299;35587;106,9;38,5;125,3
2017;3515608;Fernando Prestes;5790;2854;2936;102,9;39,6;34,1
2017;3515657;Fernão;1621;828;793;95,8;37,1;16,1
2017;3515707;Ferraz de Vasconcelos;175690;85345;90345;105,9;32,5;5946,1
2017;3515806;Flora Rica;1620;812;808;99,5;41,7;7,2
2017;3515905;Floreal;2868;1413;1455;103;42,7;14
2017;3516002;Flórida Paulista;12970;7116;5854;82,3;37,1;24,7
2017;3516101;Florínea;3475;2003;1472;73,5;37,6;15,4
2017;3516200;Franca;340417;165507;174910;105,7;35,6;562
2017;3516309;Francisco Morato;161655;79603;82052;103,1;31,4;3299
2017;3516408;Franco da Rocha;139919;70909;69010;97,3;32,8;1053,8
2017;3516507;Gabriel Monteiro;2777;1392;1385;99,5;39,5;20
2017;3516606;Gália;6707;3313;3394;102,4;39,1;18,8
2017;3516705;Garça;42844;20729;22115;106,7;37,6;77,1
2017;3516804;Gastão Vidigal;3710;1871;1839;98,3;37,3;20,5
2017;3516853;Gavião Peixoto;4599;2321;2278;98,1;34,2;18,9
2017;3516903;General Salgado;10558;5259;5299;100,8;39;21,4
2017;3517000;Getulina;10545;5755;4790;83,2;37,2;15,6
2017;3517109;Glicério;4365;2153;2212;102,7;37,6;16
2017;3517208;Guaiçara;11080;5518;5562;100,8;34,9;40
2017;3517307;Guaimbê;5526;2746;2780;101,2;36,3;25,4
2017;3517406;Guaíra;38702;18980;19722;103,9;36,3;30,8
2017;3517505;Guapiaçu;20131;10050;10081;100,3;35,9;61,9
2017;3517604;Guapiara;17660;8962;8698;97,1;35,4;43,3
2017;3517703;Guará;19281;9493;9788;103,1;34,8;53,2
2017;3517802;Guaraçaí;7952;3941;4011;101,8;40,3;14
2017;3517901;Guaraci;10266;5174;5092;98,4;36,2;16
2017;3518008;Guarani d'Oeste;1975;977;998;102,1;39,2;23
2017;3518107;Guarantã;6458;3207;3251;101,4;35;14
2017;3518206;Guararapes;31122;15232;15890;104,3;37,9;32,6
2017;3518305;Guararema;29111;14494;14617;100,8;35,5;107,5
2017;3518404;Guaratinguetá;115910;55646;60264;108,3;37;154
2017;3518503;Guareí;14905;9017;5888;65,3;35,2;26,2
2017;3518602;Guariba;37002;18176;18826;103,6;33,9;136,9
2017;3518701;Guarujá;291739;141076;150663;106,8;34,1;2014,9
2017;3518800;Guarulhos;1272168;615183;656985;106,8;33,6;3992,1
2017;3518859;Guatapará;7216;3662;3554;97,1;35,1;17,4
2017;3518909;Guzolândia;4509;2310;2199;95,2;36,4;17,9
2017;3519006;Herculândia;8997;4448;4549;102,3;36,1;24,7
2017;3519055;Holambra;13489;6768;6721;99,3;34,7;205,7
2017;3519071;Hortolândia;219005;109568;109437;99,9;33,2;3508,8
2017;3519105;Iacanga;10269;5172;5097;98,5;36,7;18,8
2017;3519204;Iacri;6306;3166;3140;99,2;38,1;19,6
2017;3519253;Iaras;7332;4887;2445;50;35,8;18,3
2017;3519303;Ibaté;31726;16026;15700;98;33,5;109
2017;3519402;Ibirá;11385;5607;5778;103;38,1;41,9
2017;3519501;Ibirarema;6596;3302;3294;99,8;36,8;28,9
2017;3519600;Ibitinga;57405;28225;29180;103,4;36,1;83,3
2017;3519709;Ibiúna;74290;37509;36781;98,1;34,8;70,2
2017;3519808;Icém;7748;4141;3607;87,1;35,8;21,4
2017;3519907;Iepê;7689;3761;3928;104,4;37,8;12,9
2017;3520004;Igaraçu do Tietê;23378;11652;11726;100,6;35,5;239,2
2017;3520103;Igarapava;27120;13224;13896;105,1;36,8;57,9
2017;3520202;Igaratá;9917;5013;4904;97,8;35,7;33,9
2017;3520301;Iguape;29250;14683;14567;99,2;37,1;14,8
2017;3520400;Ilhabela;32088;16062;16026;99,8;33,5;92,6
2017;3520426;Ilha Comprida;11653;5769;5884;102;39,4;59,3
2017;3520442;Ilha Solteira;25641;12469;13172;105,6;38,6;39,3
2017;3520509;Indaiatuba;233277;114791;118486;103,2;35,5;748,8
2017;3520608;Indiana;4997;2518;2479;98,5;37,6;38,6
2017;3520707;Indiaporã;4021;1967;2054;104,4;40,5;14,4
2017;3520806;Inúbia Paulista;3649;1808;1841;101,8;37,8;41,9
2017;3520905;Ipaussu;13745;6819;6926;101,6;35,5;65,6
2017;3521002;Iperó;33172;17801;15371;86,3;33,1;194,8
2017;3521101;Ipeúna;6566;3333;3233;97;34,4;34,6
2017;3521150;Ipiguá;5773;2915;2858;98;36,8;42,4
2017;3521200;Iporanga;4185;2115;2070;97,9;34;3,6
2017;3521309;Ipuã;14422;7245;7177;99,1;34,3;30,9
2017;3521408;Iracemápolis;21252;10599;10653;100,5;35,2;184,6
2017;3521507;Irapuã;7096;3629;3467;95,5;36,6;27,5
2017;3521606;Irapuru;7441;4294;3147;73,3;38,8;34,7
2017;3521705;Itaberá;18017;9052;8965;99;35,5;16,4
2017;3521804;Itaí;24825;12994;11831;91;34,7;22,7
2017;3521903;Itajobi;15949;8006;7943;99,2;38,4;31,8
2017;3522000;Itaju;3463;1764;1699;96,3;36,1;15
2017;3522109;Itanhaém;102657;49569;53088;107,1;36,8;170,6
2017;3522158;Itaoca;3348;1709;1639;95,9;36,5;18,3
2017;3522208;Itapecerica da Serra;157507;77732;79775;102,6;32,6;1044,9
2017;3522307;Itapetininga;152877;76370;76507;100,2;34,8;85,4
2017;3522406;Itapeva;89589;44061;45528;103,3;34,1;49,1
2017;3522505;Itapevi;220513;107917;112596;104,3;31,5;2667,8
2017;3522604;Itapira;70938;34921;36017;103,1;37,8;136,8
2017;3522653;Itapirapuã Paulista;4108;2120;1988;93,8;32,4;10,1
2017;3522703;Itápolis;39950;19670;20280;103,1;37,8;40,1
2017;3522802;Itaporanga;14437;7145;7292;102,1;36,6;28,4
2017;3522901;Itapuí;13082;6555;6527;99,6;34,8;93,4
2017;3523008;Itapura;4209;2142;2067;96,5;36,7;14
2017;3523107;Itaquaquecetuba;350972;172153;178819;103,9;31,4;4247,9
2017;3523206;Itararé;46370;22666;23704;104,6;35,1;46,2
2017;3523305;Itariri;15569;7782;7787;100,1;33,8;56,9
2017;3523404;Itatiba;113733;55911;57822;103,4;36;352,9
2017;3523503;Itatinga;18811;9818;8993;91,6;33,2;19,2
2017;3523602;Itirapina;15915;9368;6547;69,9;34,8;28,2
2017;3523701;Itirapuã;5856;2978;2878;96,6;35;36,3
2017;3523800;Itobi;7842;4013;3829;95,4;36,1;56,4
2017;3523909;Itu;163458;80278;83180;103,6;35,2;255,1
2017;3524006;Itupeva;59943;30221;29722;98,3;32,8;298,4
2017;3524105;Ituverava;38222;18544;19678;106,1;37,4;54,2
2017;3524204;Jaborandi;6441;3214;3227;100,4;36,7;23,6
2017;3524303;Jaboticabal;72289;34735;37554;108,1;37,5;102,3
2017;3524402;Jacareí;230102;111570;118532;106,2;35,6;495,6
2017;3524501;Jaci;6799;3448;3351;97,2;34,5;46,8
2017;3524600;Jacupiranga;16672;8363;8309;99,4;34,9;23,7
2017;3524709;Jaguariúna;53133;26040;27093;104;35;375,8
2017;3524808;Jales;48404;23524;24880;105,8;39,1;131,3
2017;3524907;Jambeiro;5985;3040;2945;96,9;35,7;32,5
2017;3525003;Jandira;114854;55937;58917;105,3;32,6;6582,2
2017;3525102;Jardinópolis;42133;21560;20573;95,4;34,8;84
2017;3525201;Jarinu;31844;16013;15831;98,9;34,3;153,4
2017;3525300;Jaú;133204;64748;68456;105,7;37;193,9
2017;3525409;Jeriquara;3571;1838;1733;94,3;33,3;25,2
2017;3525508;Joanópolis;12433;6286;6147;97,8;37,3;33,2
2017;3525607;João Ramalho;4338;2183;2155;98,7;34,4;10,4
2017;3525706;José Bonifácio;35183;17426;17757;101,9;36,2;40,9
2017;3525805;Júlio Mesquita;4347;2126;2221;104,5;35,8;33,9
2017;3525854;Jumirim;2968;1491;1477;99,1;34,6;52,4
2017;3525904;Jundiaí;413373;200099;213274;106,6;37,1;958,6
2017;3526001;Junqueirópolis;19871;10442;9429;90,3;38,2;34,1
2017;3526100;Juquiá;18205;9170;9035;98,5;35,9;22,4
2017;3526209;Juquitiba;28201;14233;13968;98,1;34,2;54
2017;3526308;Lagoinha;4972;2526;2446;96,8;39,6;19,5
2017;3526407;Laranjal Paulista;25901;12699;13202;104;36,7;67,4
2017;3526506;Lavínia;9304;6760;2544;37,6;36;17,3
2017;3526605;Lavrinhas;6975;3486;3489;100,1;33,1;41,7
2017;3526704;Leme;96207;47642;48565;101,9;35;238,8
2017;3526803;Lençóis Paulista;64704;31983;32721;102,3;35,3;79,9
2017;3526902;Limeira;286652;140179;146473;104,5;36,4;493,6
2017;3527009;Lindóia;6921;3426;3495;102;37,3;142
2017;3527108;Lins;73884;35629;38255;107,4;37,4;129,6
2017;3527207;Lorena;84317;40506;43811;108,2;36,1;203,6
2017;3527256;Lourdes;2057;1041;1016;97,6;39,3;18,1
2017;3527306;Louveira;45564;22825;22739;99,6;32,6;817,5
2017;3527405;Lucélia;20115;10957;9158;83,6;38,3;63,9
2017;3527504;Lucianópolis;2323;1168;1155;98,9;37,2;12,3
2017;3527603;Luís Antônio;11907;6020;5887;97,8;32,8;19,9
2017;3527702;Luiziânia;4876;2471;2405;97,3;35,9;29,3
2017;3527801;Lupércio;4176;2039;2137;104,8;36,2;26,9
2017;3527900;Lutécia;2715;1349;1366;101,3;37,1;5,7
2017;3528007;Macatuba;16726;8319;8407;101,1;35,3;74,5
2017;3528106;Macaubal;7585;3805;3780;99,3;40,1;30,6
2017;3528205;Macedônia;3859;1928;1931;100,2;39,7;11,8
2017;3528304;Magda;3235;1619;1616;99,8;40,3;10,4
2017;3528403;Mairinque;47508;23824;23684;99,4;34,8;226,1
2017;3528502;Mairiporã;88910;44532;44378;99,7;34,9;277,2
2017;3528601;Manduri;9549;4755;4794;100,8;37;41,7
2017;3528700;Marabá Paulista;4682;2943;1739;59,1;35,6;5,1
2017;3528809;Maracaí;13051;6481;6570;101,4;36,5;24,5
2017;3528858;Marapoama;3035;1557;1478;94,9;37,3;27,3
2017;3528908;Mariápolis;3704;1876;1828;97,4;38,1;19,9
2017;3529005;Marília;229898;110566;119332;107,9;36,9;196,4
2017;3529104;Marinópolis;1990;1010;980;97;38,9;25,6
2017;3529203;Martinópolis;24689;12750;11939;93,6;37;19,7
2017;3529302;Matão;78717;38805;39912;102,9;36,8;150
2017;3529401;Mauá;421367;204470;216897;106,1;34;6803,1
2017;3529500;Mendonça;5540;2794;2746;98,3;37,6;28,4
2017;3529609;Meridiano;4326;2117;2209;104,3;38,2;19
2017;3529658;Mesópolis;1924;971;953;98,1;37,2;12,9
2017;3529708;Miguelópolis;20065;9906;10159;102,6;35,1;24,4
2017;3529807;Mineiros do Tietê;11637;5786;5851;101,1;36,3;54,6
2017;3529906;Miracatu;19553;9811;9742;99,3;34,6;19,5
2017;3530003;Mira Estrela;3006;1499;1507;100,5;39,9;13,9
2017;3530102;Mirandópolis;28059;15703;12356;78,7;39;30,6
2017;3530201;Mirante do Paranapanema;16528;8305;8223;99;37,9;13,3
2017;3530300;Mirassol;59518;28993;30525;105,3;37,1;244,7
2017;3530409;Mirassolândia;4507;2277;2230;97,9;37,1;27,1
2017;3530508;Mococa;67612;33383;34229;102,5;37,5;79,1
2017;3530607;Mogi das Cruzes;427289;206693;220596;106,7;34,6;599,7
2017;3530706;Mogi Guaçu;147769;72583;75186;103,6;36,1;181,8
2017;3530805;Mogi Mirim;90869;44429;46440;104,5;37,3;182,6
2017;3530904;Mombuca;3539;1763;1776;100,7;34;26,5
2017;3531001;Monções;2048;1035;1013;97,9;40,9;19,6
2017;3531100;Mongaguá;55651;28102;27549;98;37,1;389,8
2017;3531209;Monte Alegre do Sul;8060;3996;4064;101,7;39,2;73,1
2017;3531308;Monte Alto;47465;23297;24168;103,7;38,3;136,8
2017;3531407;Monte Aprazível;22158;10906;11252;103,2;38,3;44,7
2017;3531506;Monte Azul Paulista;18585;9314;9271;99,5;37,8;70,5
2017;3531605;Monte Castelo;4173;2074;2099;101,2;39;17,9
2017;3531704;Monteiro Lobato;4148;2107;2041;96,9;37,3;12,5
2017;3531803;Monte Mor;58322;28930;29392;101,6;33,3;242,4
2017;3531902;Morro Agudo;28764;14335;14429;100,7;34;20,7
2017;3532009;Morungaba;12967;6402;6565;102,5;35,2;88,4
2017;3532058;Motuca;4188;2119;2069;97,6;35,8;18,3
2017;3532108;Murutinga do Sul;3952;1973;1979;100,3;41;15,8
2017;3532157;Nantes;2695;1336;1359;101,7;34;9,4
2017;3532207;Narandiba;5143;2577;2566;99,6;33,5;14,4
2017;3532306;Natividade da Serra;6881;3590;3291;91,7;38,8;8,3
2017;3532405;Nazaré Paulista;17556;8961;8595;95,9;36,6;53,8
2017;3532504;Neves Paulista;9341;4631;4710;101,7;40,3;42,6
2017;3532603;Nhandeara;10304;5003;5301;106;41;23,6
2017;3532702;Nipoã;4579;2376;2203;92,7;34,9;33,3
2017;3532801;Nova Aliança;6364;3143;3221;102,5;37,3;29,3
2017;3532827;Nova Campina;8558;4312;4246;98,5;31,5;22,2
2017;3532843;Nova Canaã Paulista;2079;1046;1033;98,8;42,7;16,7
2017;3532868;Nova Castilho;1112;551;561;101,8;36,9;6,1
2017;3532900;Nova Europa;9375;4692;4683;99,8;35,1;58,5
2017;3533007;Nova Granada;19404;9678;9726;100,5;36,7;36,5
2017;3533106;Nova Guataporanga;2169;1076;1093;101,6;39,5;63,5
2017;3533205;Nova Independência;3975;2089;1886;90,3;33,9;15
2017;3533254;Novais;4530;2345;2185;93,2;32,9;38,5
2017;3533304;Nova Luzitânia;3148;1611;1537;95,4;37;42,6
2017;3533403;Nova Odessa;57779;28396;29383;103,5;35,9;783
2017;3533502;Novo Horizonte;37882;18762;19120;101,9;37,3;40,7
2017;3533601;Nuporanga;7179;3570;3609;101,1;36,6;20,6
2017;3533700;Ocauçu;4260;2180;2080;95,4;36,7;14,2
2017;3533809;Óleo;2597;1310;1287;98,2;39;13,1
2017;3533908;Olímpia;53262;26046;27216;104,5;36,9;66,4
2017;3534005;Onda Verde;4390;2231;2159;96,8;35,1;18,1
2017;3534104;Oriente;6162;2980;3182;106,8;38,5;28,2
2017;3534203;Orindiúva;5901;2966;2935;99;33,8;23,9
2017;3534302;Orlândia;39257;19087;20170;105,7;36,6;134,6
2017;3534401;Osasco;709509;339152;370357;109,2;34,7;10923,2
2017;3534500;Oscar Bressane;2520;1217;1303;107,1;41;11,3
2017;3534609;Osvaldo Cruz;31268;15631;15637;100;39,3;126,1
2017;3534708;Ourinhos;104456;50120;54336;108,4;36,7;353,1
2017;3534757;Ouroeste;9612;4758;4854;102;36,8;33,3
2017;3534807;Ouro Verde;7858;3827;4031;105,3;35,8;29,5
2017;3534906;Pacaembu;14236;8963;5273;58,8;38,2;41,9
2017;3535002;Palestina;11318;5672;5646;99,5;38;16,2
2017;3535101;Palmares Paulista;10244;5266;4978;94,5;33;124,7
2017;3535200;Palmeira d'Oeste;9266;4631;4635;100,1;40,9;29,1
2017;3535309;Palmital;20447;9972;10475;105;38,9;37,3
2017;3535408;Panorama;15029;7471;7558;101,2;34,9;42,2
2017;3535507;Paraguaçu Paulista;41899;20980;20919;99,7;36,3;41,8
2017;3535606;Paraibuna;17706;8974;8732;97,3;36,5;21,9
2017;3535705;Paraíso;6059;3068;2991;97,5;37,7;39
2017;3535804;Paranapanema;18768;9550;9218;96,5;34;18,4
2017;3535903;Paranapuã;3948;1988;1960;98,6;37,3;28,1
2017;3536000;Parapuã;10777;5404;5373;99,4;39,3;29,4
2017;3536109;Pardinho;6572;3338;3234;96,9;34,7;31,3
2017;3536208;Pariquera-Açu;19027;9424;9603;101,9;35,3;52,9
2017;3536257;Parisi;2542;1258;1284;102,1;38,7;30
2017;3536307;Patrocínio Paulista;13972;7062;6910;97,8;34,8;23,2
2017;3536406;Paulicéia;7356;3749;3607;96,2;34,7;19,7
2017;3536505;Paulínia;98667;48308;50359;104,2;34,3;711
2017;3536570;Paulistânia;1953;986;967;98,1;36,3;7,6
2017;3536604;Paulo de Faria;7976;4002;3974;99,3;37,5;10,8
2017;3536703;Pederneiras;43691;21812;21879;100,3;35,4;60,1
2017;3536802;Pedra Bela;6206;3232;2974;92;37,9;39,1
2017;3536901;Pedranópolis;2716;1377;1339;97,2;40,6;10,4
2017;3537008;Pedregulho;15711;7924;7787;98,3;35,4;22
2017;3537107;Pedreira;42632;20991;21641;103,1;36,6;391,8
2017;3537156;Pedrinhas Paulista;2862;1411;1451;102,8;38,4;18,8
2017;3537206;Pedro de Toledo;10891;5552;5339;96,2;35,9;16,2
2017;3537305;Penápolis;60752;29416;31336;106,5;37,7;85,4
2017;3537404;Pereira Barreto;24760;12065;12695;105,2;37,9;25,4
2017;3537503;Pereiras;8222;4125;4097;99,3;36,2;36,8
2017;3537602;Peruíbe;65241;31619;33622;106,3;37;200
2017;3537701;Piacatu;5507;2758;2749;99,7;37,8;23,7
2017;3537800;Piedade;52901;26737;26164;97,9;36,2;70,8
2017;3537909;Pilar do Sul;27279;13833;13446;97,2;35,2;40
2017;3538006;Pindamonhangaba;158335;77224;81111;105;34,9;216,5
2017;3538105;Pindorama;14856;7480;7376;98,6;38,5;80,4
2017;3538204;Pinhalzinho;14374;7184;7190;100,1;38,3;93
2017;3538303;Piquerobi;3392;1644;1748;106,3;38,4;7
2017;3538501;Piquete;13314;6406;6908;107,8;38,3;75,6
2017;3538600;Piracaia;25772;12689;13083;103,1;37,4;66,8
2017;3538709;Piracicaba;400842;194876;205966;105,7;36,3;290,9
2017;3538808;Piraju;29245;14163;15082;106,5;37,5;58
2017;3538907;Pirajuí;22738;12167;10571;86,9;37,3;27,6
2017;3539004;Pirangi;10822;5438;5384;99;38,4;50,1
2017;3539103;Pirapora do Bom Jesus;17225;8560;8665;101,2;31,5;158,8
2017;3539202;Pirapozinho;25210;12293;12917;105,1;36,6;52,8
2017;3539301;Pirassununga;72491;35177;37314;106,1;37,5;99,7
2017;3539400;Piratininga;13888;6806;7082;104,1;37,1;34,5
2017;3539509;Pitangueiras;34669;17426;17243;98,9;33,8;80,5
2017;3539608;Planalto;4471;2253;2218;98,4;35,6;15,4
2017;3539707;Platina;3137;1603;1534;95,7;36,1;9,6
2017;3539806;Poá;105833;50987;54846;107,6;34,3;6130,4
2017;3539905;Poloni;5530;2718;2812;103,5;38,7;40,9
2017;3540002;Pompéia;20226;9913;10313;104;37,4;25,8
2017;3540101;Pongaí;3458;1761;1697;96,4;40;18,9
2017;3540200;Pontal;38915;19950;18965;95,1;32,4;109,2
2017;3540259;Pontalinda;4117;2195;1922;87,6;35,4;19,6
2017;3540309;Pontes Gestal;2473;1233;1240;100,6;38,4;11,4
2017;3540408;Populina;4206;2099;2107;100,4;39,4;13,3
2017;3540507;Porangaba;9623;4923;4700;95,5;39;36,2
2017;3540606;Porto Feliz;53507;27072;26435;97,6;35,8;96,1
2017;3540705;Porto Ferreira;52437;25738;26699;103,7;36,6;214,1
2017;3540754;Potim;20047;11306;8741;77,3;32,5;449
2017;3540804;Potirendaba;17299;8643;8656;100,2;37,4;50,5
2017;3540853;Pracinha;2702;1953;749;38,4;33,8;42,9
2017;3540903;Pradópolis;17331;8682;8649;99,6;34,8;103,5
2017;3541000;Praia Grande;314948;150302;164646;109,5;35,6;2104,5
2017;3541059;Pratânia;4942;2497;2445;97,9;32,9;28,2
2017;3541109;Presidente Alves;3974;1969;2005;101,8;37,8;13,9
2017;3541208;Presidente Bernardes;14206;7544;6662;88,3;39,7;19
2017;3541307;Presidente Epitácio;40659;19753;20906;105,8;36,5;32,3
2017;3541406;Presidente Prudente;219349;105214;114135;108,5;37,3;391,2
2017;3541505;Presidente Venceslau;36640;17956;18684;104,1;39;48,5
2017;3541604;Promissão;35723;17641;18082;102,5;36,3;45,8
2017;3541653;Quadra;3346;1733;1613;93,1;36,8;16,3
2017;3541703;Quatá;13090;6524;6566;100,6;35,5;20,1
2017;3541802;Queiroz;3054;1539;1515;98,4;33,5;13
2017;3541901;Queluz;10094;5067;5027;99,2;34,8;40,5
2017;3542008;Quintana;6590;3236;3354;103,6;36,2;20,7
2017;3542107;Rafard;8821;4363;4458;102,2;35,8;72,5
2017;3542206;Rancharia;28837;14033;14804;105,5;37,1;18,2
2017;3542305;Redenção da Serra;4264;2230;2034;91,2;38,2;13,8
2017;3542404;Regente Feijó;19578;9679;9899;102,3;37,2;74,4
2017;3542503;Reginópolis;7543;4719;2824;59,8;34,9;18,4
2017;3542602;Registro;58047;28705;29342;102,2;35,2;80,4
2017;3542701;Restinga;6506;3242;3264;100,7;33,6;26,5
2017;3542800;Ribeira;3238;1663;1575;94,7;36,5;9,6
2017;3542909;Ribeirão Bonito;11583;5770;5813;100,7;35,8;24,6
2017;3543006;Ribeirão Branco;18506;9464;9042;95,5;32,3;26,5
2017;3543105;Ribeirão Corrente;4469;2268;2201;97;33,7;30,1
2017;3543204;Ribeirão do Sul;4606;2313;2293;99,1;38,5;22,7
2017;3543238;Ribeirão dos Índios;2110;1037;1073;103,5;40;10,7
2017;3543253;Ribeirão Grande;7523;3861;3662;94,8;35,7;22,6
2017;3543303;Ribeirão Pires;115463;56075;59388;105,9;36,4;1166,6
2017;3543402;Ribeirão Preto;662411;316304;346107;109,4;36,4;1017,7
2017;3543501;Riversul;5875;2946;2929;99,4;36,7;15,2
2017;3543600;Rifaina;3792;1899;1893;99,7;37,3;23,3
2017;3543709;Rincão;9747;4872;4875;100,1;35,9;30,8
2017;3543808;Rinópolis;9608;4806;4802;99,9;39,2;26,8
2017;3543907;Rio Claro;195919;94850;101069;106,6;36,9;393,1
2017;3544004;Rio das Pedras;30740;15410;15330;99,5;34,1;135,6
2017;3544103;Rio Grande da Serra;44495;21896;22599;103,2;33,3;1224,4
2017;3544202;Riolândia;10447;6221;4226;67,9;34,7;16,5
2017;3544251;Rosana;18628;9233;9395;101,8;36,3;25
2017;3544301;Roseira;10379;5216;5163;99;34,5;79,9
2017;3544400;Rubiácea;2732;1377;1355;98,4;35,3;11,6
2017;3544509;Rubinéia;3437;1699;1738;102,3;41,3;14,2
2017;3544608;Sabino;5230;2573;2657;103,3;39,2;17,1
2017;3544707;Sagres;2456;1194;1262;105,7;37,4;16,6
2017;3544806;Sales;6111;3052;3059;100,2;38,4;19,8
2017;3544905;Sales Oliveira;11121;5420;5701;105,2;37;36,4
2017;3545001;Salesópolis;15434;7714;7720;100,1;35,7;36,3
2017;3545100;Salmourão;4830;2448;2382;97,3;36,8;27,9
2017;3545159;Saltinho;7726;3809;3917;102,8;37,8;77,5
2017;3545209;Salto;122485;60228;62257;103,4;35,2;920,5
2017;3545308;Salto de Pirapora;42558;21143;21415;101,3;35,3;151,8
2017;3545407;Salto Grande;9022;4421;4601;104,1;37,1;47,9
2017;3545506;Sandovalina;3701;1870;1831;97,9;34,5;8,1
2017;3545605;Santa Adélia;14223;7051;7172;101,7;37,1;43,1
2017;3545704;Santa Albertina;6145;3083;3062;99,3;39,5;22,5
2017;3545803;Santa Bárbara d'Oeste;183144;90301;92843;102,8;36,5;675,7
2017;3546009;Santa Branca;13975;6968;7007;100,6;37,2;51,3
2017;3546108;Santa Clara d'Oeste;2394;1212;1182;97,5;38,1;13
2017;3546207;Santa Cruz da Conceição;4206;2067;2139;103,5;39,6;28
2017;3546256;Santa Cruz da Esperança;2093;1041;1052;101,1;36,7;14,1
2017;3546306;Santa Cruz das Palmeiras;29567;14803;14764;99,7;35,3;100,1
2017;3546405;Santa Cruz do Rio Pardo;45565;22229;23336;105;36,8;40,9
2017;3546504;Santa Ernestina;5901;2994;2907;97,1;34,1;43,9
2017;3546603;Santa Fé do Sul;32513;15659;16854;107,6;38,4;157,4
2017;3546702;Santa Gertrudes;22948;11597;11351;97,9;32,8;233,5
2017;3546801;Santa Isabel;52460;26076;26384;101,2;35,2;144,4
2017;3546900;Santa Lúcia;7733;3845;3888;101,1;34,9;50,3
2017;3547007;Santa Maria da Serra;5316;2687;2629;97,8;34,5;21
2017;3547106;Santa Mercedes;2942;1464;1478;101;36,9;17,6
2017;3547205;Santana da Ponte Pensa;1665;841;824;98;42,9;12,8
2017;3547304;Santana de Parnaíba;134989;65975;69014;104,6;33,3;750,1
2017;3547403;Santa Rita d'Oeste;2669;1312;1357;103,4;42,1;12,7
2017;3547502;Santa Rita do Passa Quatro;25685;12351;13334;108;40,5;34,1
2017;3547601;Santa Rosa de Viterbo;23813;11606;12207;105,2;37,4;82,5
2017;3547650;Santa Salete;1570;787;783;99,5;40,5;19,8
2017;3547700;Santo Anastácio;19128;9246;9882;106,9;38,9;34,6
2017;3547809;Santo André;723606;344948;378658;109,8;37,6;4116,5
2017;3547908;Santo Antônio da Alegria;6556;3367;3189;94,7;37,3;21,1
2017;3548005;Santo Antônio de Posse;22207;11137;11070;99,4;34,7;144,1
2017;3548054;Santo Antônio do Aracanguá;8160;4105;4055;98,8;36,6;6,2
2017;3548104;Santo Antônio do Jardim;6059;3073;2986;97,2;37,8;55,1
2017;3548203;Santo Antônio do Pinhal;6905;3473;3432;98,8;36,4;51,9
2017;3548302;Santo Expedito;2920;1446;1474;101,9;38,9;30,9
2017;3548401;Santópolis do Aguapeí;4113;2046;2067;101;35,1;32,1
2017;3548500;Santos;422760;192429;230331;119,7;40,8;1504,3
2017;3548609;São Bento do Sapucaí;11278;5630;5648;100,3;38,1;44,7
2017;3548708;São Bernardo do Campo;799563;382901;416662;108,8;35,9;1952,4
2017;3548807;São Caetano do Sul;160022;73415;86607;118;40,8;10438
2017;3548906;São Carlos;241896;118157;123739;104,7;36,7;212,8
2017;3549003;São Francisco;2717;1347;1370;101,7;40,7;35,9
2017;3549102;São João da Boa Vista;89267;43063;46204;107,3;38,1;172,9
2017;3549201;São João das Duas Pontes;2598;1292;1306;101,1;38,4;20,1
2017;3549250;São João de Iracema;1817;905;912;100,8;37,4;10,2
2017;3549300;São João do Pau d'Alho;2197;1085;1112;102,5;41,5;18,7
2017;3549409;São Joaquim da Barra;48043;23384;24659;105,5;36,4;116,9
2017;3549508;São José da Bela Vista;8014;4064;3950;97,2;33,8;28,9
2017;3549607;São José do Barreiro;3976;1997;1979;99,1;36,4;7
2017;3549706;São José do Rio Pardo;52384;25470;26914;105,7;38;124,8
2017;3549805;São José do Rio Preto;452684;216655;236029;108,9;37,3;1048
2017;3549904;São José dos Campos;673348;326716;346632;106,1;35,2;612,5
2017;3549953;São Lourenço da Serra;15284;7711;7573;98,2;34,9;82
2017;3550001;São Luiz do Paraitinga;10435;5299;5136;96,9;38,9;16,9
2017;3550100;São Manuel;37975;18598;19377;104,2;36,2;58,4
2017;3550209;São Miguel Arcanjo;32021;16209;15812;97,6;34,8;34,4
2017;3550308;São Paulo;11471199;5414040;6057159;111,9;36,2;7540,9
2017;3550407;São Pedro;35664;17345;18319;105,6;38;58,3
2017;3550506;São Pedro do Turvo;7214;3662;3552;97;35,8;9,9
2017;3550605;São Roque;79551;38969;40582;104,1;36,5;259,2
2017;3550704;São Sebastião;78657;38820;39837;102,6;33,3;195,5
2017;3550803;São Sebastião da Grama;11258;5672;5586;98,5;37,3;44,6
2017;3550902;São Simão;13948;6861;7087;103,3;37,6;22,6
2017;3551009;São Vicente;334928;161162;173766;107,8;35,4;2260,7
2017;3551108;Sarapuí;9867;5001;4866;97,3;35,4;28
2017;3551207;Sarutaiá;3697;1849;1848;99,9;36,2;26,1
2017;3551306;Sebastianópolis do Sul;3116;1524;1592;104,5;38,7;18,6
2017;3551405;Serra Azul;12174;7634;4540;59,5;34,7;43
2017;3551504;Serrana;42049;20833;21216;101,8;32,9;333,6
2017;3551603;Serra Negra;28604;13857;14747;106,4;39,2;140,4
2017;3551702;Sertãozinho;120634;59128;61506;104;34,8;299,3
2017;3551801;Sete Barras;12903;6591;6312;95,8;35;12,1
2017;3551900;Severínia;15105;7798;7307;93,7;34,4;107,5
2017;3552007;Silveiras;6041;3026;3015;99,6;35,9;14,6
2017;3552106;Socorro;38898;19193;19705;102,7;39,3;86,6
2017;3552205;Sorocaba;669084;325067;344017;105,8;35,4;1487,3
2017;3552304;Sud Mennucci;7408;3695;3713;100,5;36,5;12,5
2017;3552403;Sumaré;264908;130410;134498;103,1;33,8;1726,2
2017;3552502;Suzano;289643;140933;148710;105,5;33,4;1404,4
2017;3552551;Suzanápolis;3431;1760;1671;94,9;37,4;10,4
2017;3552601;Tabapuã;11458;5705;5753;100,8;38,6;33,1
2017;3552700;Tabatinga;14776;7415;7361;99,3;35,5;40,1
2017;3552809;Taboão da Serra;263991;125715;138276;110;33,6;12948,5
2017;3552908;Taciba;6064;2994;3070;102,5;35,6;10
2017;3553005;Taguaí;11939;5919;6020;101,7;33,6;82,2
2017;3553104;Taiaçu;5801;2938;2863;97,4;37;54,2
2017;3553203;Taiúva;6109;3272;2837;86,7;38,2;46,1
2017;3553302;Tambaú;22015;10878;11137;102,4;36,8;39,2
2017;3553401;Tanabi;24993;12379;12614;101,9;38,4;33,4
2017;3553500;Tapiraí;8030;4041;3989;98,7;34,2;10,6
2017;3553609;Tapiratiba;12296;6018;6278;104,3;37,6;55,4
2017;3553658;Taquaral;2708;1347;1361;101;37;50,2
2017;3553708;Taquaritinga;53462;26161;27301;104,4;37,1;90
2017;3553807;Taquarituba;23595;12015;11580;96,4;35,6;52,6
2017;3553856;Taquarivaí;6106;3087;3019;97,8;31,9;26,3
2017;3553906;Tarabai;6609;3267;3342;102,3;34,9;32,8
2017;3553955;Tarumã;14158;7114;7044;99;34;46,7
2017;3554003;Tatuí;117617;57715;59902;103,8;35,1;224,6
2017;3554102;Taubaté;299297;145303;153994;106;35,9;478,9
2017;3554201;Tejupá;4454;2275;2179;95,8;34,5;15
2017;3554300;Teodoro Sampaio;22001;10901;11100;101,8;34,4;14,1
2017;3554409;Terra Roxa;8234;4130;4104;99,4;36,6;37,2
2017;3554508;Tietê;37410;18477;18933;102,5;36,7;92,5
2017;3554607;Timburi;2572;1300;1272;97,8;39,1;13,1
2017;3554656;Torre de Pedra;2143;1103;1040;94,3;38,6;30
2017;3554706;Torrinha;9317;4674;4643;99,3;38,4;29,6
2017;3554755;Trabiju;1618;813;805;99;34,6;25,5
2017;3554805;Tremembé;47203;25119;22084;87,9;35,1;247
2017;3554904;Três Fronteiras;6253;3134;3119;99,5;38,8;41,2
2017;3554953;Tuiuti;6495;3277;3218;98,2;39,3;51,3
2017;3555000;Tupã;64154;30823;33331;108,1;39,1;102,2
2017;3555109;Tupi Paulista;15326;7930;7396;93,3;40,8;62,6
2017;3555208;Turiúba;1884;958;926;96,7;40,8;12,3
2017;3555307;Turmalina;1809;888;921;103,7;43,9;12,2
2017;3555356;Ubarana;5356;2747;2609;95;33,7;25,5
2017;3555406;Ubatuba;86843;43035;43808;101,8;34,3;122,6
2017;3555505;Ubirajara;4830;2495;2335;93,6;35,1;17,1
2017;3555604;Uchoa;10077;4973;5104;102,6;38,7;39,9
2017;3555703;União Paulista;1619;816;803;98,4;34,9;20,5
2017;3555802;Urânia;8893;4387;4506;102,7;39,5;42,5
2017;3555901;Uru;1352;675;677;100,3;39,1;9,2
2017;3556008;Urupês;13377;6600;6777;102,7;39,3;41,3
2017;3556107;Valentim Gentil;12872;6432;6440;100,1;35,9;86
2017;3556206;Valinhos;118675;58137;60538;104,1;37,3;799
2017;3556305;Valparaíso;23750;13144;10606;80,7;35;27,7
2017;3556354;Vargem;9802;5012;4790;95,6;36,2;68,7
2017;3556404;Vargem Grande do Sul;39938;19726;20212;102,5;36,4;149,5
2017;3556453;Vargem Grande Paulista;47730;23486;24244;103,2;34,1;1123,3
2017;3556503;Várzea Paulista;113417;56385;57032;101,1;33,6;3229,4
2017;3556602;Vera Cruz;10485;5142;5343;103,9;38,5;42,3
2017;3556701;Vinhedo;71470;35041;36429;104;36,4;882,9
2017;3556800;Viradouro;17511;8720;8791;100,8;35,7;80,4
2017;3556909;Vista Alegre do Alto;7587;3858;3729;96,7;34,3;79,5
2017;3556958;Vitória Brasil;1791;916;875;95,5;38;35,9
2017;3557006;Votorantim;120523;59242;61281;103,4;34,3;654,4
2017;3557105;Votuporanga;91951;44555;47396;106,4;37,9;218,6
2017;3557154;Zacarias;2581;1289;1292;100,2;37,8;8,1
2017;3557204;Chavantes;12322;6045;6277;103,8;36,2;65,3
2017;3557303;Estiva Gerbi;10801;5422;5379;99,2;35;145,7
2018;3500105;Adamantina;34551;16668;17883;107,3;39,9;83,9
2018;3500204;Adolfo;4100;2036;2064;101,4;38,6;19,4
2018;3500303;Aguaí;32266;16068;16198;100,8;35,6;68
2018;3500402;Águas da Prata;7505;3637;3868;106,4;41,1;52,6
2018;3500501;Águas de Lindóia;17866;8710;9156;105,1;39,2;297,1
2018;3500550;Águas de Santa Bárbara;6731;3351;3380;100,9;37,9;16,6
2018;3500600;Águas de São Pedro;2776;1299;1477;113,7;44,2;768,5
2018;3500709;Agudos;36847;18121;18726;103,3;35,6;38,1
2018;3500758;Alambari;5735;2887;2848;98,6;35,2;35,9
2018;3500808;Alfredo Marcondes;4285;2148;2137;99,5;40,4;36
2018;3500907;Altair;3613;1877;1736;92,5;35,3;11,5
2018;3501004;Altinópolis;16459;8156;8303;101,8;37,2;17,7
2018;3501103;Alto Alegre;4011;2027;1984;97,9;41,2;12,6
2018;3501152;Alumínio;17305;8644;8661;100,2;34,2;207
2018;3501202;Álvares Florence;3938;2006;1932;96,3;42,3;10,9
2018;3501301;Álvares Machado;26185;12787;13398;104,8;36,4;75,3
2018;3501400;Álvaro de Carvalho;4782;3146;1636;52;35,4;31,1
2018;3501509;Alvinlândia;2947;1453;1494;102,8;35,9;34,7
2018;3501608;Americana;229381;111270;118111;106,1;37,7;1712,9
2018;3501707;Américo Brasiliense;33856;16836;17020;101,1;34,1;275,3
2018;3501806;Américo de Campos;5879;2878;3001;104,3;39,7;23,2
2018;3501905;Amparo;67691;33053;34638;104,8;38,2;152
2018;3502002;Analândia;4515;2289;2226;97,2;36,5;13,9
2018;3502101;Andradina;58775;29105;29670;101,9;38,2;61
2018;3502200;Angatuba;23519;11841;11678;98,6;35,7;22,9
2018;3502309;Anhembi;5708;2910;2798;96,2;35,3;7,7
2018;3502408;Anhumas;3933;1931;2002;103,7;37,1;12,3
2018;3502507;Aparecida;33810;16263;17547;107,9;37;279,7
2018;3502606;Aparecida d'Oeste;4262;2114;2148;101,6;41,1;23,8
2018;3502705;Apiaí;25040;12529;12511;99,9;34,8;25,7
2018;3502754;Araçariguama;19967;10074;9893;98,2;32,5;137,5
2018;3502804;Araçatuba;195390;93279;102111;109,5;38;167,4
2018;3502903;Araçoiaba da Serra;30968;15414;15554;100,9;37,9;121,3
2018;3503000;Aramina;5394;2651;2743;103,5;37,8;26,6
2018;3503109;Arandu;6633;3334;3299;99;35,5;23,2
2018;3503158;Arapeí;2415;1208;1207;99,9;37,7;15,4
2018;3503208;Araraquara;232161;111562;120599;108,1;37,6;231,3
2018;3503307;Araras;127386;62077;65309;105,2;37;197,5
2018;3503356;Arco-Íris;2017;1021;996;97,6;38,3;7,6
2018;3503406;Arealva;8051;4046;4005;99;40,1;15,9
2018;3503505;Areias;3628;1824;1804;98,9;35,9;11,9
2018;3503604;Areiópolis;10389;5283;5106;96,6;33,6;120,9
2018;3503703;Ariranha;7971;3989;3982;99,8;38;60,1
2018;3503802;Artur Nogueira;49240;24372;24868;102;34,7;276,6
2018;3503901;Arujá;83077;40575;42502;104,7;34,1;863,9
2018;3503950;Aspásia;1837;922;915;99,2;39,8;26,5
2018;3504008;Assis;100062;48365;51697;106,9;37,6;217,2
2018;3504107;Atibaia;148586;72315;76271;105,5;36,6;310,5
2018;3504206;Auriflama;13987;6931;7056;101,8;38,9;32,2
2018;3504305;Avaí;4667;2327;2340;100,6;36;8,6
2018;3504404;Avanhandava;11384;6276;5108;81,4;34,3;33,6
2018;3504503;Avaré;90126;44667;45459;101,8;36,2;74,3
2018;3504602;Bady Bassitt;22882;11262;11620;103,2;35,3;207,3
2018;3504701;Balbinos;3810;3100;710;22,9;36;41,6
2018;3504800;Bálsamo;9175;4473;4702;105,1;38,9;61,2
2018;3504909;Bananal;10123;4949;5174;104,5;37,3;16,4
2018;3505005;Barão de Antonina;3407;1706;1701;99,7;36,7;22,2
2018;3505104;Barbosa;6017;2978;3039;102;36,3;29,3
2018;3505203;Bariri;31783;15680;16103;102,7;37,7;71,5
2018;3505302;Barra Bonita;34902;16894;18008;106,6;39,2;232,5
2018;3505351;Barra do Chapéu;5214;2719;2495;91,8;34,2;12,9
2018;3505401;Barra do Turvo;7224;3714;3510;94,5;35,7;7,2
2018;3505500;Barretos;119600;57515;62085;107,9;37;76,4
2018;3505609;Barrinha;31115;15443;15672;101,5;32,6;213,1
2018;3505708;Barueri;293047;140797;152250;108,1;33,2;4460,3
2018;3505807;Bastos;21284;10417;10867;104,3;36,9;124,5
2018;3505906;Batatais;57973;28269;29704;105,1;37,5;68,2
2018;3506003;Bauru;369608;178873;190735;106,6;36,8;553,6
2018;3506102;Bebedouro;76429;37074;39355;106,2;37,6;111,9
2018;3506201;Bento de Abreu;2662;1342;1320;98,4;36;8,8
2018;3506300;Bernardino de Campos;11377;5841;5536;94,8;38,2;46,6
2018;3506359;Bertioga;58858;29376;29482;100,4;32,9;119,7
2018;3506409;Bilac;7314;3598;3716;103,3;39,3;46,3
2018;3506508;Birigui;116499;56541;59958;106;37,2;219,8
2018;3506607;Biritiba Mirim;29514;14766;14748;99,9;35,1;93
2018;3506706;Boa Esperança do Sul;13266;6592;6674;101,2;34,8;19,2
2018;3506805;Bocaina;11232;5526;5706;103,3;36,4;30,9
2018;3506904;Bofete;10250;5215;5035;96,5;37,6;15,7
2018;3507001;Boituva;57019;28293;28726;101,5;35,1;229
2018;3507100;Bom Jesus dos Perdões;21299;10607;10692;100,8;34,7;196,5
2018;3507159;Bom Sucesso de Itararé;3564;1822;1742;95,6;31,5;26,7
2018;3507209;Borá;885;446;439;98,4;36,3;7,4
2018;3507308;Boracéia;4576;2323;2253;97;34,9;37,5
2018;3507407;Borborema;14458;7210;7248;100,5;38,8;26,2
2018;3507456;Borebi;2600;1272;1328;104,4;33,9;7,5
2018;3507506;Botucatu;139894;67488;72406;107,3;36,7;94,4
2018;3507605;Bragança Paulista;167473;81555;85918;105,3;36,6;326,7
2018;3507704;Braúna;5284;2626;2658;101,2;37,6;27,1
2018;3507753;Brejo Alegre;2601;1327;1274;96;37,3;24,6
2018;3507803;Brodowski;23940;11779;12161;103,2;36,2;86
2018;3507902;Brotas;23215;11354;11861;104,5;36,8;21,1
2018;3508009;Buri;19807;9994;9813;98,2;33;16,6
2018;3508108;Buritama;16786;8236;8550;103,8;38,4;51,3
2018;3508207;Buritizal;4267;2113;2154;101,9;37,8;16
2018;3508306;Cabrália Paulista;4384;2223;2161;97,2;35,8;18,3
2018;3508405;Cabreúva;45386;22648;22738;100,4;33,1;174,4
2018;3508504;Caçapava;93052;45743;47309;103,4;36;252,2
2018;3508603;Cachoeira Paulista;31281;15183;16098;106;36,6;108,6
2018;3508702;Caconde;17669;8805;8864;100,7;37,7;37,7
2018;3508801;Cafelândia;16763;8144;8619;105,8;37,5;18,2
2018;3508900;Caiabu;3860;1946;1914;98,4;38,9;15,2
2018;3509007;Caieiras;92822;45116;47706;105,7;34,4;950,6
2018;3509106;Caiuá;5339;3074;2265;73,7;37,6;9,7
2018;3509205;Cajamar;83253;41076;42177;102,7;32,3;633,7
2018;3509254;Cajati;28758;14479;14279;98,6;33,7;63,3
2018;3509304;Cajobi;9401;4714;4687;99,4;38,2;53,1
2018;3509403;Cajuru;23842;11879;11963;100,7;35,9;36,1
2018;3509452;Campina do Monte Alegre;5851;2960;2891;97,7;36,1;31,7
2018;3509502;Campinas;1128071;540145;587926;108,8;37,1;1419,7
2018;3509601;Campo Limpo Paulista;77280;37837;39443;104,2;34,9;973,3
2018;3509700;Campos do Jordão;47569;23261;24308;104,5;34,7;164
2018;3509809;Campos Novos Paulista;4782;2427;2355;97;36,1;9,9
2018;3509908;Cananéia;12360;6095;6265;102,8;36;10
2018;3509957;Canas;4757;2379;2378;100;33,2;89,3
2018;3510005;Cândido Mota;29840;14548;15292;105,1;37,7;50,1
2018;3510104;Cândido Rodrigues;2823;1402;1421;101,4;40,6;39,8
2018;3510153;Canitar;5626;2787;2839;101,9;31,9;97,9
2018;3510203;Capão Bonito;46705;23193;23512;101,4;34,9;28,5
2018;3510302;Capela do Alto;21165;11358;9807;86,3;34,2;124,6
2018;3510401;Capivari;49782;24582;25200;102,5;35,4;154,2
2018;3510500;Caraguatatuba;124019;60708;63311;104,3;35,2;255,7
2018;3510609;Carapicuíba;385134;185785;199349;107,3;33,7;11148,5
2018;3510708;Cardoso;11684;5732;5952;103,8;40;18,3
2018;3510807;Casa Branca;28370;14810;13560;91,6;37,3;32,8
2018;3510906;Cássia dos Coqueiros;2780;1430;1350;94,4;39;14,5
2018;3511003;Castilho;19515;9655;9860;102,1;36,7;18,3
2018;3511102;Catanduva;115643;55643;60000;107,8;38,4;398
2018;3511201;Catiguá;7108;3574;3534;98,9;37;47,9
2018;3511300;Cedral;11028;5461;5567;101,9;37,7;55,7
2018;3511409;Cerqueira César;20291;10372;9919;95,6;35,6;39,7
2018;3511508;Cerquilho;43257;21198;22059;104,1;36,5;338,5
2018;3511607;Cesário Lange;17993;9262;8731;94,3;35,3;94,5
2018;3511706;Charqueada;15499;7783;7716;99,1;35,5;88,1
2018;3511904;Clementina;7089;3567;3522;98,7;34,9;42
2018;3512001;Colina;18240;8899;9341;105;36,7;43,2
2018;3512100;Colômbia;6510;3287;3223;98,1;35,4;8,9
2018;3512209;Conchal;27276;13671;13605;99,5;34;149,2
2018;3512308;Conchas;15674;7862;7812;99,4;37,7;33,6
2018;3512407;Cordeirópolis;23448;11646;11802;101,3;35,1;170,4
2018;3512506;Coroados;5432;2701;2731;101,1;37,3;22
2018;3512605;Coronel Macedo;4578;2321;2257;97,2;37,6;15,1
2018;3512704;Corumbataí;4115;2067;2048;99,1;35,7;14,8
2018;3512803;Cosmópolis;59923;29609;30314;102,4;35;387,4
2018;3512902;Cosmorama;8204;4105;4099;99,9;39;18,6
2018;3513009;Cotia;250908;122066;128842;105,6;33,6;774,4
2018;3513108;Cravinhos;33002;16339;16663;102;36,2;106
2018;3513207;Cristais Paulista;8732;4368;4364;99,9;35,7;22,7
2018;3513306;Cruzália;2184;1073;1111;103,5;39,8;14,6
2018;3513405;Cruzeiro;76435;36860;39575;107,4;36,9;250
2018;3513504;Cubatão;115947;56430;59517;105,5;33,8;811,5
2018;3513603;Cunha;22139;11275;10864;96,4;37,7;15,7
2018;3513702;Descalvado;31756;15611;16145;103,4;37,9;42,1
2018;3513801;Diadema;395531;189812;205719;108,4;34,3;12870,3
2018;3513850;Dirce Reis;1647;847;800;94,5;40,3;18,7
2018;3513900;Divinolândia;11251;5584;5667;101,5;39,5;50,3
2018;3514007;Dobrada;8559;4308;4251;98,7;33,3;57,2
2018;3514106;Dois Córregos;24811;12303;12508;101,7;36,4;39,2
2018;3514205;Dolcinópolis;2167;1102;1065;96,6;40;27,8
2018;3514304;Dourado;8353;4163;4190;100,6;39;40,6
2018;3514403;Dracena;45087;22176;22911;103,3;39,3;92,5
2018;3514502;Duartina;12355;6028;6327;105;39,5;46,7
2018;3514601;Dumont;8988;4483;4505;100,5;34,8;80,7
2018;3514700;Echaporã;6287;3091;3196;103,4;37,3;12,2
2018;3514809;Eldorado;13737;6941;6796;97,9;34,3;8,3
2018;3514908;Elias Fausto;17139;8691;8448;97,2;34,7;84,7
2018;3514924;Elisiário;3168;1619;1549;95,7;37,8;33,7
2018;3514957;Embaúba;2377;1221;1156;94,7;38,5;28,6
2018;3515004;Embu das Artes;249976;120847;129129;106,9;32,8;3550,9
2018;3515103;Embu-Guaçu;66307;32768;33539;102,4;34,2;426
2018;3515129;Emilianópolis;3056;1529;1527;99,9;39,7;13,6
2018;3515152;Engenheiro Coelho;18256;9291;8965;96,5;32,1;166,1
2018;3515186;Espírito Santo do Pinhal;40716;19807;20909;105,6;38,5;104,6
2018;3515194;Espírito Santo do Turvo;4192;2105;2087;99,1;33,4;21,6
2018;3515202;Estrela d'Oeste;9050;4579;4471;97,6;38,3;30,5
2018;3515301;Estrela do Norte;2714;1353;1361;100,6;36,3;10,2
2018;3515350;Euclides da Cunha Paulista;8563;4255;4308;101,2;36,1;14,9
2018;3515400;Fartura;16269;7916;8353;105,5;37,6;37,9
2018;3515509;Fernandópolis;69460;33537;35923;107,1;38,7;126,3
2018;3515608;Fernando Prestes;5827;2870;2957;103;39,9;34,3
2018;3515657;Fernão;1629;834;795;95,3;37,3;16,2
2018;3515707;Ferraz de Vasconcelos;176672;85747;90925;106;32,9;5979,3
2018;3515806;Flora Rica;1599;799;800;100,1;42,2;7,1
2018;3515905;Floreal;2852;1403;1449;103,3;43,1;14
2018;3516002;Flórida Paulista;12990;7124;5866;82,3;37,4;24,8
2018;3516101;Florínea;3557;2100;1457;69,4;37,8;15,7
2018;3516200;Franca;343605;166961;176644;105,8;35,9;567,3
2018;3516309;Francisco Morato;162631;79979;82652;103,3;31,8;3318,9
2018;3516408;Franco da Rocha;141151;71407;69744;97,7;33,2;1063,1
2018;3516507;Gabriel Monteiro;2789;1394;1395;100,1;39,8;20,1
2018;3516606;Gália;6662;3285;3377;102,8;39,5;18,7
2018;3516705;Garça;42754;20670;22084;106,8;37,9;76,9
2018;3516804;Gastão Vidigal;3632;1812;1820;100,4;37,8;20,1
2018;3516853;Gavião Peixoto;4629;2330;2299;98,7;34,5;19
2018;3516903;General Salgado;10540;5241;5299;101,1;39,4;21,3
2018;3517000;Getulina;10502;5734;4768;83,2;37,6;15,5
2018;3517109;Glicério;4334;2135;2199;103;38;15,9
2018;3517208;Guaiçara;11131;5535;5596;101,1;35,2;40,2
2018;3517307;Guaimbê;5530;2745;2785;101,5;36,7;25,4
2018;3517406;Guaíra;38893;19047;19846;104,2;36,7;30,9
2018;3517505;Guapiaçu;20473;10207;10266;100,6;36,1;63
2018;3517604;Guapiara;17616;8937;8679;97,1;35,8;43,1
2018;3517703;Guará;19196;9437;9759;103,4;35,2;53
2018;3517802;Guaraçaí;7871;3897;3974;102;40,7;13,8
2018;3517901;Guaraci;10301;5183;5118;98,7;36,7;16,1
2018;3518008;Guarani d'Oeste;1974;977;997;102;39,5;23
2018;3518107;Guarantã;6468;3207;3261;101,7;35,4;14
2018;3518206;Guararapes;31167;15233;15934;104,6;38,2;32,6
2018;3518305;Guararema;29574;14695;14879;101,3;35,9;109,2
2018;3518404;Guaratinguetá;116454;55878;60576;108,4;37,4;154,7
2018;3518503;Guareí;14972;9044;5928;65,5;35,6;26,4
2018;3518602;Guariba;37172;18192;18980;104,3;34,3;137,5
2018;3518701;Guarujá;291629;140844;150785;107,1;34,5;2014,1
2018;3518800;Guarulhos;1278712;617630;661082;107;34;4012,6
2018;3518859;Guatapará;7255;3677;3578;97,3;35,5;17,5
2018;3518909;Guzolândia;4472;2286;2186;95,6;36,9;17,7
2018;3519006;Herculândia;9023;4456;4567;102,5;36,4;24,8
2018;3519055;Holambra;13818;6919;6899;99,7;35,1;210,7
2018;3519071;Hortolândia;222839;111297;111542;100,2;33,5;3570,2
2018;3519105;Iacanga;10312;5176;5136;99,2;37;18,8
2018;3519204;Iacri;6281;3147;3134;99,6;38,4;19,5
2018;3519253;Iaras;7467;4987;2480;49,7;36,3;18,6
2018;3519303;Ibaté;31880;16059;15821;98,5;33,8;109,6
2018;3519402;Ibirá;11454;5634;5820;103,3;38,4;42,1
2018;3519501;Ibirarema;6570;3285;3285;100;37,2;28,8
2018;3519600;Ibitinga;58013;28510;29503;103,5;36,4;84,2
2018;3519709;Ibiúna;74712;37679;37033;98,3;35,2;70,6
2018;3519808;Icém;7786;4188;3598;85,9;36,3;21,5
2018;3519907;Iepê;7700;3758;3942;104,9;38,2;12,9
2018;3520004;Igaraçu do Tietê;23374;11646;11728;100,7;35,9;239,1
2018;3520103;Igarapava;27009;13144;13865;105,5;37,2;57,7
2018;3520202;Igaratá;10053;5076;4977;98;36,1;34,3
2018;3520301;Iguape;29290;14706;14584;99,2;37,5;14,8
2018;3520400;Ilhabela;32688;16325;16363;100,2;33,9;94,4
2018;3520426;Ilha Comprida;12035;5949;6086;102,3;39,9;61,2
2018;3520442;Ilha Solteira;25680;12481;13199;105,8;39;39,3
2018;3520509;Indaiatuba;238030;116958;121072;103,5;35,9;764
2018;3520608;Indiana;5026;2533;2493;98,4;37,9;38,9
2018;3520707;Indiaporã;4039;1976;2063;104,4;40,8;14,4
2018;3520806;Inúbia Paulista;3649;1806;1843;102;38,2;41,9
2018;3520905;Ipaussu;13784;6820;6964;102,1;35,9;65,8
2018;3521002;Iperó;33847;18161;15686;86,4;33,5;198,8
2018;3521101;Ipeúna;6634;3356;3278;97,7;34,8;34,9
2018;3521150;Ipiguá;5977;3017;2960;98,1;37;43,9
2018;3521200;Iporanga;4169;2108;2061;97,8;34,4;3,6
2018;3521309;Ipuã;14454;7246;7208;99,5;34,7;31
2018;3521408;Iracemápolis;21446;10686;10760;100,7;35,6;186,3
2018;3521507;Irapuã;7061;3604;3457;95,9;36,9;27,4
2018;3521606;Irapuru;7388;4257;3131;73,5;39,1;34,4
2018;3521705;Itaberá;18029;9050;8979;99,2;35,9;16,4
2018;3521804;Itaí;24952;13032;11920;91,5;35,1;22,8
2018;3521903;Itajobi;16150;8101;8049;99,4;38,5;32,2
2018;3522000;Itaju;3496;1773;1723;97,2;36,4;15,2
2018;3522109;Itanhaém;104879;50606;54273;107,2;37,2;174,3
2018;3522158;Itaoca;3369;1713;1656;96,7;36,8;18,4
2018;3522208;Itapecerica da Serra;158045;77842;80203;103;33;1048,4
2018;3522307;Itapetininga;154080;76957;77123;100,2;35,1;86,1
2018;3522406;Itapeva;89795;44144;45651;103,4;34,5;49,2
2018;3522505;Itapevi;223375;109230;114145;104,5;31,8;2702,4
2018;3522604;Itapira;71271;35052;36219;103,3;38,1;137,5
2018;3522653;Itapirapuã Paulista;4149;2142;2007;93,7;32,7;10,2
2018;3522703;Itápolis;39929;19637;20292;103,3;38,1;40,1
2018;3522802;Itaporanga;14392;7112;7280;102,4;37;28,3
2018;3522901;Itapuí;13186;6597;6589;99,9;35;94,2
2018;3523008;Itapura;4191;2131;2060;96,7;37,2;13,9
2018;3523107;Itaquaquecetuba;355261;174111;181150;104;31,8;4299,9
2018;3523206;Itararé;46072;22503;23569;104,7;35,5;45,9
2018;3523305;Itariri;15591;7784;7807;100,3;34,3;57
2018;3523404;Itatiba;115416;56684;58732;103,6;36,3;358,1
2018;3523503;Itatinga;18899;9892;9007;91,1;33,6;19,3
2018;3523602;Itirapina;15984;9408;6576;69,9;35,1;28,3
2018;3523701;Itirapuã;5842;2969;2873;96,8;35,4;36,3
2018;3523800;Itobi;7890;4032;3858;95,7;36,5;56,8
2018;3523909;Itu;164668;80783;83885;103,8;35,5;257
2018;3524006;Itupeva;62090;31265;30825;98,6;33,1;309,1
2018;3524105;Ituverava;38144;18487;19657;106,3;37,8;54,1
2018;3524204;Jaborandi;6406;3193;3213;100,6;37;23,4
2018;3524303;Jaboticabal;72305;34691;37614;108,4;37,9;102,3
2018;3524402;Jacareí;232536;112631;119905;106,5;36;500,9
2018;3524501;Jaci;6975;3533;3442;97,4;34,7;48,1
2018;3524600;Jacupiranga;16601;8310;8291;99,8;35,4;23,6
2018;3524709;Jaguariúna;54471;26645;27826;104,4;35,3;385,3
2018;3524808;Jales;48552;23571;24981;106;39,4;131,7
2018;3524907;Jambeiro;6075;3075;3000;97,6;36,2;32,9
2018;3525003;Jandira;115727;56305;59422;105,5;33,1;6632,3
2018;3525102;Jardinópolis;42843;21974;20869;95;35;85,4
2018;3525201;Jarinu;33019;16593;16426;99;34,5;159,1
2018;3525300;Jaú;133468;64794;68674;106;37,4;194,2
2018;3525409;Jeriquara;3631;1869;1762;94,3;33,5;25,6
2018;3525508;Joanópolis;12532;6337;6195;97,8;37,6;33,5
2018;3525607;João Ramalho;4351;2184;2167;99,2;34,8;10,5
2018;3525706;José Bonifácio;35534;17582;17952;102,1;36,4;41,3
2018;3525805;Júlio Mesquita;4339;2121;2218;104,6;36,2;33,9
2018;3525854;Jumirim;2989;1495;1494;99,9;34,8;52,7
2018;3525904;Jundiaí;420132;203219;216913;106,7;37,4;974,3
2018;3526001;Junqueirópolis;20035;10516;9519;90,5;38,4;34,4
2018;3526100;Juquiá;18045;9081;8964;98,7;36,4;22,2
2018;3526209;Juquitiba;28113;14181;13932;98,2;34,6;53,8
2018;3526308;Lagoinha;5004;2538;2466;97,2;40,1;19,6
2018;3526407;Laranjal Paulista;25995;12730;13265;104,2;37;67,6
2018;3526506;Lavínia;9392;6853;2539;37;36,3;17,5
2018;3526605;Lavrinhas;7023;3506;3517;100,3;33,5;42
2018;3526704;Leme;96752;47825;48927;102,3;35,4;240,2
2018;3526803;Lençóis Paulista;65120;32167;32953;102,4;35,6;80,4
2018;3526902;Limeira;288300;140863;147437;104,7;36,8;496,5
2018;3527009;Lindóia;6945;3436;3509;102,1;37,7;142,4
2018;3527108;Lins;74256;35773;38483;107,6;37,7;130,3
2018;3527207;Lorena;84607;40617;43990;108,3;36,5;204,3
2018;3527256;Lourdes;2039;1026;1013;98,7;39,7;17,9
2018;3527306;Louveira;46852;23433;23419;99,9;32,9;840,6
2018;3527405;Lucélia;20131;11011;9120;82,8;38,7;63,9
2018;3527504;Lucianópolis;2336;1179;1157;98,1;37,5;12,3
2018;3527603;Luís Antônio;11984;6040;5944;98,4;33,2;20
2018;3527702;Luiziânia;4847;2449;2398;97,9;36,2;29,1
2018;3527801;Lupércio;4147;2026;2121;104,7;36,6;26,7
2018;3527900;Lutécia;2711;1346;1365;101,4;37,4;5,7
2018;3528007;Macatuba;16769;8331;8438;101,3;35,7;74,7
2018;3528106;Macaubal;7579;3793;3786;99,8;40,5;30,5
2018;3528205;Macedônia;3893;1938;1955;100,9;40,1;11,9
2018;3528304;Magda;3223;1606;1617;100,7;40,6;10,3
2018;3528403;Mairinque;48065;24119;23946;99,3;35,2;228,7
2018;3528502;Mairiporã;89958;44986;44972;100;35,3;280,5
2018;3528601;Manduri;9637;4790;4847;101,2;37,4;42,1
2018;3528700;Marabá Paulista;4664;2928;1736;59,3;36;5,1
2018;3528809;Maracaí;13012;6456;6556;101,5;36,9;24,4
2018;3528858;Marapoama;3095;1587;1508;95;37,5;27,8
2018;3528908;Mariápolis;3670;1852;1818;98,2;38,5;19,7
2018;3529005;Marília;231934;111466;120468;108,1;37,2;198,1
2018;3529104;Marinópolis;1965;998;967;96,9;39,3;25,2
2018;3529203;Martinópolis;24754;12773;11981;93,8;37,3;19,7
2018;3529302;Matão;78958;38886;40072;103;37,2;150,4
2018;3529401;Mauá;421634;204300;217334;106,4;34,5;6807,4
2018;3529500;Mendonça;5671;2857;2814;98,5;37,8;29,1
2018;3529609;Meridiano;4383;2145;2238;104,3;38,5;19,2
2018;3529658;Mesópolis;1929;972;957;98,5;37,4;13
2018;3529708;Miguelópolis;19991;9855;10136;102,9;35,4;24,4
2018;3529807;Mineiros do Tietê;11573;5751;5822;101,2;36,7;54,3
2018;3529906;Miracatu;19393;9715;9678;99,6;35,1;19,4
2018;3530003;Mira Estrela;3038;1516;1522;100,4;40,3;14
2018;3530102;Mirandópolis;28118;15788;12330;78,1;39,3;30,6
2018;3530201;Mirante do Paranapanema;16441;8246;8195;99,4;38,3;13,3
2018;3530300;Mirassol;60357;29373;30984;105,5;37,3;248,1
2018;3530409;Mirassolândia;4549;2300;2249;97,8;37,3;27,4
2018;3530508;Mococa;67807;33435;34372;102,8;37,9;79,3
2018;3530607;Mogi das Cruzes;432833;209153;223680;106,9;34,9;607,5
2018;3530706;Mogi Guaçu;149271;73200;76071;103,9;36,5;183,7
2018;3530805;Mogi Mirim;91399;44637;46762;104,8;37,6;183,6
2018;3530904;Mombuca;3575;1775;1800;101,4;34,2;26,7
2018;3531001;Monções;2036;1026;1010;98,4;41,3;19,5
2018;3531100;Mongaguá;57005;28829;28176;97,7;37,6;399,3
2018;3531209;Monte Alegre do Sul;8188;4055;4133;101,9;39,6;74,2
2018;3531308;Monte Alto;47529;23313;24216;103,9;38,7;137
2018;3531407;Monte Aprazível;22214;10918;11296;103,5;38,6;44,8
2018;3531506;Monte Azul Paulista;18532;9285;9247;99,6;38,2;70,3
2018;3531605;Monte Castelo;4184;2079;2105;101,3;39,2;17,9
2018;3531704;Monteiro Lobato;4141;2097;2044;97,5;37,6;12,4
2018;3531803;Monte Mor;59648;29550;30098;101,9;33,6;247,9
2018;3531902;Morro Agudo;28656;14235;14421;101,3;34,4;20,6
2018;3532009;Morungaba;13139;6476;6663;102,9;35,5;89,5
2018;3532058;Motuca;4164;2107;2057;97,6;36,3;18,2
2018;3532108;Murutinga do Sul;3925;1956;1969;100,7;41,4;15,6
2018;3532157;Nantes;2689;1332;1357;101,9;34,4;9,4
2018;3532207;Narandiba;5246;2622;2624;100,1;33,7;14,7
2018;3532306;Natividade da Serra;6923;3610;3313;91,8;39,2;8,3
2018;3532405;Nazaré Paulista;17695;9022;8673;96,1;36,9;54,2
2018;3532504;Neves Paulista;9431;4674;4757;101,8;40,5;43,1
2018;3532603;Nhandeara;10246;4965;5281;106,4;41,3;23,5
2018;3532702;Nipoã;4635;2400;2235;93,1;35,2;33,7
2018;3532801;Nova Aliança;6436;3176;3260;102,6;37,5;29,6
2018;3532827;Nova Campina;8557;4305;4252;98,8;31,9;22,2
2018;3532843;Nova Canaã Paulista;2071;1041;1030;98,9;43,1;16,6
2018;3532868;Nova Castilho;1107;549;558;101,6;37,1;6
2018;3532900;Nova Europa;9372;4691;4681;99,8;35,5;58,5
2018;3533007;Nova Granada;19439;9682;9757;100,8;37;36,6
2018;3533106;Nova Guataporanga;2169;1074;1095;102;39,7;63,5
2018;3533205;Nova Independência;4121;2185;1936;88,6;34,1;15,5
2018;3533254;Novais;4512;2323;2189;94,2;33,2;38,3
2018;3533304;Nova Luzitânia;3091;1577;1514;96;37,5;41,9
2018;3533403;Nova Odessa;58727;28829;29898;103,7;36,3;795,9
2018;3533502;Novo Horizonte;38069;18832;19237;102,2;37,6;40,9
2018;3533601;Nuporanga;7246;3598;3648;101,4;36,8;20,8
2018;3533700;Ocauçu;4276;2186;2090;95,6;37;14,2
2018;3533809;Óleo;2583;1304;1279;98,1;39,2;13
2018;3533908;Olímpia;53731;26240;27491;104,8;37,2;66,9
2018;3534005;Onda Verde;4464;2264;2200;97,2;35,4;18,4
2018;3534104;Oriente;6166;2979;3187;107;38,8;28,2
2018;3534203;Orindiúva;5941;2981;2960;99,3;34,2;24
2018;3534302;Orlândia;39121;18992;20129;106;37;134,1
2018;3534401;Osasco;714883;341397;373486;109,4;35,1;11006
2018;3534500;Oscar Bressane;2518;1217;1301;106,9;41,3;11,3
2018;3534609;Osvaldo Cruz;31317;15638;15679;100,3;39,6;126,3
2018;3534708;Ourinhos;104603;50108;54495;108,8;37,1;353,6
2018;3534757;Ouroeste;9773;4835;4938;102,1;37,1;33,9
2018;3534807;Ouro Verde;7849;3814;4035;105,8;36,1;29,4
2018;3534906;Pacaembu;14377;9140;5237;57,3;38,4;42,4
2018;3535002;Palestina;11365;5691;5674;99,7;38,3;16,3
2018;3535101;Palmares Paulista;10140;5184;4956;95,6;33,5;123,5
2018;3535200;Palmeira d'Oeste;9213;4605;4608;100,1;41,4;28,9
2018;3535309;Palmital;20344;9917;10427;105,1;39,2;37,1
2018;3535408;Panorama;15060;7475;7585;101,5;35,3;42,3
2018;3535507;Paraguaçu Paulista;41882;20956;20926;99,9;36,7;41,8
2018;3535606;Paraibuna;17731;8983;8748;97,4;36,9;21,9
2018;3535705;Paraíso;6084;3078;3006;97,7;38,1;39,2
2018;3535804;Paranapanema;18932;9625;9307;96,7;34,3;18,6
2018;3535903;Paranapuã;3975;1997;1978;99;37,5;28,3
2018;3536000;Parapuã;10755;5379;5376;99,9;39,6;29,3
2018;3536109;Pardinho;6703;3403;3300;97;35;31,9
2018;3536208;Pariquera-Açu;19122;9472;9650;101,9;35,7;53,2
2018;3536257;Parisi;2622;1292;1330;102,9;38,9;30,9
2018;3536307;Patrocínio Paulista;14106;7124;6982;98;35,1;23,4
2018;3536406;Paulicéia;7483;3804;3679;96,7;35,1;20
2018;3536505;Paulínia;101142;49436;51706;104,6;34,7;728,8
2018;3536570;Paulistânia;1984;998;986;98,8;36,6;7,7
2018;3536604;Paulo de Faria;7885;3960;3925;99,1;37,9;10,7
2018;3536703;Pederneiras;43994;21941;22053;100,5;35,7;60,5
2018;3536802;Pedra Bela;6270;3267;3003;91,9;38,3;39,5
2018;3536901;Pedranópolis;2743;1387;1356;97,8;41;10,5
2018;3537008;Pedregulho;15700;7908;7792;98,5;35,8;22
2018;3537107;Pedreira;42772;21039;21733;103,3;37;393,1
2018;3537156;Pedrinhas Paulista;2860;1408;1452;103,1;38,9;18,8
2018;3537206;Pedro de Toledo;10995;5612;5383;95,9;36,4;16,4
2018;3537305;Penápolis;61077;29538;31539;106,8;38;85,9
2018;3537404;Pereira Barreto;24682;12012;12670;105,5;38,3;25,3
2018;3537503;Pereiras;8337;4178;4159;99,5;36,5;37,4
2018;3537602;Peruíbe;65998;31954;34044;106,5;37,4;202,3
2018;3537701;Piacatu;5522;2760;2762;100,1;38,1;23,8
2018;3537800;Piedade;53016;26761;26255;98,1;36,6;71
2018;3537909;Pilar do Sul;27358;13865;13493;97,3;35,6;40,2
2018;3538006;Pindamonhangaba;159942;77907;82035;105,3;35,3;218,7
2018;3538105;Pindorama;14819;7445;7374;99;38,9;80,2
2018;3538204;Pinhalzinho;14559;7270;7289;100,3;38,6;94,2
2018;3538303;Piquerobi;3368;1627;1741;107;38,8;7
2018;3538501;Piquete;13191;6339;6852;108,1;38,7;75
2018;3538600;Piracaia;25891;12724;13167;103,5;37,9;67,2
2018;3538709;Piracicaba;405952;197175;208777;105,9;36,6;294,6
2018;3538808;Piraju;29328;14200;15128;106,5;37,9;58,1
2018;3538907;Pirajuí;22762;12124;10638;87,7;37,6;27,6
2018;3539004;Pirangi;10852;5445;5407;99,3;38,7;50,3
2018;3539103;Pirapora do Bom Jesus;17478;8688;8790;101,2;31,8;161,1
2018;3539202;Pirapozinho;25280;12320;12960;105,2;37;52,9
2018;3539301;Pirassununga;72832;35296;37536;106,3;37,8;100,2
2018;3539400;Piratininga;14164;6932;7232;104,3;37,4;35,2
2018;3539509;Pitangueiras;34538;17326;17212;99,3;34,2;80,2
2018;3539608;Planalto;4472;2246;2226;99,1;36,1;15,4
2018;3539707;Platina;3125;1594;1531;96;36,4;9,5
2018;3539806;Poá;105665;50863;54802;107,7;34,7;6120,7
2018;3539905;Poloni;5554;2725;2829;103,8;38,9;41,1
2018;3540002;Pompéia;20267;9929;10338;104,1;37,7;25,8
2018;3540101;Pongaí;3458;1755;1703;97;40,3;18,9
2018;3540200;Pontal;38721;19774;18947;95,8;32,8;108,7
2018;3540259;Pontalinda;4124;2197;1927;87,7;35,7;19,7
2018;3540309;Pontes Gestal;2452;1217;1235;101,5;38,7;11,3
2018;3540408;Populina;4207;2091;2116;101,2;39,7;13,3
2018;3540507;Porangaba;9808;5014;4794;95,6;39,5;36,9
2018;3540606;Porto Feliz;54180;27439;26741;97,5;36,1;97,3
2018;3540705;Porto Ferreira;52475;25712;26763;104,1;37;214,3
2018;3540754;Potim;20120;11341;8779;77,4;32,9;450,7
2018;3540804;Potirendaba;17558;8750;8808;100,7;37,6;51,3
2018;3540853;Pracinha;2676;1933;743;38,4;34;42,4
2018;3540903;Pradópolis;17319;8651;8668;100,2;35,2;103,5
2018;3541000;Praia Grande;322485;153725;168760;109,8;36;2154,9
2018;3541059;Pratânia;4990;2512;2478;98,6;33,2;28,5
2018;3541109;Presidente Alves;3947;1958;1989;101,6;38,2;13,8
2018;3541208;Presidente Bernardes;14293;7668;6625;86,4;40;19,1
2018;3541307;Presidente Epitácio;40515;19658;20857;106,1;37;32,1
2018;3541406;Presidente Prudente;221205;106037;115168;108,6;37,7;394,6
2018;3541505;Presidente Venceslau;36444;17813;18631;104,6;39,5;48,3
2018;3541604;Promissão;35674;17594;18080;102,8;36,6;45,8
2018;3541653;Quadra;3362;1736;1626;93,7;37,2;16,3
2018;3541703;Quatá;13107;6528;6579;100,8;35,9;20,1
2018;3541802;Queiroz;3098;1559;1539;98,7;33,8;13,2
2018;3541901;Queluz;9913;4968;4945;99,5;35,1;39,7
2018;3542008;Quintana;6690;3278;3412;104,1;36,4;21
2018;3542107;Rafard;8852;4377;4475;102,2;36,1;72,8
2018;3542206;Rancharia;28835;14011;14824;105,8;37,4;18,2
2018;3542305;Redenção da Serra;4322;2260;2062;91,2;38,7;14
2018;3542404;Regente Feijó;19733;9747;9986;102,5;37,5;75
2018;3542503;Reginópolis;7560;4720;2840;60,2;35,2;18,4
2018;3542602;Registro;58501;28952;29549;102,1;35,6;81
2018;3542701;Restinga;6505;3237;3268;101;34;26,5
2018;3542800;Ribeira;3227;1657;1570;94,7;36,8;9,6
2018;3542909;Ribeirão Bonito;11479;5712;5767;101;36,3;24,3
2018;3543006;Ribeirão Branco;18562;9485;9077;95,7;32,6;26,6
2018;3543105;Ribeirão Corrente;4500;2276;2224;97,7;34;30,3
2018;3543204;Ribeirão do Sul;4621;2321;2300;99,1;38,9;22,7
2018;3543238;Ribeirão dos Índios;2103;1029;1074;104,4;40,4;10,7
2018;3543253;Ribeirão Grande;7519;3859;3660;94,8;36,1;22,6
2018;3543303;Ribeirão Pires;115682;56112;59570;106,2;36,8;1168,8
2018;3543402;Ribeirão Preto;670434;319896;350538;109,6;36,6;1030
2018;3543501;Riversul;5823;2927;2896;98,9;36,9;15,1
2018;3543600;Rifaina;3837;1919;1918;99,9;37,5;23,6
2018;3543709;Rincão;9636;4809;4827;100,4;36,3;30,4
2018;3543808;Rinópolis;9551;4766;4785;100,4;39,5;26,6
2018;3543907;Rio Claro;197246;95412;101834;106,7;37,1;395,7
2018;3544004;Rio das Pedras;30910;15476;15434;99,7;34,4;136,4
2018;3544103;Rio Grande da Serra;44511;21868;22643;103,5;33,7;1224,8
2018;3544202;Riolândia;10416;6237;4179;67;35;16,5
2018;3544251;Rosana;18439;9127;9312;102;36,8;24,8
2018;3544301;Roseira;10492;5269;5223;99,1;34,9;80,8
2018;3544400;Rubiácea;2735;1375;1360;98,9;35,6;11,6
2018;3544509;Rubinéia;3524;1743;1781;102,2;41,7;14,5
2018;3544608;Sabino;5220;2558;2662;104,1;39,7;17,1
2018;3544707;Sagres;2463;1195;1268;106,1;37,6;16,6
2018;3544806;Sales;6195;3084;3111;100,9;38,8;20,1
2018;3544905;Sales Oliveira;11198;5446;5752;105,6;37,3;36,6
2018;3545001;Salesópolis;15403;7685;7718;100,4;36,1;36,2
2018;3545100;Salmourão;4841;2452;2389;97,4;37,1;28
2018;3545159;Saltinho;7821;3849;3972;103,2;38,1;78,4
2018;3545209;Salto;125013;61426;63587;103,5;35,5;939,5
2018;3545308;Salto de Pirapora;42848;21280;21568;101,4;35,7;152,8
2018;3545407;Salto Grande;9044;4424;4620;104,4;37,5;48
2018;3545506;Sandovalina;3692;1860;1832;98,5;35;8,1
2018;3545605;Santa Adélia;14223;7040;7183;102;37,5;43,1
2018;3545704;Santa Albertina;6193;3102;3091;99,6;39,7;22,7
2018;3545803;Santa Bárbara d'Oeste;183600;90441;93159;103;36,9;677,4
2018;3546009;Santa Branca;13991;6975;7016;100,6;37,6;51,4
2018;3546108;Santa Clara d'Oeste;2433;1228;1205;98,1;38,2;13,3
2018;3546207;Santa Cruz da Conceição;4227;2074;2153;103,8;40,2;28,2
2018;3546256;Santa Cruz da Esperança;2105;1051;1054;100,3;37,1;14,2
2018;3546306;Santa Cruz das Palmeiras;29486;14728;14758;100,2;35,7;99,8
2018;3546405;Santa Cruz do Rio Pardo;45814;22339;23475;105,1;37,1;41,1
2018;3546504;Santa Ernestina;5943;3013;2930;97,2;34,5;44,2
2018;3546603;Santa Fé do Sul;33034;15904;17130;107,7;38,7;159,9
2018;3546702;Santa Gertrudes;23105;11672;11433;98;33,1;235,1
2018;3546801;Santa Isabel;52693;26162;26531;101,4;35,5;145
2018;3546900;Santa Lúcia;7638;3794;3844;101,3;35,4;49,6
2018;3547007;Santa Maria da Serra;5301;2677;2624;98;34,9;21
2018;3547106;Santa Mercedes;2952;1466;1486;101,4;37,2;17,7
2018;3547205;Santana da Ponte Pensa;1671;837;834;99,6;43,2;12,9
2018;3547304;Santana de Parnaíba;138802;67732;71070;104,9;33,7;771,3
2018;3547403;Santa Rita d'Oeste;2684;1319;1365;103,5;42,3;12,8
2018;3547502;Santa Rita do Passa Quatro;25534;12267;13267;108,2;40,9;33,9
2018;3547601;Santa Rosa de Viterbo;23781;11567;12214;105,6;37,8;82,4
2018;3547650;Santa Salete;1589;792;797;100,6;40,8;20,1
2018;3547700;Santo Anastácio;18926;9136;9790;107,2;39,3;34,2
2018;3547809;Santo André;729934;347623;382311;110;37,9;4152,5
2018;3547908;Santo Antônio da Alegria;6600;3389;3211;94,7;37,6;21,3
2018;3548005;Santo Antônio de Posse;22436;11245;11191;99,5;35;145,6
2018;3548054;Santo Antônio do Aracanguá;8229;4136;4093;99;37,1;6,3
2018;3548104;Santo Antônio do Jardim;6087;3080;3007;97,6;38,2;55,4
2018;3548203;Santo Antônio do Pinhal;6969;3504;3465;98,9;36,8;52,4
2018;3548302;Santo Expedito;2938;1452;1486;102,3;39,2;31,1
2018;3548401;Santópolis do Aguapeí;4084;2027;2057;101,5;35,4;31,9
2018;3548500;Santos;422933;192348;230585;119,9;41,1;1504,9
2018;3548609;São Bento do Sapucaí;11371;5669;5702;100,6;38,5;45
2018;3548708;São Bernardo do Campo;803794;384391;419403;109,1;36,3;1962,7
2018;3548807;São Caetano do Sul;161515;74035;87480;118,2;41;10535,4
2018;3548906;São Carlos;244909;119535;125374;104,9;37;215,4
2018;3549003;São Francisco;2708;1341;1367;101,9;41,1;35,8
2018;3549102;São João da Boa Vista;90120;43442;46678;107,4;38,4;174,5
2018;3549201;São João das Duas Pontes;2597;1286;1311;101,9;38,8;20,1
2018;3549250;São João de Iracema;1829;914;915;100,1;37,6;10,3
2018;3549300;São João do Pau d'Alho;2213;1093;1120;102,5;41,8;18,8
2018;3549409;São Joaquim da Barra;48230;23456;24774;105,6;36,7;117,4
2018;3549508;São José da Bela Vista;7948;4023;3925;97,6;34,2;28,7
2018;3549607;São José do Barreiro;3961;1990;1971;99;36,8;6,9
2018;3549706;São José do Rio Pardo;52466;25463;27003;106;38,3;125
2018;3549805;São José do Rio Preto;458994;219556;239438;109,1;37,6;1062,6
2018;3549904;São José dos Campos;679425;329142;350283;106,4;35,6;618
2018;3549953;São Lourenço da Serra;15459;7791;7668;98,4;35,3;82,9
2018;3550001;São Luiz do Paraitinga;10448;5294;5154;97,4;39,4;16,9
2018;3550100;São Manuel;37892;18559;19333;104,2;36,6;58,2
2018;3550209;São Miguel Arcanjo;32092;16232;15860;97,7;35,2;34,5
2018;3550308;São Paulo;11493509;5421282;6072227;112;36,6;7555,5
2018;3550407;São Pedro;36233;17611;18622;105,7;38,4;59,3
2018;3550506;São Pedro do Turvo;7233;3670;3563;97,1;36,1;9,9
2018;3550605;São Roque;79693;39008;40685;104,3;36,9;259,7
2018;3550704;São Sebastião;79349;39088;40261;103;33,7;197,2
2018;3550803;São Sebastião da Grama;11105;5584;5521;98,9;37,7;44
2018;3550902;São Simão;13861;6820;7041;103,2;38,1;22,5
2018;3551009;São Vicente;334671;161049;173622;107,8;35,8;2259
2018;3551108;Sarapuí;9967;5052;4915;97,3;35,8;28,3
2018;3551207;Sarutaiá;3701;1850;1851;100,1;36,5;26,1
2018;3551306;Sebastianópolis do Sul;3126;1524;1602;105,1;38,9;18,6
2018;3551405;Serra Azul;12294;7742;4552;58,8;35,1;43,4
2018;3551504;Serrana;42497;21022;21475;102,2;33,2;337,2
2018;3551603;Serra Negra;28925;14000;14925;106,6;39,5;142
2018;3551702;Sertãozinho;122043;59699;62344;104,4;35,1;302,8
2018;3551801;Sete Barras;12889;6578;6311;95,9;35,4;12,1
2018;3551900;Severínia;15041;7759;7282;93,9;34,8;107,1
2018;3552007;Silveiras;6080;3040;3040;100;36,3;14,7
2018;3552106;Socorro;39178;19312;19866;102,9;39,6;87,3
2018;3552205;Sorocaba;681037;330519;350518;106,1;35,6;1513,8
2018;3552304;Sud Mennucci;7414;3694;3720;100,7;36,9;12,5
2018;3552403;Sumaré;268309;131901;136408;103,4;34,1;1748,3
2018;3552502;Suzano;293716;142741;150975;105,8;33,8;1424,2
2018;3552551;Suzanápolis;3439;1763;1676;95,1;37,8;10,4
2018;3552601;Tabapuã;11448;5685;5763;101,4;38,9;33,1
2018;3552700;Tabatinga;14807;7403;7404;100;35,9;40,2
2018;3552809;Taboão da Serra;266592;126860;139732;110,1;34;13076,1
2018;3552908;Taciba;6110;3013;3097;102,8;35,8;10,1
2018;3553005;Taguaí;12104;5998;6106;101,8;33,9;83,3
2018;3553104;Taiaçu;5786;2932;2854;97,3;37,3;54
2018;3553203;Taiúva;6213;3365;2848;84,6;38,3;46,9
2018;3553302;Tambaú;21938;10826;11112;102,6;37,2;39,1
2018;3553401;Tanabi;25050;12391;12659;102,2;38,6;33,5
2018;3553500;Tapiraí;8034;4044;3990;98,7;34,6;10,6
2018;3553609;Tapiratiba;12230;5974;6256;104,7;38;55,1
2018;3553658;Taquaral;2695;1338;1357;101,4;37,4;50
2018;3553708;Taquaritinga;53348;26070;27278;104,6;37,5;89,8
2018;3553807;Taquarituba;23788;12155;11633;95,7;35,9;53
2018;3553856;Taquarivaí;6274;3181;3093;97,2;32,3;27,1
2018;3553906;Tarabai;6618;3268;3350;102,5;35,2;32,9
2018;3553955;Tarumã;14335;7188;7147;99,4;34,4;47,3
2018;3554003;Tatuí;119065;58365;60700;104;35,4;227,3
2018;3554102;Taubaté;302105;146429;155676;106,3;36,3;483,4
2018;3554201;Tejupá;4404;2249;2155;95,8;34,9;14,9
2018;3554300;Teodoro Sampaio;22085;10929;11156;102,1;34,7;14,2
2018;3554409;Terra Roxa;8194;4106;4088;99,6;37;37
2018;3554508;Tietê;37541;18531;19010;102,6;37;92,8
2018;3554607;Timburi;2558;1290;1268;98,3;39,6;13
2018;3554656;Torre de Pedra;2122;1086;1036;95,4;39;29,7
2018;3554706;Torrinha;9322;4669;4653;99,7;38,7;29,6
2018;3554755;Trabiju;1630;820;810;98,8;34,8;25,7
2018;3554805;Tremembé;48071;25599;22472;87,8;35,4;251,6
2018;3554904;Três Fronteiras;6373;3193;3180;99,6;38,9;42
2018;3554953;Tuiuti;6560;3301;3259;98,7;39,7;51,8
2018;3555000;Tupã;64265;30840;33425;108,4;39,4;102,3
2018;3555109;Tupi Paulista;15441;7961;7480;94;41;63,1
2018;3555208;Turiúba;1870;950;920;96,8;41,1;12,2
2018;3555307;Turmalina;1787;878;909;103,5;44,4;12,1
2018;3555356;Ubarana;5379;2753;2626;95,4;34,1;25,6
2018;3555406;Ubatuba;88133;43646;44487;101,9;34,7;124,5
2018;3555505;Ubirajara;4907;2535;2372;93,6;35,3;17,4
2018;3555604;Uchoa;10150;5007;5143;102,7;38,9;40,2
2018;3555703;União Paulista;1621;814;807;99,1;35;20,5
2018;3555802;Urânia;8903;4386;4517;103;39,8;42,5
2018;3555901;Uru;1368;683;685;100,3;39,3;9,3
2018;3556008;Urupês;13460;6633;6827;102,9;39,5;41,6
2018;3556107;Valentim Gentil;13138;6560;6578;100,3;36,1;87,7
2018;3556206;Valinhos;120385;58900;61485;104,4;37,7;810,5
2018;3556305;Valparaíso;23903;13245;10658;80,5;35,4;27,9
2018;3556354;Vargem;9959;5086;4873;95,8;36,4;69,8
2018;3556404;Vargem Grande do Sul;40049;19763;20286;102,6;36,7;149,9
2018;3556453;Vargem Grande Paulista;48313;23737;24576;103,5;34,5;1137,1
2018;3556503;Várzea Paulista;114072;56671;57401;101,3;34;3248,1
2018;3556602;Vera Cruz;10447;5119;5328;104,1;38,9;42,2
2018;3556701;Vinhedo;72572;35526;37046;104,3;36,8;896,5
2018;3556800;Viradouro;17514;8706;8808;101,2;36,1;80,4
2018;3556909;Vista Alegre do Alto;7694;3908;3786;96,9;34,5;80,6
2018;3556958;Vitória Brasil;1793;920;873;94,9;38,2;36
2018;3557006;Votorantim;122164;59952;62212;103,8;34,6;663,3
2018;3557105;Votuporanga;92967;45001;47966;106,6;38,1;221
2018;3557154;Zacarias;2606;1303;1303;100;38,1;8,2
2018;3557204;Chavantes;12332;6037;6295;104,3;36,5;65,3
2018;3557303;Estiva Gerbi;10911;5475;5436;99,3;35,4;147,2
2019;3500105;Adamantina;34643;16703;17940;107,4;40,2;84,1
2019;3500204;Adolfo;4169;2067;2102;101,7;38,8;19,8
2019;3500303;Aguaí;32284;16054;16230;101,1;35,9;68
2019;3500402;Águas da Prata;7474;3612;3862;106,9;41,5;52,4
2019;3500501;Águas de Lindóia;17909;8728;9181;105,2;39,7;297,9
2019;3500550;Águas de Santa Bárbara;6841;3406;3435;100,9;38,3;16,9
2019;3500600;Águas de São Pedro;2780;1301;1479;113,7;44,5;769,6
2019;3500709;Agudos;37131;18247;18884;103,5;35,9;38,4
2019;3500758;Alambari;5847;2943;2904;98,7;35,6;36,6
2019;3500808;Alfredo Marcondes;4338;2170;2168;99,9;40,5;36,5
2019;3500907;Altair;3575;1849;1726;93,3;35,8;11,4
2019;3501004;Altinópolis;16581;8203;8378;102,1;37,5;17,8
2019;3501103;Alto Alegre;3987;2010;1977;98,4;41,6;12,5
2019;3501152;Alumínio;17329;8644;8685;100,5;34,6;207,2
2019;3501202;Álvares Florence;3940;2004;1936;96,6;42,7;10,9
2019;3501301;Álvares Machado;26497;12918;13579;105,1;36,7;76,2
2019;3501400;Álvaro de Carvalho;4802;3174;1628;51,3;35,8;31,3
2019;3501509;Alvinlândia;2941;1448;1493;103,1;36,3;34,6
2019;3501608;Americana;231764;112283;119481;106,4;38,1;1730,7
2019;3501707;Américo Brasiliense;33721;16739;16982;101,5;34,5;274,2
2019;3501806;Américo de Campos;5895;2877;3018;104,9;40;23,3
2019;3501905;Amparo;67880;33106;34774;105;38,6;152,4
2019;3502002;Analândia;4540;2297;2243;97,6;36,8;13,9
2019;3502101;Andradina;59146;29316;29830;101,8;38,4;61,3
2019;3502200;Angatuba;23674;11910;11764;98,8;36;23
2019;3502309;Anhembi;5707;2908;2799;96,3;35,7;7,7
2019;3502408;Anhumas;3958;1939;2019;104,1;37,4;12,3
2019;3502507;Aparecida;33581;16143;17438;108;37,4;277,8
2019;3502606;Aparecida d'Oeste;4232;2101;2131;101,4;41,5;23,6
2019;3502705;Apiaí;24986;12502;12484;99,9;35,3;25,6
2019;3502754;Araçariguama;20395;10274;10121;98,5;32,9;140,5
2019;3502804;Araçatuba;197004;93964;103040;109,7;38,3;168,8
2019;3502903;Araçoiaba da Serra;31350;15602;15748;100,9;38,4;122,8
2019;3503000;Aramina;5406;2649;2757;104,1;38,1;26,7
2019;3503109;Arandu;6702;3367;3335;99;35,8;23,4
2019;3503158;Arapeí;2400;1198;1202;100,3;38,2;15,3
2019;3503208;Araraquara;234979;112861;122118;108,2;37,8;234,1
2019;3503307;Araras;128439;62483;65956;105,6;37,4;199,2
2019;3503356;Arco-Íris;2024;1024;1000;97,7;38,4;7,6
2019;3503406;Arealva;8066;4043;4023;99,5;40,4;15,9
2019;3503505;Areias;3619;1822;1797;98,6;36,4;11,9
2019;3503604;Areiópolis;10341;5249;5092;97;34;120,4
2019;3503703;Ariranha;7888;3937;3951;100,4;38,4;59,5
2019;3503802;Artur Nogueira;49840;24636;25204;102,3;35;280
2019;3503901;Arujá;84078;41002;43076;105,1;34,5;874,3
2019;3503950;Aspásia;1840;923;917;99,3;40,1;26,5
2019;3504008;Assis;100611;48583;52028;107,1;37,9;218,4
2019;3504107;Atibaia;151342;73568;77774;105,7;37;316,3
2019;3504206;Auriflama;13937;6901;7036;102;39,3;32,1
2019;3504305;Avaí;4621;2304;2317;100,6;36,4;8,5
2019;3504404;Avanhandava;11374;6267;5107;81,5;34,6;33,6
2019;3504503;Avaré;90958;45073;45885;101,8;36,5;75
2019;3504602;Bady Bassitt;23974;11790;12184;103,3;35,4;217,2
2019;3504701;Balbinos;3819;3113;706;22,7;36,4;41,7
2019;3504800;Bálsamo;9301;4532;4769;105,2;39,1;62,1
2019;3504909;Bananal;10085;4922;5163;104,9;37,7;16,4
2019;3505005;Barão de Antonina;3434;1714;1720;100,4;37;22,4
2019;3505104;Barbosa;5942;2931;3011;102,7;36,7;29
2019;3505203;Bariri;31810;15663;16147;103,1;38;71,6
2019;3505302;Barra Bonita;34828;16838;17990;106,8;39,6;232
2019;3505351;Barra do Chapéu;5215;2716;2499;92;34,5;12,9
2019;3505401;Barra do Turvo;7151;3662;3489;95,3;36,1;7,1
2019;3505500;Barretos;120520;57922;62598;108,1;37,3;77
2019;3505609;Barrinha;31421;15572;15849;101,8;33;215,2
2019;3505708;Barueri;299502;143669;155833;108,5;33,6;4558,6
2019;3505807;Bastos;21392;10467;10925;104,4;37,3;125,2
2019;3505906;Batatais;58168;28337;29831;105,3;37,8;68,5
2019;3506003;Bauru;372522;180246;192276;106,7;37,1;557,9
2019;3506102;Bebedouro;76592;37136;39456;106,2;37,9;112,1
2019;3506201;Bento de Abreu;2651;1334;1317;98,7;36,3;8,8
2019;3506300;Bernardino de Campos;11476;5936;5540;93,3;38,4;47
2019;3506359;Bertioga;60270;30065;30205;100,5;33,3;122,6
2019;3506409;Bilac;7337;3607;3730;103,4;39,6;46,4
2019;3506508;Birigui;117404;56932;60472;106,2;37,5;221,5
2019;3506607;Biritiba Mirim;29626;14804;14822;100,1;35,5;93,3
2019;3506706;Boa Esperança do Sul;13191;6544;6647;101,6;35,2;19,1
2019;3506805;Bocaina;11269;5537;5732;103,5;36,7;31
2019;3506904;Bofete;10333;5255;5078;96,6;38;15,8
2019;3507001;Boituva;58112;28779;29333;101,9;35,5;233,4
2019;3507100;Bom Jesus dos Perdões;21506;10694;10812;101,1;35,1;198,5
2019;3507159;Bom Sucesso de Itararé;3555;1815;1740;95,9;31,9;26,6
2019;3507209;Borá;897;451;446;98,9;36,5;7,5
2019;3507308;Boracéia;4611;2340;2271;97,1;35,2;37,8
2019;3507407;Borborema;14418;7180;7238;100,8;39,2;26,1
2019;3507456;Borebi;2627;1282;1345;104,9;34,1;7,5
2019;3507506;Botucatu;141380;68153;73227;107,4;37;95,4
2019;3507605;Bragança Paulista;170007;82694;87313;105,6;36,9;331,7
2019;3507704;Braúna;5320;2637;2683;101,7;37,8;27,3
2019;3507753;Brejo Alegre;2597;1320;1277;96,7;37,8;24,6
2019;3507803;Brodowski;24299;11943;12356;103,5;36,5;87,3
2019;3507902;Brotas;23438;11445;11993;104,8;37,2;21,3
2019;3508009;Buri;19965;10055;9910;98,6;33,3;16,7
2019;3508108;Buritama;16932;8283;8649;104,4;38,8;51,8
2019;3508207;Buritizal;4301;2124;2177;102,5;38,1;16,1
2019;3508306;Cabrália Paulista;4378;2220;2158;97,2;36,1;18,2
2019;3508405;Cabreúva;45821;22820;23001;100,8;33,5;176,1
2019;3508504;Caçapava;94054;46182;47872;103,7;36,4;254,9
2019;3508603;Cachoeira Paulista;31414;15226;16188;106,3;36,9;109,1
2019;3508702;Caconde;17564;8745;8819;100,8;38,1;37,5
2019;3508801;Cafelândia;16776;8138;8638;106,1;37,8;18,2
2019;3508900;Caiabu;3829;1926;1903;98,8;39,3;15,1
2019;3509007;Caieiras;93572;45442;48130;105,9;34,8;958,3
2019;3509106;Caiuá;5378;3131;2247;71,8;37,9;9,8
2019;3509205;Cajamar;85650;42189;43461;103;32,7;651,9
2019;3509254;Cajati;28743;14466;14277;98,7;34,1;63,2
2019;3509304;Cajobi;9346;4674;4672;100;38,6;52,8
2019;3509403;Cajuru;23889;11892;11997;100,9;36,2;36,2
2019;3509452;Campina do Monte Alegre;5890;2977;2913;97,9;36,5;31,9
2019;3509502;Campinas;1133164;542019;591145;109,1;37,4;1426,1
2019;3509601;Campo Limpo Paulista;77509;37923;39586;104,4;35,3;976,1
2019;3509700;Campos do Jordão;47505;23219;24286;104,6;35,1;163,8
2019;3509809;Campos Novos Paulista;4817;2440;2377;97,4;36,4;9,9
2019;3509908;Cananéia;12360;6081;6279;103,3;36,5;10
2019;3509957;Canas;4811;2402;2409;100,3;33,6;90,3
2019;3510005;Cândido Mota;29822;14531;15291;105,2;38,1;50,1
2019;3510104;Cândido Rodrigues;2842;1413;1429;101,1;40,8;40,1
2019;3510153;Canitar;5789;2861;2928;102,3;32,1;100,8
2019;3510203;Capão Bonito;46709;23181;23528;101,5;35,3;28,5
2019;3510302;Capela do Alto;21605;11654;9951;85,4;34,5;127,2
2019;3510401;Capivari;49940;24612;25328;102,9;35,8;154,7
2019;3510500;Caraguatatuba;126908;62017;64891;104,6;35,6;261,7
2019;3510609;Carapicuíba;386747;186393;200354;107,5;34,1;11195,2
2019;3510708;Cardoso;11634;5702;5932;104;40,4;18,2
2019;3510807;Casa Branca;28357;14775;13582;91,9;37,6;32,8
2019;3510906;Cássia dos Coqueiros;2792;1437;1355;94,3;39,5;14,6
2019;3511003;Castilho;19684;9726;9958;102,4;37,1;18,5
2019;3511102;Catanduva;115904;55708;60196;108,1;38,7;398,8
2019;3511201;Catiguá;7093;3560;3533;99,2;37,3;47,8
2019;3511300;Cedral;11424;5653;5771;102,1;37,7;57,7
2019;3511409;Cerqueira César;20621;10587;10034;94,8;35,9;40,3
2019;3511508;Cerquilho;43697;21385;22312;104,3;36,9;341,9
2019;3511607;Cesário Lange;18284;9401;8883;94,5;35,6;96
2019;3511706;Charqueada;15530;7783;7747;99,5;35,9;88,3
2019;3511904;Clementina;7072;3549;3523;99,3;35,3;41,9
2019;3512001;Colina;18312;8916;9396;105,4;37;43,4
2019;3512100;Colômbia;6567;3312;3255;98,3;35,7;9
2019;3512209;Conchal;27551;13791;13760;99,8;34,4;150,7
2019;3512308;Conchas;15605;7825;7780;99,4;38,1;33,5
2019;3512407;Cordeirópolis;23762;11781;11981;101,7;35,4;172,7
2019;3512506;Coroados;5432;2698;2734;101,3;37,7;22
2019;3512605;Coronel Macedo;4520;2286;2234;97,7;38,1;14,9
2019;3512704;Corumbataí;4141;2079;2062;99,2;36;14,9
2019;3512803;Cosmópolis;59963;29579;30384;102,7;35,4;387,7
2019;3512902;Cosmorama;8351;4172;4179;100,2;39,1;18,9
2019;3513009;Cotia;257130;124971;132159;105,8;33,9;793,6
2019;3513108;Cravinhos;33139;16377;16762;102,4;36,6;106,4
2019;3513207;Cristais Paulista;8879;4429;4450;100,5;36;23
2019;3513306;Cruzália;2170;1069;1101;103;40,2;14,5
2019;3513405;Cruzeiro;76162;36684;39478;107,6;37,3;249,1
2019;3513504;Cubatão;115282;55917;59365;106,2;34,2;806,8
2019;3513603;Cunha;22173;11291;10882;96,4;38,2;15,8
2019;3513702;Descalvado;31807;15626;16181;103,6;38,3;42,2
2019;3513801;Diadema;395937;189752;206185;108,7;34,8;12883,5
2019;3513850;Dirce Reis;1636;845;791;93,6;40,6;18,6
2019;3513900;Divinolândia;11257;5586;5671;101,5;39,8;50,3
2019;3514007;Dobrada;8608;4318;4290;99,4;33,7;57,5
2019;3514106;Dois Córregos;24786;12273;12513;102;36,8;39,2
2019;3514205;Dolcinópolis;2177;1104;1073;97,2;40,2;27,9
2019;3514304;Dourado;8309;4132;4177;101,1;39,4;40,4
2019;3514403;Dracena;45286;22252;23034;103,5;39,6;92,9
2019;3514502;Duartina;12370;6034;6336;105;39,8;46,8
2019;3514601;Dumont;9114;4541;4573;100,7;35,1;81,8
2019;3514700;Echaporã;6279;3087;3192;103,4;37,5;12,2
2019;3514809;Eldorado;13606;6862;6744;98,3;34,8;8,2
2019;3514908;Elias Fausto;17308;8754;8554;97,7;35;85,5
2019;3514924;Elisiário;3169;1612;1557;96,6;38,1;33,7
2019;3514957;Embaúba;2373;1216;1157;95,1;38,9;28,5
2019;3515004;Embu das Artes;250792;121119;129673;107,1;33,2;3562,5
2019;3515103;Embu-Guaçu;66627;32892;33735;102,6;34,6;428,1
2019;3515129;Emilianópolis;3055;1527;1528;100,1;40,1;13,6
2019;3515152;Engenheiro Coelho;18592;9428;9164;97,2;32,5;169,1
2019;3515186;Espírito Santo do Pinhal;40549;19708;20841;105,7;38,9;104,2
2019;3515194;Espírito Santo do Turvo;4191;2103;2088;99,3;33,7;21,6
2019;3515202;Estrela d'Oeste;9135;4626;4509;97,5;38,6;30,8
2019;3515301;Estrela do Norte;2722;1352;1370;101,3;36,6;10,3
2019;3515350;Euclides da Cunha Paulista;8419;4171;4248;101,8;36,6;14,7
2019;3515400;Fartura;16397;7981;8416;105,5;38;38,2
2019;3515509;Fernandópolis;70017;33769;36248;107,3;39;127,4
2019;3515608;Fernando Prestes;5855;2885;2970;102,9;40,1;34,4
2019;3515657;Fernão;1637;838;799;95,3;37,6;16,3
2019;3515707;Ferraz de Vasconcelos;177619;86128;91491;106,2;33,3;6011,3
2019;3515806;Flora Rica;1575;782;793;101,4;42,7;7
2019;3515905;Floreal;2833;1390;1443;103,8;43,5;13,9
2019;3516002;Flórida Paulista;13003;7127;5876;82,4;37,8;24,8
2019;3516101;Florínea;3638;2195;1443;65,7;38;16,1
2019;3516200;Franca;346530;168286;178244;105,9;36,3;572,1
2019;3516309;Francisco Morato;163518;80308;83210;103,6;32,2;3337
2019;3516408;Franco da Rocha;142269;71846;70423;98;33,5;1071,5
2019;3516507;Gabriel Monteiro;2794;1395;1399;100,3;40;20,1
2019;3516606;Gália;6621;3258;3363;103,2;39,9;18,6
2019;3516705;Garça;42675;20610;22065;107,1;38,3;76,8
2019;3516804;Gastão Vidigal;3540;1751;1789;102,2;38,3;19,6
2019;3516853;Gavião Peixoto;4657;2338;2319;99,2;34,8;19,1
2019;3516903;General Salgado;10508;5214;5294;101,5;39,7;21,3
2019;3517000;Getulina;10452;5712;4740;83;38;15,4
2019;3517109;Glicério;4296;2115;2181;103,1;38,5;15,7
2019;3517208;Guaiçara;11165;5539;5626;101,6;35,6;40,3
2019;3517307;Guaimbê;5536;2746;2790;101,6;37,1;25,4
2019;3517406;Guaíra;39068;19106;19962;104,5;37;31
2019;3517505;Guapiaçu;20806;10354;10452;100,9;36,3;64
2019;3517604;Guapiara;17553;8902;8651;97,2;36,3;43
2019;3517703;Guará;19100;9375;9725;103,7;35,6;52,7
2019;3517802;Guaraçaí;7789;3854;3935;102,1;41,2;13,7
2019;3517901;Guaraci;10339;5191;5148;99,2;37,1;16,1
2019;3518008;Guarani d'Oeste;1978;980;998;101,8;39,9;23,1
2019;3518107;Guarantã;6474;3209;3265;101,7;35,8;14
2019;3518206;Guararapes;31195;15231;15964;104,8;38,6;32,6
2019;3518305;Guararema;30030;14894;15136;101,6;36,3;110,9
2019;3518404;Guaratinguetá;117004;56113;60891;108,5;37,7;155,5
2019;3518503;Guareí;15014;9057;5957;65,8;36;26,4
2019;3518602;Guariba;37324;18192;19132;105,2;34,7;138,1
2019;3518701;Guarujá;291362;140524;150838;107,3;34,8;2012,2
2019;3518800;Guarulhos;1284707;619787;664920;107,3;34,3;4031,4
2019;3518859;Guatapará;7285;3689;3596;97,5;35,9;17,6
2019;3518909;Guzolândia;4429;2263;2166;95,7;37,3;17,5
2019;3519006;Herculândia;9061;4465;4596;102,9;36,7;24,9
2019;3519055;Holambra;14125;7056;7069;100,2;35,5;215,4
2019;3519071;Hortolândia;226593;112970;113623;100,6;33,9;3630,4
2019;3519105;Iacanga;10358;5183;5175;99,8;37,3;18,9
2019;3519204;Iacri;6259;3129;3130;100;38,8;19,4
2019;3519253;Iaras;7605;5096;2509;49,2;36,8;18,9
2019;3519303;Ibaté;32014;16083;15931;99,1;34,2;110
2019;3519402;Ibirá;11530;5662;5868;103,6;38,7;42,4
2019;3519501;Ibirarema;6539;3266;3273;100,2;37,6;28,7
2019;3519600;Ibitinga;58606;28791;29815;103,6;36,6;85
2019;3519709;Ibiúna;75053;37800;37253;98,6;35,6;70,9
2019;3519808;Icém;7815;4231;3584;84,7;36,7;21,6
2019;3519907;Iepê;7693;3748;3945;105,3;38,6;12,9
2019;3520004;Igaraçu do Tietê;23367;11638;11729;100,8;36,4;239,1
2019;3520103;Igarapava;26858;13045;13813;105,9;37,6;57,3
2019;3520202;Igaratá;10202;5139;5063;98,5;36,5;34,8
2019;3520301;Iguape;29307;14711;14596;99,2;37,9;14,8
2019;3520400;Ilhabela;33277;16581;16696;100,7;34,3;96,1
2019;3520426;Ilha Comprida;12422;6134;6288;102,5;40,4;63,2
2019;3520442;Ilha Solteira;25690;12473;13217;106;39,4;39,4
2019;3520509;Indaiatuba;242784;119116;123668;103,8;36,2;779,3
2019;3520608;Indiana;5055;2549;2506;98,3;38,2;39,1
2019;3520707;Indiaporã;4057;1984;2073;104,5;41,1;14,5
2019;3520806;Inúbia Paulista;3645;1804;1841;102,1;38,6;41,8
2019;3520905;Ipaussu;13800;6813;6987;102,6;36,2;65,9
2019;3521002;Iperó;34526;18527;15999;86,4;33,9;202,7
2019;3521101;Ipeúna;6691;3377;3314;98,1;35,2;35,2
2019;3521150;Ipiguá;6188;3118;3070;98,5;37,2;45,5
2019;3521200;Iporanga;4144;2096;2048;97,7;34,8;3,6
2019;3521309;Ipuã;14468;7234;7234;100;35,1;31
2019;3521408;Iracemápolis;21626;10767;10859;100,9;35,9;187,9
2019;3521507;Irapuã;7026;3573;3453;96,6;37,2;27,3
2019;3521606;Irapuru;7324;4216;3108;73,7;39,4;34,2
2019;3521705;Itaberá;18060;9061;8999;99,3;36,2;16,4
2019;3521804;Itaí;25064;13064;12000;91,9;35,4;22,9
2019;3521903;Itajobi;16384;8208;8176;99,6;38,6;32,6
2019;3522000;Itaju;3528;1780;1748;98,2;36,8;15,3
2019;3522109;Itanhaém;106938;51556;55382;107,4;37,6;177,7
2019;3522158;Itaoca;3388;1718;1670;97,2;37,1;18,5
2019;3522208;Itapecerica da Serra;158506;77906;80600;103,5;33,5;1051,5
2019;3522307;Itapetininga;155287;77544;77743;100,3;35,4;86,8
2019;3522406;Itapeva;90006;44231;45775;103,5;34,9;49,3
2019;3522505;Itapevi;226021;110433;115588;104,7;32,2;2734,4
2019;3522604;Itapira;71623;35189;36434;103,5;38,4;138,2
2019;3522653;Itapirapuã Paulista;4187;2161;2026;93,8;33;10,3
2019;3522703;Itápolis;39892;19596;20296;103,6;38,5;40
2019;3522802;Itaporanga;14338;7073;7265;102,7;37,3;28,2
2019;3522901;Itapuí;13254;6622;6632;100,2;35,2;94,7
2019;3523008;Itapura;4155;2106;2049;97,3;37,7;13,8
2019;3523107;Itaquaquecetuba;359455;176009;183446;104,2;32,2;4350,6
2019;3523206;Itararé;45774;22341;23433;104,9;35,9;45,6
2019;3523305;Itariri;15614;7784;7830;100,6;34,8;57,1
2019;3523404;Itatiba;117089;57449;59640;103,8;36,7;363,3
2019;3523503;Itatinga;18980;9965;9015;90,5;33,9;19,4
2019;3523602;Itirapina;16026;9434;6592;69,9;35,5;28,4
2019;3523701;Itirapuã;5831;2963;2868;96,8;35,7;36,2
2019;3523800;Itobi;7934;4047;3887;96;36,8;57,1
2019;3523909;Itu;165771;81237;84534;104,1;35,8;258,7
2019;3524006;Itupeva;64247;32312;31935;98,8;33,4;319,8
2019;3524105;Ituverava;38056;18431;19625;106,5;38,2;54
2019;3524204;Jaborandi;6375;3172;3203;101;37,4;23,3
2019;3524303;Jaboticabal;72304;34633;37671;108,8;38,2;102,3
2019;3524402;Jacareí;234877;113642;121235;106,7;36,3;505,9
2019;3524501;Jaci;7150;3618;3532;97,6;34,9;49,3
2019;3524600;Jacupiranga;16516;8248;8268;100,2;35,8;23,5
2019;3524709;Jaguariúna;55801;27244;28557;104,8;35,6;394,7
2019;3524808;Jales;48694;23612;25082;106,2;39,7;132,1
2019;3524907;Jambeiro;6160;3108;3052;98,2;36,6;33,4
2019;3525003;Jandira;116513;56622;59891;105,8;33,5;6677,3
2019;3525102;Jardinópolis;43531;22377;21154;94,5;35,3;86,7
2019;3525201;Jarinu;34209;17187;17022;99;34,8;164,8
2019;3525300;Jaú;133711;64828;68883;106,3;37,8;194,6
2019;3525409;Jeriquara;3688;1899;1789;94,2;33,7;26
2019;3525508;Joanópolis;12629;6386;6243;97,8;37,9;33,7
2019;3525607;João Ramalho;4366;2189;2177;99,5;35,1;10,5
2019;3525706;José Bonifácio;35852;17718;18134;102,3;36,7;41,7
2019;3525805;Júlio Mesquita;4329;2113;2216;104,9;36,5;33,8
2019;3525854;Jumirim;3011;1502;1509;100,5;35;53,1
2019;3525904;Jundiaí;426842;206309;220533;106,9;37,7;989,9
2019;3526001;Junqueirópolis;20193;10592;9601;90,6;38,7;34,7
2019;3526100;Juquiá;17881;8988;8893;98,9;36,8;22
2019;3526209;Juquitiba;28006;14121;13885;98,3;35,1;53,6
2019;3526308;Lagoinha;5038;2554;2484;97,3;40,5;19,7
2019;3526407;Laranjal Paulista;26108;12774;13334;104,4;37,2;67,9
2019;3526506;Lavínia;9464;6938;2526;36,4;36,5;17,6
2019;3526605;Lavrinhas;7070;3526;3544;100,5;33,8;42,3
2019;3526704;Leme;97290;47999;49291;102,7;35,8;241,5
2019;3526803;Lençóis Paulista;65505;32339;33166;102,6;36;80,9
2019;3526902;Limeira;289824;141480;148344;104,9;37,1;499,1
2019;3527009;Lindóia;6977;3448;3529;102,3;38,1;143,1
2019;3527108;Lins;74591;35902;38689;107,8;38;130,8
2019;3527207;Lorena;84820;40692;44128;108,4;36,9;204,8
2019;3527256;Lourdes;2015;1006;1009;100,3;40,1;17,7
2019;3527306;Louveira;48148;24043;24105;100,3;33,2;863,8
2019;3527405;Lucélia;20157;11071;9086;82,1;39,1;64
2019;3527504;Lucianópolis;2351;1189;1162;97,7;37,9;12,4
2019;3527603;Luís Antônio;12052;6058;5994;98,9;33,7;20,1
2019;3527702;Luiziânia;4811;2425;2386;98,4;36,5;28,9
2019;3527801;Lupércio;4109;2005;2104;104,9;37;26,5
2019;3527900;Lutécia;2708;1343;1365;101,6;37,7;5,7
2019;3528007;Macatuba;16810;8341;8469;101,5;36;74,9
2019;3528106;Macaubal;7567;3783;3784;100;40,8;30,5
2019;3528205;Macedônia;3925;1952;1973;101,1;40,4;12
2019;3528304;Magda;3211;1589;1622;102,1;41;10,3
2019;3528403;Mairinque;48656;24429;24227;99,2;35,6;231,5
2019;3528502;Mairiporã;91024;45446;45578;100,3;35,7;283,8
2019;3528601;Manduri;9717;4823;4894;101,5;37,7;42,4
2019;3528700;Marabá Paulista;4645;2913;1732;59,5;36,4;5,1
2019;3528809;Maracaí;12952;6420;6532;101,7;37,3;24,3
2019;3528858;Marapoama;3156;1615;1541;95,4;37,7;28,4
2019;3528908;Mariápolis;3639;1829;1810;99;38,9;19,5
2019;3529005;Marília;233876;112320;121556;108,2;37,5;199,8
2019;3529104;Marinópolis;1937;982;955;97,3;39,8;24,9
2019;3529203;Martinópolis;24841;12805;12036;94;37,7;19,8
2019;3529302;Matão;79136;38938;40198;103,2;37,6;150,8
2019;3529401;Mauá;421601;203973;217628;106,7;34,9;6806,9
2019;3529500;Mendonça;5800;2920;2880;98,6;38;29,7
2019;3529609;Meridiano;4430;2166;2264;104,5;38,7;19,4
2019;3529658;Mesópolis;1936;976;960;98,4;37,6;13
2019;3529708;Miguelópolis;19890;9794;10096;103,1;35,8;24,2
2019;3529807;Mineiros do Tietê;11521;5723;5798;101,3;37,1;54
2019;3529906;Miracatu;19242;9626;9616;99,9;35,6;19,2
2019;3530003;Mira Estrela;3069;1534;1535;100,1;40,7;14,2
2019;3530102;Mirandópolis;28132;15846;12286;77,5;39,7;30,7
2019;3530201;Mirante do Paranapanema;16354;8190;8164;99,7;38,7;13,2
2019;3530300;Mirassol;61193;29748;31445;105,7;37,6;251,6
2019;3530409;Mirassolândia;4593;2316;2277;98,3;37,5;27,6
2019;3530508;Mococa;67964;33467;34497;103,1;38,3;79,5
2019;3530607;Mogi das Cruzes;438365;211594;226771;107,2;35,3;615,2
2019;3530706;Mogi Guaçu;150686;73770;76916;104,3;36,8;185,4
2019;3530805;Mogi Mirim;91873;44816;47057;105;38;184,6
2019;3530904;Mombuca;3617;1791;1826;102;34,4;27,1
2019;3531001;Monções;2022;1017;1005;98,8;41,6;19,4
2019;3531100;Mongaguá;58346;29551;28795;97,4;38;408,7
2019;3531209;Monte Alegre do Sul;8305;4109;4196;102,1;40;75,3
2019;3531308;Monte Alto;47638;23349;24289;104;39;137,3
2019;3531407;Monte Aprazível;22271;10926;11345;103,8;38,9;44,9
2019;3531506;Monte Azul Paulista;18467;9246;9221;99,7;38,6;70,1
2019;3531605;Monte Castelo;4203;2090;2113;101,1;39,4;18
2019;3531704;Monteiro Lobato;4140;2088;2052;98,3;38;12,4
2019;3531803;Monte Mor;60961;30166;30795;102,1;33,9;253,4
2019;3531902;Morro Agudo;28553;14136;14417;102;34,9;20,6
2019;3532009;Morungaba;13309;6546;6763;103,3;35,8;90,7
2019;3532058;Motuca;4144;2096;2048;97,7;36,7;18,1
2019;3532108;Murutinga do Sul;3883;1932;1951;101;41,7;15,5
2019;3532157;Nantes;2684;1327;1357;102,3;34,8;9,4
2019;3532207;Narandiba;5360;2673;2687;100,5;33,9;15
2019;3532306;Natividade da Serra;6948;3626;3322;91,6;39,5;8,3
2019;3532405;Nazaré Paulista;17849;9087;8762;96,4;37,2;54,7
2019;3532504;Neves Paulista;9518;4715;4803;101,9;40,8;43,5
2019;3532603;Nhandeara;10173;4920;5253;106,8;41,7;23,3
2019;3532702;Nipoã;4682;2420;2262;93,5;35,4;34
2019;3532801;Nova Aliança;6513;3210;3303;102,9;37,7;29,9
2019;3532827;Nova Campina;8557;4292;4265;99,4;32,4;22,2
2019;3532843;Nova Canaã Paulista;2065;1034;1031;99,7;43,4;16,6
2019;3532868;Nova Castilho;1099;548;551;100,5;37,3;6
2019;3532900;Nova Europa;9371;4691;4680;99,8;35,9;58,5
2019;3533007;Nova Granada;19459;9676;9783;101,1;37,4;36,6
2019;3533106;Nova Guataporanga;2170;1073;1097;102,2;40;63,5
2019;3533205;Nova Independência;4256;2276;1980;87;34,3;16,1
2019;3533254;Novais;4486;2297;2189;95,3;33,6;38,1
2019;3533304;Nova Luzitânia;3031;1540;1491;96,8;37,9;41,1
2019;3533403;Nova Odessa;59653;29251;30402;103,9;36,6;808,4
2019;3533502;Novo Horizonte;38239;18893;19346;102,4;37,9;41
2019;3533601;Nuporanga;7296;3617;3679;101,7;37,1;20,9
2019;3533700;Ocauçu;4291;2191;2100;95,8;37,4;14,3
2019;3533809;Óleo;2573;1303;1270;97,5;39,5;12,9
2019;3533908;Olímpia;54195;26433;27762;105;37,4;67,5
2019;3534005;Onda Verde;4552;2305;2247;97,5;35,7;18,7
2019;3534104;Oriente;6159;2971;3188;107,3;39,2;28,2
2019;3534203;Orindiúva;5979;2995;2984;99,6;34,6;24,2
2019;3534302;Orlândia;38982;18897;20085;106,3;37,4;133,6
2019;3534401;Osasco;719799;343402;376397;109,6;35,4;11081,7
2019;3534500;Oscar Bressane;2517;1216;1301;107;41,7;11,3
2019;3534609;Osvaldo Cruz;31339;15636;15703;100,4;39,9;126,3
2019;3534708;Ourinhos;104690;50064;54626;109,1;37,4;353,9
2019;3534757;Ouroeste;9941;4910;5031;102,5;37,5;34,4
2019;3534807;Ouro Verde;7837;3796;4041;106,5;36,4;29,4
2019;3534906;Pacaembu;14522;9324;5198;55,7;38,6;42,8
2019;3535002;Palestina;11408;5705;5703;100;38,5;16,4
2019;3535101;Palmares Paulista;10021;5100;4921;96,5;34;122
2019;3535200;Palmeira d'Oeste;9144;4563;4581;100,4;41,8;28,7
2019;3535309;Palmital;20212;9848;10364;105,2;39,6;36,9
2019;3535408;Panorama;15066;7472;7594;101,6;35,6;42,3
2019;3535507;Paraguaçu Paulista;41808;20905;20903;100;37;41,7
2019;3535606;Paraibuna;17720;8972;8748;97,5;37,4;21,9
2019;3535705;Paraíso;6105;3082;3023;98,1;38,5;39,3
2019;3535804;Paranapanema;19060;9687;9373;96,8;34,7;18,7
2019;3535903;Paranapuã;3999;2006;1993;99,4;37,7;28,5
2019;3536000;Parapuã;10736;5356;5380;100,4;40;29,3
2019;3536109;Pardinho;6835;3467;3368;97,1;35,3;32,6
2019;3536208;Pariquera-Açu;19189;9506;9683;101,9;36,1;53,4
2019;3536257;Parisi;2698;1322;1376;104,1;39,1;31,8
2019;3536307;Patrocínio Paulista;14233;7181;7052;98,2;35,4;23,6
2019;3536406;Paulicéia;7607;3856;3751;97,3;35,5;20,3
2019;3536505;Paulínia;103618;50553;53065;105;35,1;746,7
2019;3536570;Paulistânia;2011;1010;1001;99,1;36,8;7,9
2019;3536604;Paulo de Faria;7785;3909;3876;99,2;38,4;10,5
2019;3536703;Pederneiras;44276;22062;22214;100,7;36,1;60,9
2019;3536802;Pedra Bela;6345;3304;3041;92;38,7;40
2019;3536901;Pedranópolis;2769;1397;1372;98,2;41,4;10,6
2019;3537008;Pedregulho;15681;7885;7796;98,9;36,2;22
2019;3537107;Pedreira;42921;21091;21830;103,5;37,4;394,4
2019;3537156;Pedrinhas Paulista;2858;1404;1454;103,6;39,4;18,8
2019;3537206;Pedro de Toledo;11089;5665;5424;95,7;36,8;16,5
2019;3537305;Penápolis;61341;29629;31712;107;38,3;86,2
2019;3537404;Pereira Barreto;24600;11953;12647;105,8;38,7;25,3
2019;3537503;Pereiras;8449;4231;4218;99,7;36,8;37,9
2019;3537602;Peruíbe;66703;32260;34443;106,8;37,8;204,5
2019;3537701;Piacatu;5533;2763;2770;100,3;38,5;23,8
2019;3537800;Piedade;53076;26751;26325;98,4;37;71,1
2019;3537909;Pilar do Sul;27452;13907;13545;97,4;36;40,3
2019;3538006;Pindamonhangaba;161527;78575;82952;105,6;35,7;220,9
2019;3538105;Pindorama;14758;7394;7364;99,6;39,2;79,8
2019;3538204;Pinhalzinho;14756;7363;7393;100,4;39;95,5
2019;3538303;Piquerobi;3346;1607;1739;108,2;39,2;6,9
2019;3538501;Piquete;13062;6271;6791;108,3;39,1;74,2
2019;3538600;Piracaia;25991;12751;13240;103,8;38,3;67,4
2019;3538709;Piracicaba;410779;199329;211450;106,1;36,9;298,1
2019;3538808;Piraju;29388;14223;15165;106,6;38,2;58,2
2019;3538907;Pirajuí;22730;12055;10675;88,6;37,9;27,6
2019;3539004;Pirangi;10886;5455;5431;99,6;39;50,4
2019;3539103;Pirapora do Bom Jesus;17737;8810;8927;101,3;32,2;163,5
2019;3539202;Pirapozinho;25346;12345;13001;105,3;37,3;53,1
2019;3539301;Pirassununga;73173;35418;37755;106,6;38,2;100,6
2019;3539400;Piratininga;14419;7045;7374;104,7;37,6;35,8
2019;3539509;Pitangueiras;34397;17221;17176;99,7;34,6;79,9
2019;3539608;Planalto;4464;2235;2229;99,7;36,5;15,4
2019;3539707;Platina;3110;1582;1528;96,6;36,8;9,5
2019;3539806;Poá;105457;50725;54732;107,9;35,1;6108,6
2019;3539905;Poloni;5574;2734;2840;103,9;39,2;41,3
2019;3540002;Pompéia;20278;9929;10349;104,2;38,1;25,8
2019;3540101;Pongaí;3455;1750;1705;97,4;40,5;18,8
2019;3540200;Pontal;38520;19599;18921;96,5;33,3;108,1
2019;3540259;Pontalinda;4126;2204;1922;87,2;36;19,7
2019;3540309;Pontes Gestal;2435;1211;1224;101,1;39;11,2
2019;3540408;Populina;4203;2082;2121;101,9;40;13,3
2019;3540507;Porangaba;9989;5106;4883;95,6;40;37,6
2019;3540606;Porto Feliz;54826;27794;27032;97,3;36,4;98,5
2019;3540705;Porto Ferreira;52667;25766;26901;104,4;37,3;215
2019;3540754;Potim;20186;11379;8807;77,4;33,2;452,2
2019;3540804;Potirendaba;17807;8854;8953;101,1;37,8;52
2019;3540853;Pracinha;2644;1907;737;38,6;34,3;41,9
2019;3540903;Pradópolis;17295;8611;8684;100,8;35,7;103,3
2019;3541000;Praia Grande;329706;156983;172723;110;36,3;2203,2
2019;3541059;Pratânia;5038;2529;2509;99,2;33,4;28,8
2019;3541109;Presidente Alves;3918;1943;1975;101,6;38,6;13,7
2019;3541208;Presidente Bernardes;14368;7791;6577;84,4;40,3;19,2
2019;3541307;Presidente Epitácio;40328;19542;20786;106,4;37,4;32
2019;3541406;Presidente Prudente;222871;106763;116108;108,8;38;397,5
2019;3541505;Presidente Venceslau;36209;17652;18557;105,1;39,9;47,9
2019;3541604;Promissão;35626;17548;18078;103;37;45,7
2019;3541653;Quadra;3379;1739;1640;94,3;37,5;16,4
2019;3541703;Quatá;13130;6540;6590;100,8;36,2;20,2
2019;3541802;Queiroz;3139;1578;1561;98,9;34,1;13,4
2019;3541901;Queluz;9732;4864;4868;100,1;35,5;39
2019;3542008;Quintana;6789;3324;3465;104,2;36,6;21,3
2019;3542107;Rafard;8882;4390;4492;102,3;36,4;73
2019;3542206;Rancharia;28834;13991;14843;106,1;37,8;18,2
2019;3542305;Redenção da Serra;4379;2290;2089;91,2;39,2;14,2
2019;3542404;Regente Feijó;19875;9804;10071;102,7;37,8;75,5
2019;3542503;Reginópolis;7576;4721;2855;60,5;35,6;18,5
2019;3542602;Registro;58993;29217;29776;101,9;36;81,7
2019;3542701;Restinga;6486;3229;3257;100,9;34,4;26,4
2019;3542800;Ribeira;3211;1647;1564;95;37,1;9,6
2019;3542909;Ribeirão Bonito;11387;5659;5728;101,2;36,7;24,1
2019;3543006;Ribeirão Branco;18633;9511;9122;95,9;33;26,7
2019;3543105;Ribeirão Corrente;4543;2292;2251;98,2;34,4;30,6
2019;3543204;Ribeirão do Sul;4633;2330;2303;98,8;39,2;22,8
2019;3543238;Ribeirão dos Índios;2093;1022;1071;104,8;40,7;10,7
2019;3543253;Ribeirão Grande;7514;3858;3656;94,8;36,5;22,5
2019;3543303;Ribeirão Pires;115918;56152;59766;106,4;37,3;1171,2
2019;3543402;Ribeirão Preto;678385;323442;354943;109,7;36,9;1042,2
2019;3543501;Riversul;5779;2909;2870;98,7;37,1;15
2019;3543600;Rifaina;3894;1947;1947;100;37,8;24
2019;3543709;Rincão;9519;4744;4775;100,7;36,8;30,1
2019;3543808;Rinópolis;9482;4723;4759;100,8;39,8;26,5
2019;3543907;Rio Claro;198629;96002;102627;106,9;37,4;398,5
2019;3544004;Rio das Pedras;31092;15548;15544;100;34,8;137,2
2019;3544103;Rio Grande da Serra;44489;21824;22665;103,9;34,2;1224,2
2019;3544202;Riolândia;10394;6263;4131;66;35,3;16,4
2019;3544251;Rosana;18220;9008;9212;102,3;37,4;24,5
2019;3544301;Roseira;10611;5329;5282;99,1;35,2;81,7
2019;3544400;Rubiácea;2729;1367;1362;99,6;35,9;11,5
2019;3544509;Rubinéia;3609;1785;1824;102,2;42,1;14,9
2019;3544608;Sabino;5219;2550;2669;104,7;40,1;17,1
2019;3544707;Sagres;2467;1193;1274;106,8;37,9;16,7
2019;3544806;Sales;6271;3108;3163;101,8;39,2;20,3
2019;3544905;Sales Oliveira;11261;5464;5797;106,1;37,6;36,8
2019;3545001;Salesópolis;15375;7660;7715;100,7;36,6;36,2
2019;3545100;Salmourão;4856;2453;2403;98;37,4;28,1
2019;3545159;Saltinho;7919;3892;4027;103,5;38,4;79,4
2019;3545209;Salto;127529;62617;64912;103,7;35,8;958,5
2019;3545308;Salto de Pirapora;43151;21424;21727;101,4;36,1;153,9
2019;3545407;Salto Grande;9053;4423;4630;104,7;37,8;48
2019;3545506;Sandovalina;3684;1853;1831;98,8;35,4;8,1
2019;3545605;Santa Adélia;14192;7019;7173;102,2;37,9;43
2019;3545704;Santa Albertina;6257;3130;3127;99,9;39,9;22,9
2019;3545803;Santa Bárbara d'Oeste;183963;90532;93431;103,2;37,3;678,8
2019;3546009;Santa Branca;14009;6980;7029;100,7;38,1;51,5
2019;3546108;Santa Clara d'Oeste;2479;1248;1231;98,6;38,3;13,5
2019;3546207;Santa Cruz da Conceição;4250;2086;2164;103,7;40,7;28,3
2019;3546256;Santa Cruz da Esperança;2109;1051;1058;100,7;37,6;14,2
2019;3546306;Santa Cruz das Palmeiras;29370;14637;14733;100,7;36,1;99,4
2019;3546405;Santa Cruz do Rio Pardo;46029;22428;23601;105,2;37,4;41,3
2019;3546504;Santa Ernestina;5993;3034;2959;97,5;34,9;44,6
2019;3546603;Santa Fé do Sul;33510;16128;17382;107,8;38,9;162,2
2019;3546702;Santa Gertrudes;23252;11741;11511;98;33,5;236,6
2019;3546801;Santa Isabel;52911;26240;26671;101,6;35,9;145,6
2019;3546900;Santa Lúcia;7537;3737;3800;101,7;36;49
2019;3547007;Santa Maria da Serra;5292;2671;2621;98,1;35,2;20,9
2019;3547106;Santa Mercedes;2953;1464;1489;101,7;37,6;17,7
2019;3547205;Santana da Ponte Pensa;1673;839;834;99,4;43,4;12,9
2019;3547304;Santana de Parnaíba;142706;69524;73182;105,3;34;793
2019;3547403;Santa Rita d'Oeste;2703;1325;1378;104;42,6;12,9
2019;3547502;Santa Rita do Passa Quatro;25387;12189;13198;108,3;41,2;33,7
2019;3547601;Santa Rosa de Viterbo;23745;11524;12221;106;38,2;82,3
2019;3547650;Santa Salete;1607;799;808;101,1;40,9;20,3
2019;3547700;Santo Anastácio;18714;9017;9697;107,5;39,7;33,8
2019;3547809;Santo André;736087;350203;385884;110,2;38,2;4187,5
2019;3547908;Santo Antônio da Alegria;6648;3406;3242;95,2;37,9;21,4
2019;3548005;Santo Antônio de Posse;22659;11348;11311;99,7;35,3;147
2019;3548054;Santo Antônio do Aracanguá;8294;4164;4130;99,2;37,5;6,3
2019;3548104;Santo Antônio do Jardim;6113;3088;3025;98;38,5;55,6
2019;3548203;Santo Antônio do Pinhal;7013;3523;3490;99,1;37,3;52,7
2019;3548302;Santo Expedito;2951;1452;1499;103,2;39,6;31,2
2019;3548401;Santópolis do Aguapeí;4049;2005;2044;101,9;35,8;31,6
2019;3548500;Santos;422919;192179;230740;120,1;41,4;1504,9
2019;3548609;São Bento do Sapucaí;11466;5708;5758;100,9;38,9;45,4
2019;3548708;São Bernardo do Campo;807403;385561;421842;109,4;36,7;1971,5
2019;3548807;São Caetano do Sul;162897;74606;88291;118,3;41,3;10625,5
2019;3548906;São Carlos;247799;120850;126949;105;37,2;218
2019;3549003;São Francisco;2691;1330;1361;102,3;41,5;35,6
2019;3549102;São João da Boa Vista;90807;43735;47072;107,6;38,7;175,8
2019;3549201;São João das Duas Pontes;2603;1285;1318;102,6;39,1;20,1
2019;3549250;São João de Iracema;1837;917;920;100,3;37,8;10,3
2019;3549300;São João do Pau d'Alho;2228;1100;1128;102,5;42;18,9
2019;3549409;São Joaquim da Barra;48399;23516;24883;105,8;37,1;117,8
2019;3549508;São José da Bela Vista;7880;3982;3898;97,9;34,6;28,5
2019;3549607;São José do Barreiro;3940;1981;1959;98,9;37,2;6,9
2019;3549706;São José do Rio Pardo;52511;25442;27069;106,4;38,6;125,1
2019;3549805;São José do Rio Preto;465315;222451;242864;109,2;37,8;1077,3
2019;3549904;São José dos Campos;684953;331274;353679;106,8;36;623
2019;3549953;São Lourenço da Serra;15624;7863;7761;98,7;35,7;83,8
2019;3550001;São Luiz do Paraitinga;10443;5283;5160;97,7;39,9;16,9
2019;3550100;São Manuel;37777;18500;19277;104,2;36,9;58,1
2019;3550209;São Miguel Arcanjo;32155;16252;15903;97,9;35,6;34,6
2019;3550308;São Paulo;11509115;5425157;6083958;112,1;36,9;7565,8
2019;3550407;São Pedro;36787;17872;18915;105,8;38,7;60,2
2019;3550506;São Pedro do Turvo;7252;3675;3577;97,3;36,4;9,9
2019;3550605;São Roque;79816;39035;40781;104,5;37,2;260,1
2019;3550704;São Sebastião;79968;39323;40645;103,4;34;198,7
2019;3550803;São Sebastião da Grama;10965;5503;5462;99,3;38,2;43,4
2019;3550902;São Simão;13793;6784;7009;103,3;38,5;22,3
2019;3551009;São Vicente;334187;160820;173367;107,8;36,2;2255,7
2019;3551108;Sarapuí;10068;5099;4969;97,5;36,1;28,6
2019;3551207;Sarutaiá;3704;1849;1855;100,3;36,9;26,2
2019;3551306;Sebastianópolis do Sul;3135;1522;1613;106;39,2;18,7
2019;3551405;Serra Azul;12401;7840;4561;58,2;35,5;43,8
2019;3551504;Serrana;42929;21199;21730;102,5;33,6;340,6
2019;3551603;Serra Negra;29223;14129;15094;106,8;39,9;143,4
2019;3551702;Sertãozinho;123460;60274;63186;104,8;35,4;306,3
2019;3551801;Sete Barras;12870;6558;6312;96,2;35,9;12,1
2019;3551900;Severínia;14978;7713;7265;94,2;35,2;106,6
2019;3552007;Silveiras;6114;3054;3060;100,2;36,6;14,7
2019;3552106;Socorro;39470;19436;20034;103,1;40;87,9
2019;3552205;Sorocaba;692712;335810;356902;106,3;35,9;1539,8
2019;3552304;Sud Mennucci;7413;3689;3724;100,9;37,3;12,5
2019;3552403;Sumaré;271650;133349;138301;103,7;34,5;1770,1
2019;3552502;Suzano;297610;144443;153167;106;34,1;1443,1
2019;3552551;Suzanápolis;3442;1764;1678;95,1;38,2;10,4
2019;3552601;Tabapuã;11445;5674;5771;101,7;39,3;33,1
2019;3552700;Tabatinga;14824;7389;7435;100,6;36,2;40,2
2019;3552809;Taboão da Serra;268919;127867;141052;110,3;34,5;13190,2
2019;3552908;Taciba;6157;3032;3125;103,1;36,1;10,1
2019;3553005;Taguaí;12271;6076;6195;102;34,2;84,4
2019;3553104;Taiaçu;5777;2927;2850;97,4;37,7;54
2019;3553203;Taiúva;6311;3454;2857;82,7;38,5;47,6
2019;3553302;Tambaú;21857;10773;11084;102,9;37,5;38,9
2019;3553401;Tanabi;25113;12403;12710;102,5;38,9;33,6
2019;3553500;Tapiraí;8032;4041;3991;98,8;35;10,6
2019;3553609;Tapiratiba;12142;5917;6225;105,2;38,5;54,7
2019;3553658;Taquaral;2685;1331;1354;101,7;37,7;49,8
2019;3553708;Taquaritinga;53152;25941;27211;104,9;37,9;89,4
2019;3553807;Taquarituba;24003;12302;11701;95,1;36,2;53,5
2019;3553856;Taquarivaí;6448;3271;3177;97,1;32,7;27,8
2019;3553906;Tarabai;6623;3267;3356;102,7;35,6;32,9
2019;3553955;Tarumã;14506;7260;7246;99,8;34,7;47,9
2019;3554003;Tatuí;120472;58993;61479;104,2;35,7;230
2019;3554102;Taubaté;304815;147496;157319;106,7;36,7;487,7
2019;3554201;Tejupá;4347;2217;2130;96,1;35,4;14,7
2019;3554300;Teodoro Sampaio;22148;10945;11203;102,4;35,1;14,2
2019;3554409;Terra Roxa;8149;4082;4067;99,6;37,5;36,8
2019;3554508;Tietê;37639;18574;19065;102,6;37,4;93,1
2019;3554607;Timburi;2544;1278;1266;99,1;40;12,9
2019;3554656;Torre de Pedra;2112;1077;1035;96,1;39,3;29,6
2019;3554706;Torrinha;9335;4670;4665;99,9;39,1;29,6
2019;3554755;Trabiju;1644;826;818;99;35;25,9
2019;3554805;Tremembé;48936;26083;22853;87,6;35,8;256,1
2019;3554904;Três Fronteiras;6489;3250;3239;99,7;39,1;42,8
2019;3554953;Tuiuti;6626;3331;3295;98,9;40,1;52,3
2019;3555000;Tupã;64340;30839;33501;108,6;39,7;102,5
2019;3555109;Tupi Paulista;15548;7982;7566;94,8;41,3;63,5
2019;3555208;Turiúba;1857;940;917;97,6;41,4;12,1
2019;3555307;Turmalina;1761;864;897;103,8;45;11,9
2019;3555356;Ubarana;5392;2760;2632;95,4;34,5;25,7
2019;3555406;Ubatuba;89421;44254;45167;102,1;35,1;126,3
2019;3555505;Ubirajara;4973;2571;2402;93,4;35,5;17,6
2019;3555604;Uchoa;10234;5044;5190;102,9;39,2;40,5
2019;3555703;União Paulista;1624;813;811;99,8;35,2;20,5
2019;3555802;Urânia;8897;4376;4521;103,3;40,1;42,5
2019;3555901;Uru;1378;684;694;101,5;39,7;9,4
2019;3556008;Urupês;13534;6665;6869;103,1;39,8;41,8
2019;3556107;Valentim Gentil;13403;6690;6713;100,3;36,4;89,5
2019;3556206;Valinhos;122060;59648;62412;104,6;38,1;821,7
2019;3556305;Valparaíso;24038;13338;10700;80,2;35,7;28
2019;3556354;Vargem;10105;5158;4947;95,9;36,6;70,9
2019;3556404;Vargem Grande do Sul;40156;19802;20354;102,8;37,1;150,3
2019;3556453;Vargem Grande Paulista;48905;23993;24912;103,8;35;1151
2019;3556503;Várzea Paulista;114645;56916;57729;101,4;34,4;3264,4
2019;3556602;Vera Cruz;10415;5098;5317;104,3;39,3;42
2019;3556701;Vinhedo;73661;35999;37662;104,6;37,1;910
2019;3556800;Viradouro;17524;8695;8829;101,5;36,4;80,5
2019;3556909;Vista Alegre do Alto;7805;3960;3845;97,1;34,7;81,8
2019;3556958;Vitória Brasil;1800;923;877;95;38,5;36,1
2019;3557006;Votorantim;123769;60634;63135;104,1;35;672
2019;3557105;Votuporanga;94018;45462;48556;106,8;38,4;223,5
2019;3557154;Zacarias;2635;1318;1317;99,9;38,3;8,3
2019;3557204;Chavantes;12324;6021;6303;104,7;36,9;65,3
2019;3557303;Estiva Gerbi;11014;5519;5495;99,6;35,7;148,5
2020;3500105;Adamantina;34717;16732;17985;107,5;40,5;84,3
2020;3500204;Adolfo;4234;2096;2138;102;39,1;20,1
2020;3500303;Aguaí;32270;16023;16247;101,4;36,3;68
2020;3500402;Águas da Prata;7437;3583;3854;107,6;42;52,1
2020;3500501;Águas de Lindóia;17960;8746;9214;105,4;40,2;298,7
2020;3500550;Águas de Santa Bárbara;6955;3463;3492;100,8;38,6;17,2
2020;3500600;Águas de São Pedro;2783;1301;1482;113,9;44,9;770,5
2020;3500709;Agudos;37372;18347;19025;103,7;36,3;38,7
2020;3500758;Alambari;5957;2999;2958;98,6;36;37,3
2020;3500808;Alfredo Marcondes;4380;2190;2190;100;40,7;36,8
2020;3500907;Altair;3541;1825;1716;94;36,3;11,3
2020;3501004;Altinópolis;16691;8250;8441;102,3;37,8;18
2020;3501103;Alto Alegre;3962;1994;1968;98,7;42;12,4
2020;3501152;Alumínio;17350;8643;8707;100,7;35,1;207,5
2020;3501202;Álvares Florence;3943;2003;1940;96,9;43;10,9
2020;3501301;Álvares Machado;26790;13040;13750;105,4;37;77,1
2020;3501400;Álvaro de Carvalho;4812;3196;1616;50,6;36,2;31,3
2020;3501509;Alvinlândia;2934;1444;1490;103,2;36,6;34,6
2020;3501608;Americana;233914;113183;120731;106,7;38,4;1746,8
2020;3501707;Américo Brasiliense;33552;16629;16923;101,8;35;272,9
2020;3501806;Américo de Campos;5898;2870;3028;105,5;40,3;23,3
2020;3501905;Amparo;68032;33140;34892;105,3;38,9;152,8
2020;3502002;Analândia;4564;2303;2261;98,2;37,1;14
2020;3502101;Andradina;59431;29478;29953;101,6;38,7;61,6
2020;3502200;Angatuba;23808;11966;11842;99;36,4;23,2
2020;3502309;Anhembi;5697;2900;2797;96,4;36;7,7
2020;3502408;Anhumas;3989;1950;2039;104,6;37,8;12,4
2020;3502507;Aparecida;33316;16003;17313;108,2;37,8;275,6
2020;3502606;Aparecida d'Oeste;4181;2075;2106;101,5;41,8;23,4
2020;3502705;Apiaí;24924;12466;12458;99,9;35,7;25,6
2020;3502754;Araçariguama;20799;10463;10336;98,8;33,3;143,2
2020;3502804;Araçatuba;198405;94545;103860;109,9;38,6;170
2020;3502903;Araçoiaba da Serra;31718;15779;15939;101;38,9;124,2
2020;3503000;Aramina;5419;2648;2771;104,6;38,5;26,7
2020;3503109;Arandu;6774;3403;3371;99,1;36,1;23,7
2020;3503158;Arapeí;2379;1183;1196;101,1;38,7;15,2
2020;3503208;Araraquara;237621;114072;123549;108,3;38,1;236,8
2020;3503307;Araras;129401;62843;66558;105,9;37,7;200,7
2020;3503356;Arco-Íris;2030;1026;1004;97,9;38,6;7,7
2020;3503406;Arealva;8104;4055;4049;99,9;40,7;16
2020;3503505;Areias;3610;1820;1790;98,4;36,8;11,8
2020;3503604;Areiópolis;10280;5208;5072;97,4;34,5;119,7
2020;3503703;Ariranha;7790;3878;3912;100,9;38,9;58,7
2020;3503802;Artur Nogueira;50367;24863;25504;102,6;35,4;282,9
2020;3503901;Arujá;85004;41391;43613;105,4;34,9;883,9
2020;3503950;Aspásia;1846;926;920;99,4;40,4;26,6
2020;3504008;Assis;101081;48762;52319;107,3;38,2;219,5
2020;3504107;Atibaia;153965;74751;79214;106;37,3;321,8
2020;3504206;Auriflama;13889;6867;7022;102,3;39,6;32
2020;3504305;Avaí;4572;2269;2303;101,5;36,8;8,5
2020;3504404;Avanhandava;11353;6255;5098;81,5;35;33,6
2020;3504503;Avaré;91713;45435;46278;101,9;36,8;75,6
2020;3504602;Bady Bassitt;25074;12318;12756;103,6;35,5;227,2
2020;3504701;Balbinos;3828;3121;707;22,7;36,7;41,8
2020;3504800;Bálsamo;9415;4584;4831;105,4;39,3;62,8
2020;3504909;Bananal;10055;4900;5155;105,2;38,1;16,3
2020;3505005;Barão de Antonina;3460;1725;1735;100,6;37,2;22,6
2020;3505104;Barbosa;5844;2876;2968;103,2;37,1;28,5
2020;3505203;Bariri;31787;15621;16166;103,5;38,3;71,5
2020;3505302;Barra Bonita;34707;16754;17953;107,2;40;231,2
2020;3505351;Barra do Chapéu;5213;2712;2501;92,2;34,9;12,9
2020;3505401;Barra do Turvo;7074;3612;3462;95,8;36,6;7
2020;3505500;Barretos;121296;58263;63033;108,2;37,5;77,4
2020;3505609;Barrinha;31688;15676;16012;102,1;33,4;217
2020;3505708;Barueri;305548;146333;159215;108,8;34;4650,6
2020;3505807;Bastos;21472;10501;10971;104,5;37,7;125,6
2020;3505906;Batatais;58344;28392;29952;105,5;38,2;68,7
2020;3506003;Bauru;375179;181488;193691;106,7;37,4;561,9
2020;3506102;Bebedouro;76719;37171;39548;106,4;38,3;112,3
2020;3506201;Bento de Abreu;2642;1328;1314;98,9;36,5;8,8
2020;3506300;Bernardino de Campos;11549;6015;5534;92;38,6;47,3
2020;3506359;Bertioga;61581;30696;30885;100,6;33,8;125,3
2020;3506409;Bilac;7357;3611;3746;103,7;39,9;46,6
2020;3506508;Birigui;118119;57230;60889;106,4;37,9;222,9
2020;3506607;Biritiba Mirim;29692;14819;14873;100,4;36;93,5
2020;3506706;Boa Esperança do Sul;13122;6497;6625;102;35,5;19
2020;3506805;Bocaina;11282;5536;5746;103,8;37,1;31
2020;3506904;Bofete;10386;5281;5105;96,7;38,5;15,9
2020;3507001;Boituva;59146;29237;29909;102,3;35,9;237,6
2020;3507100;Bom Jesus dos Perdões;21693;10770;10923;101,4;35,5;200,2
2020;3507159;Bom Sucesso de Itararé;3557;1815;1742;96;32,3;26,6
2020;3507209;Borá;907;453;454;100,2;37;7,6
2020;3507308;Boracéia;4649;2361;2288;96,9;35,4;38,1
2020;3507407;Borborema;14373;7142;7231;101,2;39,6;26
2020;3507456;Borebi;2658;1295;1363;105,3;34,2;7,6
2020;3507506;Botucatu;142748;68760;73988;107,6;37,3;96,3
2020;3507605;Bragança Paulista;172439;83780;88659;105,8;37,3;336,4
2020;3507704;Braúna;5334;2632;2702;102,7;38,1;27,3
2020;3507753;Brejo Alegre;2585;1312;1273;97;38,2;24,5
2020;3507803;Brodowski;24617;12087;12530;103,7;36,8;88,4
2020;3507902;Brotas;23621;11512;12109;105,2;37,6;21,4
2020;3508009;Buri;20124;10117;10007;98,9;33,6;16,8
2020;3508108;Buritama;17046;8314;8732;105;39,2;52,1
2020;3508207;Buritizal;4332;2132;2200;103,2;38,4;16,3
2020;3508306;Cabrália Paulista;4363;2214;2149;97,1;36,5;18,2
2020;3508405;Cabreúva;46223;22974;23249;101,2;33,9;177,6
2020;3508504;Caçapava;94911;46554;48357;103,9;36,7;257,2
2020;3508603;Cachoeira Paulista;31528;15261;16267;106,6;37,3;109,5
2020;3508702;Caconde;17453;8681;8772;101;38,6;37,3
2020;3508801;Cafelândia;16773;8127;8646;106,4;38;18,2
2020;3508900;Caiabu;3795;1908;1887;98,9;39,7;15
2020;3509007;Caieiras;94169;45689;48480;106,1;35,3;964,4
2020;3509106;Caiuá;5408;3186;2222;69,7;38,2;9,8
2020;3509205;Cajamar;88048;43293;44755;103,4;33;670,1
2020;3509254;Cajati;28693;14432;14261;98,8;34,5;63,1
2020;3509304;Cajobi;9289;4629;4660;100,7;39;52,5
2020;3509403;Cajuru;23892;11881;12011;101,1;36,6;36,2
2020;3509452;Campina do Monte Alegre;5929;2993;2936;98,1;36,9;32,1
2020;3509502;Campinas;1136851;543194;593657;109,3;37,7;1430,8
2020;3509601;Campo Limpo Paulista;77654;37964;39690;104,5;35,7;978
2020;3509700;Campos do Jordão;47378;23149;24229;104,7;35,5;163,4
2020;3509809;Campos Novos Paulista;4854;2455;2399;97,7;36,7;10
2020;3509908;Cananéia;12346;6060;6286;103,7;36,9;10
2020;3509957;Canas;4858;2425;2433;100,3;33,9;91,2
2020;3510005;Cândido Mota;29781;14494;15287;105,5;38,4;50
2020;3510104;Cândido Rodrigues;2858;1418;1440;101,6;41,2;40,3
2020;3510153;Canitar;5959;2939;3020;102,8;32,4;103,7
2020;3510203;Capão Bonito;46652;23138;23514;101,6;35,7;28,4
2020;3510302;Capela do Alto;22024;11941;10083;84,4;34,8;129,6
2020;3510401;Capivari;50074;24634;25440;103,3;36,2;155,1
2020;3510500;Caraguatatuba;129657;63247;66410;105;35,9;267,4
2020;3510609;Carapicuíba;387497;186573;200924;107,7;34,5;11216,9
2020;3510708;Cardoso;11564;5661;5903;104,3;40,8;18,1
2020;3510807;Casa Branca;28315;14727;13588;92,3;37,9;32,8
2020;3510906;Cássia dos Coqueiros;2799;1442;1357;94,1;39,9;14,6
2020;3511003;Castilho;19839;9791;10048;102,6;37,5;18,6
2020;3511102;Catanduva;116021;55703;60318;108,3;39;399,3
2020;3511201;Catiguá;7075;3547;3528;99,5;37,7;47,7
2020;3511300;Cedral;11818;5841;5977;102,3;37,8;59,7
2020;3511409;Cerqueira César;20942;10799;10143;93,9;36,1;40,9
2020;3511508;Cerquilho;44087;21539;22548;104,7;37,3;345
2020;3511607;Cesário Lange;18548;9531;9017;94,6;35,9;97,4
2020;3511706;Charqueada;15533;7771;7762;99,9;36,2;88,3
2020;3511904;Clementina;7048;3521;3527;100,2;35,7;41,8
2020;3512001;Colina;18368;8924;9444;105,8;37,3;43,5
2020;3512100;Colômbia;6604;3325;3279;98,6;36,1;9,1
2020;3512209;Conchal;27772;13879;13893;100,1;34,7;151,9
2020;3512308;Conchas;15508;7772;7736;99,5;38,5;33,3
2020;3512407;Cordeirópolis;24061;11910;12151;102;35,6;174,9
2020;3512506;Coroados;5427;2695;2732;101,4;38,1;22
2020;3512605;Coronel Macedo;4467;2260;2207;97,7;38,6;14,7
2020;3512704;Corumbataí;4168;2092;2076;99,2;36,2;15
2020;3512803;Cosmópolis;59931;29507;30424;103,1;35,8;387,5
2020;3512902;Cosmorama;8487;4232;4255;100,5;39,2;19,2
2020;3513009;Cotia;263097;127741;135356;106;34,2;812
2020;3513108;Cravinhos;33241;16403;16838;102,7;37;106,7
2020;3513207;Cristais Paulista;9025;4491;4534;101;36,4;23,4
2020;3513306;Cruzália;2154;1063;1091;102,6;40,6;14,4
2020;3513405;Cruzeiro;75860;36501;39359;107,8;37,7;248,2
2020;3513504;Cubatão;114483;55341;59142;106,9;34,6;801,3
2020;3513603;Cunha;22203;11298;10905;96,5;38,6;15,8
2020;3513702;Descalvado;31845;15634;16211;103,7;38,6;42,3
2020;3513801;Diadema;395653;189352;206301;109;35,2;12874,3
2020;3513850;Dirce Reis;1632;844;788;93,4;40,9;18,5
2020;3513900;Divinolândia;11265;5589;5676;101,6;40,2;50,3
2020;3514007;Dobrada;8662;4330;4332;100;34,1;57,9
2020;3514106;Dois Córregos;24746;12233;12513;102,3;37,1;39,1
2020;3514205;Dolcinópolis;2190;1106;1084;98;40,4;28,1
2020;3514304;Dourado;8254;4094;4160;101,6;39,7;40,1
2020;3514403;Dracena;45455;22313;23142;103,7;39,9;93,2
2020;3514502;Duartina;12366;6039;6327;104,8;40,2;46,7
2020;3514601;Dumont;9232;4594;4638;101;35,4;82,9
2020;3514700;Echaporã;6269;3085;3184;103,2;37,8;12,2
2020;3514809;Eldorado;13442;6768;6674;98,6;35,2;8,1
2020;3514908;Elias Fausto;17467;8812;8655;98,2;35,4;86,3
2020;3514924;Elisiário;3159;1600;1559;97,4;38,4;33,6
2020;3514957;Embaúba;2365;1209;1156;95,6;39,3;28,4
2020;3515004;Embu das Artes;251078;121123;129955;107,3;33,6;3566,6
2020;3515103;Embu-Guaçu;66851;32964;33887;102,8;35;429,5
2020;3515129;Emilianópolis;3055;1524;1531;100,5;40,6;13,6
2020;3515152;Engenheiro Coelho;18925;9565;9360;97,9;32,8;172,1
2020;3515186;Espírito Santo do Pinhal;40377;19609;20768;105,9;39,3;103,7
2020;3515194;Espírito Santo do Turvo;4186;2097;2089;99,6;34;21,6
2020;3515202;Estrela d'Oeste;9231;4674;4557;97,5;38,8;31,2
2020;3515301;Estrela do Norte;2729;1351;1378;102;37;10,3
2020;3515350;Euclides da Cunha Paulista;8275;4088;4187;102,4;37,2;14,4
2020;3515400;Fartura;16512;8043;8469;105,3;38,3;38,5
2020;3515509;Fernandópolis;70488;33953;36535;107,6;39,2;128,2
2020;3515608;Fernando Prestes;5881;2892;2989;103,4;40,4;34,6
2020;3515657;Fernão;1644;840;804;95,7;37,9;16,4
2020;3515707;Ferraz de Vasconcelos;178385;86415;91970;106,4;33,7;6037,3
2020;3515806;Flora Rica;1548;771;777;100,8;43,1;6,9
2020;3515905;Floreal;2809;1376;1433;104,1;43,9;13,8
2020;3516002;Flórida Paulista;13022;7133;5889;82,6;38,2;24,8
2020;3516101;Florínea;3721;2299;1422;61,9;38,1;16,5
2020;3516200;Franca;348988;169376;179612;106;36,6;576,2
2020;3516309;Francisco Morato;164181;80520;83661;103,9;32,6;3350,6
2020;3516408;Franco da Rocha;143204;72182;71022;98,4;33,9;1078,5
2020;3516507;Gabriel Monteiro;2792;1393;1399;100,4;40,2;20,1
2020;3516606;Gália;6557;3223;3334;103,4;40,3;18,4
2020;3516705;Garça;42573;20545;22028;107,2;38,6;76,6
2020;3516804;Gastão Vidigal;3444;1688;1756;104;38,9;19,1
2020;3516853;Gavião Peixoto;4682;2340;2342;100,1;35,1;19,2
2020;3516903;General Salgado;10458;5183;5275;101,8;40,1;21,2
2020;3517000;Getulina;10398;5688;4710;82,8;38,4;15,4
2020;3517109;Glicério;4249;2084;2165;103,9;39;15,6
2020;3517208;Guaiçara;11196;5547;5649;101,8;35,9;40,4
2020;3517307;Guaimbê;5549;2753;2796;101,6;37,5;25,5
2020;3517406;Guaíra;39181;19135;20046;104,8;37,4;31,1
2020;3517505;Guapiaçu;21118;10496;10622;101,2;36,5;65
2020;3517604;Guapiara;17439;8846;8593;97,1;36,7;42,7
2020;3517703;Guará;18969;9294;9675;104,1;36,1;52,4
2020;3517802;Guaraçaí;7693;3802;3891;102,3;41,6;13,5
2020;3517901;Guaraci;10364;5193;5171;99,6;37,5;16,2
2020;3518008;Guarani d'Oeste;1972;975;997;102,3;40,3;23
2020;3518107;Guarantã;6461;3197;3264;102,1;36,2;14
2020;3518206;Guararapes;31198;15213;15985;105,1;38,9;32,6
2020;3518305;Guararema;30474;15086;15388;102;36,7;112,5
2020;3518404;Guaratinguetá;117537;56342;61195;108,6;38,1;156,2
2020;3518503;Guareí;15024;9047;5977;66,1;36,4;26,5
2020;3518602;Guariba;37446;18182;19264;106;35,1;138,5
2020;3518701;Guarujá;290552;139938;150614;107,6;35,2;2006,7
2020;3518800;Guarulhos;1288992;621082;667910;107,5;34,7;4044,9
2020;3518859;Guatapará;7315;3695;3620;98;36,4;17,7
2020;3518909;Guzolândia;4375;2237;2138;95,6;37,6;17,3
2020;3519006;Herculândia;9099;4478;4621;103,2;37;25
2020;3519055;Holambra;14439;7197;7242;100,6;35,8;220,2
2020;3519071;Hortolândia;230155;114536;115619;100,9;34,3;3687,5
2020;3519105;Iacanga;10397;5185;5212;100,5;37,6;19
2020;3519204;Iacri;6226;3108;3118;100,3;39,1;19,3
2020;3519253;Iaras;7747;5206;2541;48,8;37,3;19,3
2020;3519303;Ibaté;32123;16093;16030;99,6;34,6;110,4
2020;3519402;Ibirá;11599;5691;5908;103,8;39;42,7
2020;3519501;Ibirarema;6495;3239;3256;100,5;38;28,5
2020;3519600;Ibitinga;59170;29057;30113;103,6;36,9;85,8
2020;3519709;Ibiúna;75341;37890;37451;98,8;36;71,2
2020;3519808;Icém;7834;4272;3562;83,4;37,1;21,6
2020;3519907;Iepê;7670;3729;3941;105,7;38,9;12,9
2020;3520004;Igaraçu do Tietê;23330;11617;11713;100,8;36,8;238,7
2020;3520103;Igarapava;26671;12927;13744;106,3;38;56,9
2020;3520202;Igaratá;10353;5209;5144;98,8;36,9;35,3
2020;3520301;Iguape;29294;14702;14592;99,3;38,3;14,8
2020;3520400;Ilhabela;33849;16822;17027;101,2;34,7;97,7
2020;3520426;Ilha Comprida;12788;6304;6484;102,9;40,9;65,1
2020;3520442;Ilha Solteira;25682;12460;13222;106,1;39,8;39,4
2020;3520509;Indaiatuba;247207;121104;126103;104,1;36,6;793,5
2020;3520608;Indiana;5086;2568;2518;98,1;38,5;39,3
2020;3520707;Indiaporã;4060;1985;2075;104,5;41,5;14,5
2020;3520806;Inúbia Paulista;3638;1798;1840;102,3;39;41,8
2020;3520905;Ipaussu;13791;6794;6997;103;36,6;65,8
2020;3521002;Iperó;35179;18874;16305;86,4;34,2;206,6
2020;3521101;Ipeúna;6743;3392;3351;98,8;35,6;35,5
2020;3521150;Ipiguá;6395;3222;3173;98,5;37,3;47
2020;3521200;Iporanga;4107;2077;2030;97,7;35,2;3,6
2020;3521309;Ipuã;14470;7222;7248;100,4;35,5;31
2020;3521408;Iracemápolis;21779;10832;10947;101,1;36,3;189,2
2020;3521507;Irapuã;6999;3552;3447;97;37,6;27,2
2020;3521606;Irapuru;7262;4178;3084;73,8;39,8;33,9
2020;3521705;Itaberá;18094;9072;9022;99,4;36,6;16,4
2020;3521804;Itaí;25146;13079;12067;92,3;35,8;23
2020;3521903;Itajobi;16608;8313;8295;99,8;38,8;33,1
2020;3522000;Itaju;3553;1790;1763;98,5;37,1;15,4
2020;3522109;Itanhaém;108918;52466;56452;107,6;38;181
2020;3522158;Itaoca;3404;1721;1683;97,8;37,3;18,6
2020;3522208;Itapecerica da Serra;158769;77871;80898;103,9;33,9;1053,2
2020;3522307;Itapetininga;156365;78066;78299;100,3;35,7;87,4
2020;3522406;Itapeva;90138;44279;45859;103,6;35,3;49,4
2020;3522505;Itapevi;228329;111468;116861;104,8;32,6;2762,3
2020;3522604;Itapira;71922;35300;36622;103,7;38,7;138,7
2020;3522653;Itapirapuã Paulista;4228;2183;2045;93,7;33,3;10,4
2020;3522703;Itápolis;39808;19532;20276;103,8;38,8;39,9
2020;3522802;Itaporanga;14282;7037;7245;103;37,7;28,1
2020;3522901;Itapuí;13359;6670;6689;100,3;35,4;95,4
2020;3523008;Itapura;4111;2076;2035;98;38,2;13,6
2020;3523107;Itaquaquecetuba;363192;177672;185520;104,4;32,7;4395,8
2020;3523206;Itararé;45447;22161;23286;105,1;36,3;45,3
2020;3523305;Itariri;15603;7768;7835;100,9;35,3;57
2020;3523404;Itatiba;118715;58185;60530;104;37;368,4
2020;3523503;Itatinga;19029;10017;9012;90;34,3;19,4
2020;3523602;Itirapina;16053;9452;6601;69,8;35,8;28,4
2020;3523701;Itirapuã;5818;2958;2860;96,7;36,1;36,1
2020;3523800;Itobi;7982;4064;3918;96,4;37,2;57,4
2020;3523909;Itu;166790;81644;85146;104,3;36,2;260,3
2020;3524006;Itupeva;66346;33322;33024;99,1;33,7;330,3
2020;3524105;Ituverava;37963;18368;19595;106,7;38,5;53,9
2020;3524204;Jaborandi;6337;3149;3188;101,2;37,8;23,2
2020;3524303;Jaboticabal;72238;34548;37690;109,1;38,6;102,2
2020;3524402;Jacareí;236981;114535;122446;106,9;36,7;510,4
2020;3524501;Jaci;7321;3702;3619;97,8;35,1;50,4
2020;3524600;Jacupiranga;16413;8175;8238;100,8;36,2;23,3
2020;3524709;Jaguariúna;57043;27793;29250;105,2;36;403,4
2020;3524808;Jales;48806;23642;25164;106,4;40;132,4
2020;3524907;Jambeiro;6242;3140;3102;98,8;37;33,8
2020;3525003;Jandira;117154;56869;60285;106;34;6714
2020;3525102;Jardinópolis;44167;22757;21410;94,1;35,6;88
2020;3525201;Jarinu;35331;17743;17588;99,1;35,1;170,2
2020;3525300;Jaú;133835;64799;69036;106,5;38,1;194,8
2020;3525409;Jeriquara;3741;1922;1819;94,6;33,9;26,4
2020;3525508;Joanópolis;12715;6432;6283;97,7;38,2;34
2020;3525607;João Ramalho;4378;2193;2185;99,6;35,4;10,5
2020;3525706;José Bonifácio;36137;17837;18300;102,6;37;42
2020;3525805;Júlio Mesquita;4310;2100;2210;105,2;36,8;33,6
2020;3525854;Jumirim;3029;1506;1523;101,1;35,3;53,4
2020;3525904;Jundiaí;432941;209098;223843;107,1;38;1004
2020;3526001;Junqueirópolis;20334;10652;9682;90,9;38,9;34,9
2020;3526100;Juquiá;17678;8874;8804;99,2;37,3;21,7
2020;3526209;Juquitiba;27869;14040;13829;98,5;35,6;53,4
2020;3526308;Lagoinha;5064;2564;2500;97,5;40,9;19,8
2020;3526407;Laranjal Paulista;26211;12811;13400;104,6;37,5;68,2
2020;3526506;Lavínia;9535;7018;2517;35,9;36,8;17,7
2020;3526605;Lavrinhas;7120;3545;3575;100,8;34,2;42,6
2020;3526704;Leme;97770;48142;49628;103,1;36,1;242,7
2020;3526803;Lençóis Paulista;65852;32488;33364;102,7;36,3;81,3
2020;3526902;Limeira;290850;141852;148998;105;37,5;500,9
2020;3527009;Lindóia;7006;3460;3546;102,5;38,5;143,7
2020;3527108;Lins;74797;35964;38833;108;38,3;131,2
2020;3527207;Lorena;84914;40708;44206;108,6;37,2;205
2020;3527256;Lourdes;1991;995;996;100,1;40,5;17,5
2020;3527306;Louveira;49409;24632;24777;100,6;33,5;886,4
2020;3527405;Lucélia;20162;11121;9041;81,3;39,6;64
2020;3527504;Lucianópolis;2363;1197;1166;97,4;38,3;12,5
2020;3527603;Luís Antônio;12113;6074;6039;99,4;34,2;20,2
2020;3527702;Luiziânia;4769;2398;2371;98,9;36,8;28,6
2020;3527801;Lupércio;4072;1987;2085;104,9;37,4;26,2
2020;3527900;Lutécia;2695;1339;1356;101,3;38;5,7
2020;3528007;Macatuba;16847;8348;8499;101,8;36,4;75
2020;3528106;Macaubal;7555;3772;3783;100,3;41,2;30,5
2020;3528205;Macedônia;3946;1958;1988;101,5;40,8;12
2020;3528304;Magda;3200;1575;1625;103,2;41,3;10,2
2020;3528403;Mairinque;49211;24718;24493;99,1;36;234,2
2020;3528502;Mairiporã;92021;45869;46152;100,6;36,1;286,9
2020;3528601;Manduri;9783;4853;4930;101,6;38,1;42,7
2020;3528700;Marabá Paulista;4624;2896;1728;59,7;36,7;5
2020;3528809;Maracaí;12886;6379;6507;102;37,7;24,2
2020;3528858;Marapoama;3209;1644;1565;95,2;37,9;28,8
2020;3528908;Mariápolis;3603;1806;1797;99,5;39,4;19,3
2020;3529005;Marília;235584;113057;122527;108,4;37,8;201,3
2020;3529104;Marinópolis;1907;968;939;97;40,2;24,5
2020;3529203;Martinópolis;24907;12829;12078;94,1;38;19,9
2020;3529302;Matão;79225;38943;40282;103,4;37,9;150,9
2020;3529401;Mauá;420973;203341;217632;107;35,3;6796,8
2020;3529500;Mendonça;5930;2989;2941;98,4;38,2;30,4
2020;3529609;Meridiano;4488;2194;2294;104,6;38,9;19,7
2020;3529658;Mesópolis;1944;981;963;98,2;37,8;13,1
2020;3529708;Miguelópolis;19777;9721;10056;103,4;36,2;24,1
2020;3529807;Mineiros do Tietê;11440;5678;5762;101,5;37,5;53,6
2020;3529906;Miracatu;19068;9522;9546;100,3;36,1;19
2020;3530003;Mira Estrela;3092;1544;1548;100,3;41,1;14,3
2020;3530102;Mirandópolis;28117;15883;12234;77;40,1;30,6
2020;3530201;Mirante do Paranapanema;16228;8111;8117;100,1;39,2;13,1
2020;3530300;Mirassol;61976;30099;31877;105,9;37,8;254,8
2020;3530409;Mirassolândia;4630;2331;2299;98,6;37,8;27,9
2020;3530508;Mococa;67992;33433;34559;103,4;38,7;79,5
2020;3530607;Mogi das Cruzes;443344;213756;229588;107,4;35,6;622,2
2020;3530706;Mogi Guaçu;151951;74264;77687;104,6;37,1;187
2020;3530805;Mogi Mirim;92246;44948;47298;105,2;38,3;185,3
2020;3530904;Mombuca;3662;1810;1852;102,3;34,7;27,4
2020;3531001;Monções;1997;1004;993;98,9;42;19,1
2020;3531100;Mongaguá;59605;30234;29371;97,1;38,5;417,5
2020;3531209;Monte Alegre do Sul;8422;4163;4259;102,3;40,4;76,3
2020;3531308;Monte Alto;47699;23362;24337;104,2;39,3;137,5
2020;3531407;Monte Aprazível;22318;10933;11385;104,1;39,2;45
2020;3531506;Monte Azul Paulista;18389;9205;9184;99,8;39,1;69,8
2020;3531605;Monte Castelo;4216;2096;2120;101,1;39,5;18,1
2020;3531704;Monteiro Lobato;4139;2077;2062;99,3;38,4;12,4
2020;3531803;Monte Mor;62242;30758;31484;102,4;34,2;258,7
2020;3531902;Morro Agudo;28401;14008;14393;102,7;35,3;20,5
2020;3532009;Morungaba;13465;6610;6855;103,7;36,1;91,8
2020;3532058;Motuca;4120;2086;2034;97,5;37,1;18
2020;3532108;Murutinga do Sul;3840;1907;1933;101,4;42,1;15,3
2020;3532157;Nantes;2677;1323;1354;102,3;35,2;9,3
2020;3532207;Narandiba;5475;2725;2750;100,9;34,1;15,3
2020;3532306;Natividade da Serra;6971;3631;3340;92;39,9;8,4
2020;3532405;Nazaré Paulista;17988;9146;8842;96,7;37,6;55,1
2020;3532504;Neves Paulista;9596;4754;4842;101,9;41;43,8
2020;3532603;Nhandeara;10090;4870;5220;107,2;42,1;23,1
2020;3532702;Nipoã;4712;2426;2286;94,2;35,6;34,2
2020;3532801;Nova Aliança;6584;3243;3341;103;37,9;30,3
2020;3532827;Nova Campina;8551;4283;4268;99,6;32,8;22,2
2020;3532843;Nova Canaã Paulista;2055;1027;1028;100,1;43,7;16,5
2020;3532868;Nova Castilho;1087;540;547;101,3;37,5;5,9
2020;3532900;Nova Europa;9361;4688;4673;99,7;36,3;58,4
2020;3533007;Nova Granada;19449;9658;9791;101,4;37,7;36,6
2020;3533106;Nova Guataporanga;2169;1070;1099;102,7;40,2;63,5
2020;3533205;Nova Independência;4384;2365;2019;85,4;34,6;16,5
2020;3533254;Novais;4460;2271;2189;96,4;33,9;37,9
2020;3533304;Nova Luzitânia;2973;1504;1469;97,7;38,4;40,3
2020;3533403;Nova Odessa;60497;29635;30862;104,1;37;819,9
2020;3533502;Novo Horizonte;38356;18928;19428;102,6;38,2;41,2
2020;3533601;Nuporanga;7333;3630;3703;102;37,4;21,1
2020;3533700;Ocauçu;4307;2199;2108;95,9;37,7;14,3
2020;3533809;Óleo;2561;1297;1264;97,5;39,8;12,9
2020;3533908;Olímpia;54572;26578;27994;105,3;37,6;68
2020;3534005;Onda Verde;4633;2339;2294;98,1;35,9;19,1
2020;3534104;Oriente;6146;2961;3185;107,6;39,6;28,1
2020;3534203;Orindiúva;6000;2997;3003;100,2;35;24,3
2020;3534302;Orlândia;38805;18786;20019;106,6;37,8;133
2020;3534401;Osasco;723768;344936;378832;109,8;35,8;11142,8
2020;3534500;Oscar Bressane;2507;1213;1294;106,7;42,1;11,3
2020;3534609;Osvaldo Cruz;31343;15623;15720;100,6;40,2;126,4
2020;3534708;Ourinhos;104718;49992;54726;109,5;37,8;354
2020;3534757;Ouroeste;10090;4978;5112;102,7;37,8;35
2020;3534807;Ouro Verde;7820;3778;4042;107;36,6;29,3
2020;3534906;Pacaembu;14660;9503;5157;54,3;38,9;43,2
2020;3535002;Palestina;11435;5711;5724;100,2;38,8;16,4
2020;3535101;Palmares Paulista;9899;5010;4889;97,6;34,5;120,5
2020;3535200;Palmeira d'Oeste;9072;4524;4548;100,5;42,2;28,5
2020;3535309;Palmital;20060;9765;10295;105,4;39,9;36,6
2020;3535408;Panorama;15052;7456;7596;101,9;36;42,3
2020;3535507;Paraguaçu Paulista;41657;20811;20846;100,2;37,4;41,6
2020;3535606;Paraibuna;17707;8956;8751;97,7;37,9;21,9
2020;3535705;Paraíso;6118;3084;3034;98,4;38,8;39,4
2020;3535804;Paranapanema;19184;9745;9439;96,9;35;18,8
2020;3535903;Paranapuã;4020;2011;2009;99,9;37,9;28,6
2020;3536000;Parapuã;10699;5323;5376;101;40,3;29,2
2020;3536109;Pardinho;6954;3523;3431;97,4;35,7;33,1
2020;3536208;Pariquera-Açu;19235;9525;9710;101,9;36,5;53,5
2020;3536257;Parisi;2769;1348;1421;105,4;39,3;32,7
2020;3536307;Patrocínio Paulista;14339;7230;7109;98,3;35,7;23,8
2020;3536406;Paulicéia;7731;3910;3821;97,7;35,9;20,7
2020;3536505;Paulínia;105984;51612;54372;105,3;35,5;763,7
2020;3536570;Paulistânia;2041;1021;1020;99,9;37,1;8
2020;3536604;Paulo de Faria;7678;3854;3824;99,2;38,9;10,4
2020;3536703;Pederneiras;44485;22140;22345;100,9;36,5;61,1
2020;3536802;Pedra Bela;6428;3343;3085;92,3;39,1;40,5
2020;3536901;Pedranópolis;2776;1394;1382;99,1;41,8;10,7
2020;3537008;Pedregulho;15656;7860;7796;99,2;36,6;22
2020;3537107;Pedreira;43036;21124;21912;103,7;37,8;395,5
2020;3537156;Pedrinhas Paulista;2848;1396;1452;104;39,9;18,7
2020;3537206;Pedro de Toledo;11154;5700;5454;95,7;37,3;16,6
2020;3537305;Penápolis;61587;29711;31876;107,3;38,6;86,6
2020;3537404;Pereira Barreto;24483;11881;12602;106,1;39,1;25,1
2020;3537503;Pereiras;8556;4280;4276;99,9;37,1;38,3
2020;3537602;Peruíbe;67365;32543;34822;107;38,2;206,5
2020;3537701;Piacatu;5536;2762;2774;100,4;38,9;23,8
2020;3537800;Piedade;53126;26738;26388;98,7;37,5;71,1
2020;3537909;Pilar do Sul;27552;13947;13605;97,5;36,4;40,4
2020;3538006;Pindamonhangaba;163030;79199;83831;105,8;36;222,9
2020;3538105;Pindorama;14699;7348;7351;100;39,6;79,5
2020;3538204;Pinhalzinho;14961;7456;7505;100,7;39,4;96,8
2020;3538303;Piquerobi;3320;1587;1733;109,2;39,6;6,9
2020;3538501;Piquete;12910;6189;6721;108,6;39,6;73,4
2020;3538600;Piracaia;26049;12754;13295;104,2;38,8;67,6
2020;3538709;Piracicaba;415361;201351;214010;106,3;37,2;301,4
2020;3538808;Piraju;29450;14254;15196;106,6;38,5;58,4
2020;3538907;Pirajuí;22682;11973;10709;89,4;38,3;27,5
2020;3539004;Pirangi;10902;5453;5449;99,9;39,3;50,5
2020;3539103;Pirapora do Bom Jesus;17961;8918;9043;101,4;32,5;165,6
2020;3539202;Pirapozinho;25381;12355;13026;105,4;37,7;53,1
2020;3539301;Pirassununga;73423;35493;37930;106,9;38,5;101
2020;3539400;Piratininga;14670;7156;7514;105;37,8;36,5
2020;3539509;Pitangueiras;34220;17097;17123;100,2;35;79,5
2020;3539608;Planalto;4444;2217;2227;100,5;37;15,3
2020;3539707;Platina;3088;1568;1520;96,9;37,2;9,4
2020;3539806;Poá;105093;50504;54589;108,1;35,6;6087,5
2020;3539905;Poloni;5584;2738;2846;103,9;39,4;41,3
2020;3540002;Pompéia;20276;9923;10353;104,3;38,4;25,8
2020;3540101;Pongaí;3443;1742;1701;97,6;40,8;18,8
2020;3540200;Pontal;38265;19393;18872;97,3;33,7;107,4
2020;3540259;Pontalinda;4132;2208;1924;87,1;36,4;19,7
2020;3540309;Pontes Gestal;2420;1203;1217;101,2;39,4;11,1
2020;3540408;Populina;4193;2072;2121;102,4;40,3;13,3
2020;3540507;Porangaba;10155;5186;4969;95,8;40,4;38,2
2020;3540606;Porto Feliz;55462;28142;27320;97,1;36,8;99,6
2020;3540705;Porto Ferreira;52816;25796;27020;104,7;37,7;215,7
2020;3540754;Potim;20264;11416;8848;77,5;33,6;453,9
2020;3540804;Potirendaba;18052;8951;9101;101,7;38;52,7
2020;3540853;Pracinha;2611;1882;729;38,7;34,5;41,4
2020;3540903;Pradópolis;17238;8565;8673;101,3;36,2;103
2020;3541000;Praia Grande;336647;160096;176551;110,3;36,7;2249,5
2020;3541059;Pratânia;5071;2538;2533;99,8;33,7;29
2020;3541109;Presidente Alves;3888;1929;1959;101,6;39;13,6
2020;3541208;Presidente Bernardes;14433;7906;6527;82,6;40,5;19,3
2020;3541307;Presidente Epitácio;40097;19402;20695;106,7;37,9;31,8
2020;3541406;Presidente Prudente;224212;107327;116885;108,9;38,3;399,9
2020;3541505;Presidente Venceslau;35934;17473;18461;105,7;40,3;47,6
2020;3541604;Promissão;35535;17482;18053;103,3;37,4;45,6
2020;3541653;Quadra;3387;1741;1646;94,5;37,9;16,5
2020;3541703;Quatá;13157;6551;6606;100,8;36,6;20,2
2020;3541802;Queiroz;3172;1593;1579;99,1;34,4;13,5
2020;3541901;Queluz;9543;4761;4782;100,4;35,9;38,3
2020;3542008;Quintana;6876;3359;3517;104,7;36,8;21,6
2020;3542107;Rafard;8924;4409;4515;102,4;36,8;73,4
2020;3542206;Rancharia;28819;13961;14858;106,4;38,1;18,2
2020;3542305;Redenção da Serra;4429;2315;2114;91,3;39,7;14,3
2020;3542404;Regente Feijó;20001;9856;10145;102,9;38,2;76
2020;3542503;Reginópolis;7606;4727;2879;60,9;35,9;18,5
2020;3542602;Registro;59436;29456;29980;101,8;36,4;82,3
2020;3542701;Restinga;6467;3216;3251;101,1;34,9;26,3
2020;3542800;Ribeira;3189;1633;1556;95,3;37,5;9,5
2020;3542909;Ribeirão Bonito;11278;5598;5680;101,5;37,2;23,9
2020;3543006;Ribeirão Branco;18671;9521;9150;96,1;33,4;26,8
2020;3543105;Ribeirão Corrente;4585;2306;2279;98,8;34,7;30,9
2020;3543204;Ribeirão do Sul;4653;2336;2317;99,2;39,6;22,9
2020;3543238;Ribeirão dos Índios;2075;1013;1062;104,8;41;10,6
2020;3543253;Ribeirão Grande;7504;3853;3651;94,8;37;22,5
2020;3543303;Ribeirão Pires;116020;56127;59893;106,7;37,7;1172,3
2020;3543402;Ribeirão Preto;685678;326669;359009;109,9;37,2;1053,4
2020;3543501;Riversul;5749;2898;2851;98,4;37,4;14,9
2020;3543600;Rifaina;3957;1979;1978;99,9;38,1;24,3
2020;3543709;Rincão;9397;4680;4717;100,8;37,3;29,7
2020;3543808;Rinópolis;9422;4679;4743;101,4;40,1;26,3
2020;3543907;Rio Claro;199806;96489;103317;107,1;37,7;400,9
2020;3544004;Rio das Pedras;31199;15587;15612;100,2;35,2;137,6
2020;3544103;Rio Grande da Serra;44437;21761;22676;104,2;34,6;1222,8
2020;3544202;Riolândia;10374;6288;4086;65;35,7;16,4
2020;3544251;Rosana;17990;8879;9111;102,6;38;24,2
2020;3544301;Roseira;10725;5378;5347;99,4;35,6;82,6
2020;3544400;Rubiácea;2723;1365;1358;99,5;36,3;11,5
2020;3544509;Rubinéia;3686;1823;1863;102,2;42,5;15,2
2020;3544608;Sabino;5196;2528;2668;105,5;40,6;17
2020;3544707;Sagres;2471;1190;1281;107,6;38,2;16,7
2020;3544806;Sales;6347;3137;3210;102,3;39,6;20,6
2020;3544905;Sales Oliveira;11324;5486;5838;106,4;38;37
2020;3545001;Salesópolis;15326;7623;7703;101;37;36,1
2020;3545100;Salmourão;4859;2448;2411;98,5;37,7;28,1
2020;3545159;Saltinho;8021;3937;4084;103,7;38,8;80,4
2020;3545209;Salto;129958;63765;66193;103,8;36,1;976,7
2020;3545308;Salto de Pirapora;43455;21567;21888;101,5;36,4;155
2020;3545407;Salto Grande;9061;4422;4639;104,9;38,2;48,1
2020;3545506;Sandovalina;3674;1846;1828;99;35,8;8,1
2020;3545605;Santa Adélia;14148;6991;7157;102,4;38,2;42,8
2020;3545704;Santa Albertina;6324;3159;3165;100,2;40,1;23,2
2020;3545803;Santa Bárbara d'Oeste;184066;90494;93572;103,4;37,7;679,1
2020;3546009;Santa Branca;14021;6979;7042;100,9;38,6;51,5
2020;3546108;Santa Clara d'Oeste;2530;1272;1258;98,9;38,4;13,8
2020;3546207;Santa Cruz da Conceição;4268;2091;2177;104,1;41,2;28,4
2020;3546256;Santa Cruz da Esperança;2114;1051;1063;101,1;38;14,3
2020;3546306;Santa Cruz das Palmeiras;29218;14528;14690;101,1;36,6;98,9
2020;3546405;Santa Cruz do Rio Pardo;46252;22519;23733;105,4;37,7;41,5
2020;3546504;Santa Ernestina;6040;3054;2986;97,8;35,3;44,9
2020;3546603;Santa Fé do Sul;33941;16336;17605;107,8;39,1;164,3
2020;3546702;Santa Gertrudes;23387;11802;11585;98,2;33,8;237,9
2020;3546801;Santa Isabel;53069;26283;26786;101,9;36,3;146,1
2020;3546900;Santa Lúcia;7425;3678;3747;101,9;36,5;48,3
2020;3547007;Santa Maria da Serra;5274;2662;2612;98,1;35,6;20,9
2020;3547106;Santa Mercedes;2961;1465;1496;102,1;37,9;17,8
2020;3547205;Santana da Ponte Pensa;1675;839;836;99,6;43,7;12,9
2020;3547304;Santana de Parnaíba;146518;71260;75258;105,6;34,4;814,2
2020;3547403;Santa Rita d'Oeste;2718;1327;1391;104,8;42,9;13
2020;3547502;Santa Rita do Passa Quatro;25233;12104;13129;108,5;41,6;33,5
2020;3547601;Santa Rosa de Viterbo;23667;11463;12204;106,5;38,6;82
2020;3547650;Santa Salete;1618;805;813;101;41,1;20,4
2020;3547700;Santo Anastácio;18484;8893;9591;107,8;40,1;33,4
2020;3547809;Santo André;741549;352441;389108;110,4;38,5;4218,6
2020;3547908;Santo Antônio da Alegria;6688;3425;3263;95,3;38,2;21,6
2020;3548005;Santo Antônio de Posse;22877;11448;11429;99,8;35,6;148,4
2020;3548054;Santo Antônio do Aracanguá;8340;4183;4157;99,4;38;6,4
2020;3548104;Santo Antônio do Jardim;6125;3093;3032;98;38,9;55,7
2020;3548203;Santo Antônio do Pinhal;7048;3542;3506;99;37,8;53
2020;3548302;Santo Expedito;2967;1454;1513;104,1;40;31,4
2020;3548401;Santópolis do Aguapeí;4002;1978;2024;102,3;36,2;31,3
2020;3548500;Santos;422246;191713;230533;120,2;41,7;1502,5
2020;3548609;São Bento do Sapucaí;11552;5743;5809;101,1;39,3;45,7
2020;3548708;São Bernardo do Campo;809739;386098;423641;109,7;37,2;1977,2
2020;3548807;São Caetano do Sul;164070;75078;88992;118,5;41,5;10702
2020;3548906;São Carlos;250502;122066;128436;105,2;37,5;220,3
2020;3549003;São Francisco;2666;1313;1353;103;42;35,3
2020;3549102;São João da Boa Vista;91352;43964;47388;107,8;39;176,9
2020;3549201;São João das Duas Pontes;2604;1280;1324;103,4;39,5;20,1
2020;3549250;São João de Iracema;1838;916;922;100,7;38;10,3
2020;3549300;São João do Pau d'Alho;2243;1105;1138;103;42,3;19,1
2020;3549409;São Joaquim da Barra;48518;23554;24964;106;37,4;118,1
2020;3549508;São José da Bela Vista;7808;3937;3871;98,3;35;28,2
2020;3549607;São José do Barreiro;3915;1968;1947;98,9;37,6;6,9
2020;3549706;São José do Rio Pardo;52517;25402;27115;106,7;39;125,1
2020;3549805;São José do Rio Preto;470977;225023;245954;109,3;38,1;1090,4
2020;3549904;São José dos Campos;689616;332969;356647;107,1;36,4;627,3
2020;3549953;São Lourenço da Serra;15784;7938;7846;98,8;36,2;84,7
2020;3550001;São Luiz do Paraitinga;10426;5270;5156;97,8;40,4;16,9
2020;3550100;São Manuel;37681;18453;19228;104,2;37,3;57,9
2020;3550209;São Miguel Arcanjo;32184;16246;15938;98,1;36,1;34,6
2020;3550308;São Paulo;11507600;5420766;6086834;112,3;37,3;7564,8
2020;3550407;São Pedro;37343;18132;19211;106;39,1;61,1
2020;3550506;São Pedro do Turvo;7252;3670;3582;97,6;36,7;9,9
2020;3550605;São Roque;79845;39014;40831;104,7;37,6;260,2
2020;3550704;São Sebastião;80523;39523;41000;103,7;34,4;200,1
2020;3550803;São Sebastião da Grama;10804;5415;5389;99,5;38,6;42,8
2020;3550902;São Simão;13709;6737;6972;103,5;39;22,2
2020;3551009;São Vicente;333253;160368;172885;107,8;36,5;2249,4
2020;3551108;Sarapuí;10180;5153;5027;97,6;36,5;28,9
2020;3551207;Sarutaiá;3712;1852;1860;100,4;37,2;26,2
2020;3551306;Sebastianópolis do Sul;3140;1519;1621;106,7;39,5;18,7
2020;3551405;Serra Azul;12510;7941;4569;57,5;35,9;44,2
2020;3551504;Serrana;43299;21346;21953;102,8;34;343,5
2020;3551603;Serra Negra;29483;14244;15239;107;40,2;144,7
2020;3551702;Sertãozinho;124745;60778;63967;105,2;35,8;309,5
2020;3551801;Sete Barras;12842;6535;6307;96,5;36,3;12,1
2020;3551900;Severínia;14869;7648;7221;94,4;35,6;105,9
2020;3552007;Silveiras;6144;3060;3084;100,8;37;14,8
2020;3552106;Socorro;39755;19559;20196;103,3;40,3;88,5
2020;3552205;Sorocaba;703838;340823;363015;106,5;36,2;1564,5
2020;3552304;Sud Mennucci;7407;3685;3722;101;37,7;12,5
2020;3552403;Sumaré;274659;134625;140034;104;34,9;1789,7
2020;3552502;Suzano;301199;145991;155208;106,3;34,5;1460,5
2020;3552551;Suzanápolis;3427;1751;1676;95,7;38,5;10,4
2020;3552601;Tabapuã;11436;5659;5777;102,1;39,6;33,1
2020;3552700;Tabatinga;14829;7365;7464;101,3;36,6;40,2
2020;3552809;Taboão da Serra;270835;128670;142165;110,5;34,9;13284,2
2020;3552908;Taciba;6195;3041;3154;103,7;36,3;10,2
2020;3553005;Taguaí;12430;6153;6277;102;34,5;85,5
2020;3553104;Taiaçu;5755;2919;2836;97,2;38;53,8
2020;3553203;Taiúva;6401;3541;2860;80,8;38,6;48,3
2020;3553302;Tambaú;21744;10703;11041;103,2;37,9;38,7
2020;3553401;Tanabi;25193;12428;12765;102,7;39,2;33,7
2020;3553500;Tapiraí;8025;4036;3989;98,8;35,4;10,6
2020;3553609;Tapiratiba;12060;5862;6198;105,7;38,9;54,4
2020;3553658;Taquaral;2674;1322;1352;102,3;38,1;49,6
2020;3553708;Taquaritinga;52901;25784;27117;105,2;38,2;89
2020;3553807;Taquarituba;24192;12437;11755;94,5;36,5;53,9
2020;3553856;Taquarivaí;6609;3360;3249;96,7;33,1;28,5
2020;3553906;Tarabai;6611;3254;3357;103,2;36;32,8
2020;3553955;Tarumã;14658;7320;7338;100,2;35,1;48,4
2020;3554003;Tatuí;121754;59552;62202;104,4;36;232,5
2020;3554102;Taubaté;307234;148421;158813;107;37,1;491,6
2020;3554201;Tejupá;4285;2188;2097;95,8;35,8;14,5
2020;3554300;Teodoro Sampaio;22193;10956;11237;102,6;35,5;14,3
2020;3554409;Terra Roxa;8088;4046;4042;99,9;37,9;36,5
2020;3554508;Tietê;37668;18578;19090;102,8;37,7;93,1
2020;3554607;Timburi;2529;1268;1261;99,4;40,4;12,9
2020;3554656;Torre de Pedra;2100;1066;1034;97;39,6;29,4
2020;3554706;Torrinha;9342;4672;4670;100;39,4;29,6
2020;3554755;Trabiju;1660;835;825;98,8;35,2;26,2
2020;3554805;Tremembé;49793;26560;23233;87,5;36,2;260,6
2020;3554904;Três Fronteiras;6606;3308;3298;99,7;39,3;43,6
2020;3554953;Tuiuti;6686;3353;3333;99,4;40,5;52,8
2020;3555000;Tupã;64342;30808;33534;108,8;39,9;102,5
2020;3555109;Tupi Paulista;15660;8010;7650;95,5;41,5;64
2020;3555208;Turiúba;1846;931;915;98,3;41,8;12
2020;3555307;Turmalina;1738;850;888;104,5;45,5;11,8
2020;3555356;Ubarana;5399;2762;2637;95,5;34,9;25,7
2020;3555406;Ubatuba;90662;44835;45827;102,2;35,4;128
2020;3555505;Ubirajara;5022;2593;2429;93,7;35,6;17,8
2020;3555604;Uchoa;10311;5079;5232;103;39,5;40,8
2020;3555703;União Paulista;1622;808;814;100,7;35,2;20,5
2020;3555802;Urânia;8889;4366;4523;103,6;40,5;42,5
2020;3555901;Uru;1380;682;698;102,3;40;9,4
2020;3556008;Urupês;13609;6698;6911;103,2;40,1;42
2020;3556107;Valentim Gentil;13659;6812;6847;100,5;36,7;91,2
2020;3556206;Valinhos;123605;60321;63284;104,9;38,4;832,1
2020;3556305;Valparaíso;24133;13413;10720;79,9;36;28,1
2020;3556354;Vargem;10246;5224;5022;96,1;36,8;71,9
2020;3556404;Vargem Grande do Sul;40210;19810;20400;103;37,4;150,5
2020;3556453;Vargem Grande Paulista;49450;24225;25225;104,1;35,4;1163,8
2020;3556503;Várzea Paulista;115097;57096;58001;101,6;34,8;3277,3
2020;3556602;Vera Cruz;10373;5073;5300;104,5;39,7;41,9
2020;3556701;Vinhedo;74679;36434;38245;105;37,5;922,5
2020;3556800;Viradouro;17526;8685;8841;101,8;36,7;80,5
2020;3556909;Vista Alegre do Alto;7924;4016;3908;97,3;34,9;83
2020;3556958;Vitória Brasil;1808;925;883;95,5;38,7;36,3
2020;3557006;Votorantim;125306;61282;64024;104,5;35,3;680,3
2020;3557105;Votuporanga;94971;45876;49095;107;38,6;225,7
2020;3557154;Zacarias;2660;1329;1331;100,2;38,7;8,3
2020;3557204;Chavantes;12306;6002;6304;105;37,2;65,2
2020;3557303;Estiva Gerbi;11116;5565;5551;99,7;36,1;149,9
2021;3500105;Adamantina;34708;16716;17992;107,6;40,8;84,2
2021;3500204;Adolfo;4292;2120;2172;102,5;39,4;20,3
2021;3500303;Aguaí;32175;15951;16224;101,7;36,6;67,8
2021;3500402;Águas da Prata;7403;3554;3849;108,3;42,4;51,9
2021;3500501;Águas de Lindóia;17956;8738;9218;105,5;40,6;298,6
2021;3500550;Águas de Santa Bárbara;7076;3523;3553;100,9;39,1;17,5
2021;3500600;Águas de São Pedro;2785;1299;1486;114,4;45,4;771
2021;3500709;Agudos;37538;18409;19129;103,9;36,6;38,8
2021;3500758;Alambari;6047;3044;3003;98,7;36,5;37,9
2021;3500808;Alfredo Marcondes;4412;2203;2209;100,3;41;37,1
2021;3500907;Altair;3498;1797;1701;94,7;36,8;11,2
2021;3501004;Altinópolis;16757;8269;8488;102,6;38,1;18
2021;3501103;Alto Alegre;3913;1968;1945;98,8;42,4;12,3
2021;3501152;Alumínio;17333;8623;8710;101;35,5;207,3
2021;3501202;Álvares Florence;3935;1999;1936;96,8;43,4;10,9
2021;3501301;Álvares Machado;27026;13136;13890;105,7;37,3;77,7
2021;3501400;Álvaro de Carvalho;4807;3208;1599;49,8;36,5;31,3
2021;3501509;Alvinlândia;2914;1431;1483;103,6;36,9;34,3
2021;3501608;Americana;235549;113826;121723;106,9;38,7;1759
2021;3501707;Américo Brasiliense;33296;16474;16822;102,1;35,5;270,8
2021;3501806;Américo de Campos;5888;2857;3031;106,1;40,6;23,3
2021;3501905;Amparo;68041;33105;34936;105,5;39,2;152,8
2021;3502002;Analândia;4579;2306;2273;98,6;37,4;14
2021;3502101;Andradina;59624;29595;30029;101,5;39;61,8
2021;3502200;Angatuba;23902;12002;11900;99,2;36,7;23,3
2021;3502309;Anhembi;5679;2885;2794;96,8;36,4;7,7
2021;3502408;Anhumas;4013;1960;2053;104,7;38,1;12,5
2021;3502507;Aparecida;32958;15818;17140;108,4;38,2;272,6
2021;3502606;Aparecida d'Oeste;4129;2053;2076;101,1;42,1;23,1
2021;3502705;Apiaí;24792;12401;12391;99,9;36,1;25,4
2021;3502754;Araçariguama;21133;10611;10522;99,2;33,7;145,5
2021;3502804;Araçatuba;199283;94879;104404;110;38,9;170,7
2021;3502903;Araçoiaba da Serra;32049;15938;16111;101,1;39,4;125,5
2021;3503000;Aramina;5420;2642;2778;105,1;38,8;26,7
2021;3503109;Arandu;6835;3429;3406;99,3;36,5;23,9
2021;3503158;Arapeí;2358;1172;1186;101,2;39,1;15
2021;3503208;Araraquara;239938;115131;124807;108,4;38,4;239,1
2021;3503307;Araras;130140;63086;67054;106,3;38,1;201,8
2021;3503356;Arco-Íris;2038;1028;1010;98,2;38,7;7,7
2021;3503406;Arealva;8131;4063;4068;100,1;41,1;16,1
2021;3503505;Areias;3600;1821;1779;97,7;37,2;11,8
2021;3503604;Areiópolis;10212;5167;5045;97,6;34,9;118,9
2021;3503703;Ariranha;7688;3817;3871;101,4;39,4;58
2021;3503802;Artur Nogueira;50847;25068;25779;102,8;35,8;285,6
2021;3503901;Arujá;85788;41704;44084;105,7;35,4;892,1
2021;3503950;Aspásia;1849;927;922;99,5;40,7;26,7
2021;3504008;Assis;101284;48812;52472;107,5;38,4;219,9
2021;3504107;Atibaia;156282;75786;80496;106,2;37,7;326,6
2021;3504206;Auriflama;13797;6815;6982;102,5;40;31,8
2021;3504305;Avaí;4532;2251;2281;101,3;37,2;8,4
2021;3504404;Avanhandava;11310;6231;5079;81,5;35,4;33,4
2021;3504503;Avaré;92307;45716;46591;101,9;37,1;76,1
2021;3504602;Bady Bassitt;26151;12836;13315;103,7;35,6;236,9
2021;3504701;Balbinos;3844;3144;700;22,3;37;41,9
2021;3504800;Bálsamo;9497;4623;4874;105,4;39,5;63,4
2021;3504909;Bananal;10023;4876;5147;105,6;38,5;16,3
2021;3505005;Barão de Antonina;3493;1739;1754;100,9;37,5;22,8
2021;3505104;Barbosa;5742;2816;2926;103,9;37,4;28
2021;3505203;Bariri;31685;15543;16142;103,9;38,6;71,3
2021;3505302;Barra Bonita;34549;16656;17893;107,4;40,5;230,1
2021;3505351;Barra do Chapéu;5197;2700;2497;92,5;35,2;12,8
2021;3505401;Barra do Turvo;6990;3555;3435;96,6;37,1;6,9
2021;3505500;Barretos;121873;58511;63362;108,3;37,8;77,8
2021;3505609;Barrinha;31895;15750;16145;102,5;33,8;218,4
2021;3505708;Barueri;310935;148664;162271;109,2;34,3;4732,6
2021;3505807;Bastos;21491;10507;10984;104,5;38,1;125,7
2021;3505906;Batatais;58384;28379;30005;105,7;38,5;68,7
2021;3506003;Bauru;377187;182415;194772;106,8;37,6;564,9
2021;3506102;Bebedouro;76598;37091;39507;106,5;38,6;112,1
2021;3506201;Bento de Abreu;2626;1315;1311;99,7;36,8;8,7
2021;3506300;Bernardino de Campos;11581;6078;5503;90,5;38,8;47,4
2021;3506359;Bertioga;62807;31283;31524;100,8;34,2;127,8
2021;3506409;Bilac;7343;3607;3736;103,6;40,2;46,5
2021;3506508;Birigui;118520;57374;61146;106,6;38,2;223,6
2021;3506607;Biritiba Mirim;29676;14790;14886;100,6;36,4;93,5
2021;3506706;Boa Esperança do Sul;13062;6455;6607;102,4;35,9;18,9
2021;3506805;Bocaina;11273;5523;5750;104,1;37,4;31
2021;3506904;Bofete;10416;5293;5123;96,8;39;15,9
2021;3507001;Boituva;60063;29633;30430;102,7;36,3;241,3
2021;3507100;Bom Jesus dos Perdões;21829;10821;11008;101,7;35,9;201,4
2021;3507159;Bom Sucesso de Itararé;3556;1816;1740;95,8;32,7;26,6
2021;3507209;Borá;912;453;459;101,3;37,4;7,7
2021;3507308;Boracéia;4682;2373;2309;97,3;35,6;38,3
2021;3507407;Borborema;14310;7100;7210;101,5;40;25,9
2021;3507456;Borebi;2691;1308;1383;105,7;34,4;7,7
2021;3507506;Botucatu;143936;69281;74655;107,8;37,6;97,1
2021;3507605;Bragança Paulista;174548;84706;89842;106,1;37,6;340,5
2021;3507704;Braúna;5337;2630;2707;102,9;38,3;27,3
2021;3507753;Brejo Alegre;2573;1306;1267;97;38,6;24,3
2021;3507803;Brodowski;24897;12214;12683;103,8;37,1;89,4
2021;3507902;Brotas;23764;11558;12206;105,6;38;21,6
2021;3508009;Buri;20211;10144;10067;99,2;33,9;16,9
2021;3508108;Buritama;17120;8325;8795;105,6;39,6;52,4
2021;3508207;Buritizal;4349;2132;2217;104;38,7;16,3
2021;3508306;Cabrália Paulista;4332;2198;2134;97,1;36,9;18,1
2021;3508405;Cabreúva;46581;23109;23472;101,6;34,2;179
2021;3508504;Caçapava;95581;46830;48751;104,1;37,1;259
2021;3508603;Cachoeira Paulista;31572;15263;16309;106,9;37,6;109,6
2021;3508702;Caconde;17305;8600;8705;101,2;39,1;37
2021;3508801;Cafelândia;16723;8089;8634;106,7;38,3;18,2
2021;3508900;Caiabu;3759;1882;1877;99,7;40,1;14,8
2021;3509007;Caieiras;94566;45838;48728;106,3;35,7;968,5
2021;3509106;Caiuá;5434;3239;2195;67,8;38,5;9,9
2021;3509205;Cajamar;90332;44338;45994;103,7;33,3;687,5
2021;3509254;Cajati;28601;14381;14220;98,9;34,8;62,9
2021;3509304;Cajobi;9217;4584;4633;101,1;39,4;52,1
2021;3509403;Cajuru;23854;11856;11998;101,2;36,9;36,1
2021;3509452;Campina do Monte Alegre;5949;2999;2950;98,4;37,3;32,2
2021;3509502;Campinas;1138055;543166;594889;109,5;38,1;1432,3
2021;3509601;Campo Limpo Paulista;77641;37923;39718;104,7;36,2;977,8
2021;3509700;Campos do Jordão;47168;23036;24132;104,8;36;162,7
2021;3509809;Campos Novos Paulista;4881;2460;2421;98,4;37;10,1
2021;3509908;Cananéia;12322;6039;6283;104;37,4;10
2021;3509957;Canas;4900;2443;2457;100,6;34,3;92
2021;3510005;Cândido Mota;29632;14409;15223;105,6;38,8;49,7
2021;3510104;Cândido Rodrigues;2870;1421;1449;102;41,5;40,5
2021;3510153;Canitar;6115;3006;3109;103,4;32,6;106,4
2021;3510203;Capão Bonito;46517;23057;23460;101,7;36,1;28,4
2021;3510302;Capela do Alto;22432;12224;10208;83,5;35,2;132
2021;3510401;Capivari;50058;24582;25476;103,6;36,6;155
2021;3510500;Caraguatatuba;132196;64364;67832;105,4;36,3;272,6
2021;3510609;Carapicuíba;387282;186279;201003;107,9;34,9;11210,7
2021;3510708;Cardoso;11458;5608;5850;104,3;41,3;17,9
2021;3510807;Casa Branca;28208;14641;13567;92,7;38,2;32,6
2021;3510906;Cássia dos Coqueiros;2802;1441;1361;94,4;40,4;14,6
2021;3511003;Castilho;19901;9809;10092;102,9;37,9;18,7
2021;3511102;Catanduva;115895;55580;60315;108,5;39,3;398,8
2021;3511201;Catiguá;7047;3527;3520;99,8;38;47,5
2021;3511300;Cedral;12212;6027;6185;102,6;37,9;61,7
2021;3511409;Cerqueira César;21214;10986;10228;93,1;36,4;41,5
2021;3511508;Cerquilho;44367;21643;22724;105;37,6;347,2
2021;3511607;Cesário Lange;18792;9647;9145;94,8;36,2;98,7
2021;3511706;Charqueada;15529;7760;7769;100,1;36,6;88,3
2021;3511904;Clementina;7014;3493;3521;100,8;36,1;41,6
2021;3512001;Colina;18425;8933;9492;106,3;37,6;43,6
2021;3512100;Colômbia;6621;3330;3291;98,8;36,5;9,1
2021;3512209;Conchal;27931;13944;13987;100,3;35,1;152,8
2021;3512308;Conchas;15371;7703;7668;99,5;38,9;33
2021;3512407;Cordeirópolis;24282;11997;12285;102,4;35,9;176,5
2021;3512506;Coroados;5418;2688;2730;101,6;38,5;22
2021;3512605;Coronel Macedo;4387;2217;2170;97,9;39,1;14,4
2021;3512704;Corumbataí;4190;2101;2089;99,4;36,5;15
2021;3512803;Cosmópolis;59806;29394;30412;103,5;36,3;386,7
2021;3512902;Cosmorama;8606;4288;4318;100,7;39,3;19,5
2021;3513009;Cotia;268598;130275;138323;106,2;34,6;829
2021;3513108;Cravinhos;33264;16388;16876;103;37,4;106,8
2021;3513207;Cristais Paulista;9154;4544;4610;101,5;36,7;23,8
2021;3513306;Cruzália;2141;1058;1083;102,4;41;14,3
2021;3513405;Cruzeiro;75422;36250;39172;108,1;38,1;246,7
2021;3513504;Cubatão;113496;54675;58821;107,6;35;794,3
2021;3513603;Cunha;22169;11273;10896;96,7;39,1;15,8
2021;3513702;Descalvado;31827;15612;16215;103,9;39;42,2
2021;3513801;Diadema;394449;188496;205953;109,3;35,7;12835,1
2021;3513850;Dirce Reis;1628;842;786;93,3;41,1;18,5
2021;3513900;Divinolândia;11226;5569;5657;101,6;40,6;50,2
2021;3514007;Dobrada;8711;4342;4369;100,6;34,5;58,2
2021;3514106;Dois Córregos;24637;12165;12472;102,5;37,4;38,9
2021;3514205;Dolcinópolis;2203;1108;1095;98,8;40,7;28,3
2021;3514304;Dourado;8183;4047;4136;102,2;40,1;39,7
2021;3514403;Dracena;45449;22288;23161;103,9;40,2;93,2
2021;3514502;Duartina;12350;6033;6317;104,7;40,6;46,7
2021;3514601;Dumont;9347;4642;4705;101,4;35,7;83,9
2021;3514700;Echaporã;6250;3072;3178;103,5;38,1;12,1
2021;3514809;Eldorado;13275;6673;6602;98,9;35,6;8
2021;3514908;Elias Fausto;17585;8848;8737;98,7;35,8;86,9
2021;3514924;Elisiário;3147;1587;1560;98,3;38,7;33,5
2021;3514957;Embaúba;2350;1198;1152;96,2;39,6;28,3
2021;3515004;Embu das Artes;250822;120858;129964;107,5;34;3562,9
2021;3515103;Embu-Guaçu;66940;32969;33971;103;35,4;430,1
2021;3515129;Emilianópolis;3040;1512;1528;101,1;41,1;13,5
2021;3515152;Engenheiro Coelho;19229;9685;9544;98,5;33,2;174,9
2021;3515186;Espírito Santo do Pinhal;40119;19466;20653;106,1;39,7;103,1
2021;3515194;Espírito Santo do Turvo;4171;2092;2079;99,4;34,3;21,5
2021;3515202;Estrela d'Oeste;9330;4729;4601;97,3;39,1;31,5
2021;3515301;Estrela do Norte;2716;1338;1378;103;37,4;10,2
2021;3515350;Euclides da Cunha Paulista;8111;3996;4115;103;37,8;14,1
2021;3515400;Fartura;16592;8082;8510;105,3;38,6;38,7
2021;3515509;Fernandópolis;70820;34075;36745;107,8;39,5;128,8
2021;3515608;Fernando Prestes;5912;2907;3005;103,4;40,6;34,8
2021;3515657;Fernão;1651;843;808;95,8;38,1;16,4
2021;3515707;Ferraz de Vasconcelos;178744;86503;92241;106,6;34,2;6049,4
2021;3515806;Flora Rica;1516;750;766;102,1;43,6;6,7
2021;3515905;Floreal;2775;1359;1416;104,2;44,2;13,6
2021;3516002;Flórida Paulista;13000;7119;5881;82,6;38,5;24,8
2021;3516101;Florínea;3792;2400;1392;58;38,3;16,8
2021;3516200;Franca;350781;170143;180638;106,2;37;579,2
2021;3516309;Francisco Morato;164611;80613;83998;104,2;33;3359,3
2021;3516408;Franco da Rocha;143933;72420;71513;98,7;34,3;1084
2021;3516507;Gabriel Monteiro;2786;1389;1397;100,6;40,5;20,1
2021;3516606;Gália;6477;3176;3301;103,9;40,7;18,2
2021;3516705;Garça;42382;20432;21950;107,4;39;76,3
2021;3516804;Gastão Vidigal;3348;1624;1724;106,2;39,4;18,5
2021;3516853;Gavião Peixoto;4696;2338;2358;100,9;35,5;19,3
2021;3516903;General Salgado;10393;5139;5254;102,2;40,5;21
2021;3517000;Getulina;10323;5654;4669;82,6;38,8;15,3
2021;3517109;Glicério;4200;2057;2143;104,2;39,5;15,4
2021;3517208;Guaiçara;11212;5545;5667;102,2;36,2;40,5
2021;3517307;Guaimbê;5540;2746;2794;101,7;37,9;25,4
2021;3517406;Guaíra;39203;19120;20083;105;37,7;31,2
2021;3517505;Guapiaçu;21405;10625;10780;101,5;36,6;65,8
2021;3517604;Guapiara;17266;8756;8510;97,2;37,1;42,3
2021;3517703;Guará;18789;9192;9597;104,4;36,5;51,9
2021;3517802;Guaraçaí;7581;3740;3841;102,7;42,1;13,3
2021;3517901;Guaraci;10358;5185;5173;99,8;38;16,1
2021;3518008;Guarani d'Oeste;1966;975;991;101,6;40,6;22,9
2021;3518107;Guarantã;6439;3187;3252;102;36,6;13,9
2021;3518206;Guararapes;31137;15163;15974;105,3;39,3;32,6
2021;3518305;Guararema;30871;15250;15621;102,4;37,1;114
2021;3518404;Guaratinguetá;117822;56447;61375;108,7;38,4;156,5
2021;3518503;Guareí;15004;9023;5981;66,3;36,8;26,4
2021;3518602;Guariba;37482;18131;19351;106,7;35,5;138,7
2021;3518701;Guarujá;289057;139020;150037;107,9;35,6;1996,3
2021;3518800;Guarulhos;1290286;620911;669375;107,8;35,1;4048,9
2021;3518859;Guatapará;7322;3695;3627;98,2;36,8;17,7
2021;3518909;Guzolândia;4312;2202;2110;95,8;38;17,1
2021;3519006;Herculândia;9112;4474;4638;103,7;37,3;25
2021;3519055;Holambra;14754;7336;7418;101,1;36,2;225
2021;3519071;Hortolândia;233265;115868;117397;101,3;34,6;3737,3
2021;3519105;Iacanga;10416;5182;5234;101;37,9;19
2021;3519204;Iacri;6182;3080;3102;100,7;39,5;19,2
2021;3519253;Iaras;7872;5307;2565;48,3;37,8;19,6
2021;3519303;Ibaté;32171;16074;16097;100,1;34,9;110,6
2021;3519402;Ibirá;11644;5707;5937;104;39,3;42,8
2021;3519501;Ibirarema;6442;3206;3236;100,9;38,5;28,2
2021;3519600;Ibitinga;59598;29252;30346;103,7;37,2;86,5
2021;3519709;Ibiúna;75450;37888;37562;99,1;36,5;71,3
2021;3519808;Icém;7829;4295;3534;82,3;37,5;21,6
2021;3519907;Iepê;7649;3712;3937;106,1;39,3;12,9
2021;3520004;Igaraçu do Tietê;23225;11560;11665;100,9;37,2;237,6
2021;3520103;Igarapava;26444;12793;13651;106,7;38,4;56,5
2021;3520202;Igaratá;10487;5262;5225;99,3;37,3;35,8
2021;3520301;Iguape;29208;14657;14551;99,3;38,8;14,8
2021;3520400;Ilhabela;34375;17044;17331;101,7;35,1;99,2
2021;3520426;Ilha Comprida;13104;6455;6649;103;41,4;66,7
2021;3520442;Ilha Solteira;25630;12417;13213;106,4;40,2;39,3
2021;3520509;Indaiatuba;251203;122873;128330;104,4;37;806,3
2021;3520608;Indiana;5108;2581;2527;97,9;38,8;39,5
2021;3520707;Indiaporã;4050;1976;2074;105;41,8;14,5
2021;3520806;Inúbia Paulista;3633;1797;1836;102,2;39,3;41,7
2021;3520905;Ipaussu;13746;6756;6990;103,5;36,9;65,6
2021;3521002;Iperó;35778;19193;16585;86,4;34,6;210,1
2021;3521101;Ipeúna;6785;3406;3379;99,2;36;35,7
2021;3521150;Ipiguá;6584;3314;3270;98,7;37,6;48,4
2021;3521200;Iporanga;4075;2061;2014;97,7;35,6;3,5
2021;3521309;Ipuã;14459;7203;7256;100,7;35,9;31
2021;3521408;Iracemápolis;21870;10867;11003;101,3;36,6;190
2021;3521507;Irapuã;6946;3515;3431;97,6;38;27
2021;3521606;Irapuru;7182;4125;3057;74,1;40,1;33,5
2021;3521705;Itaberá;18065;9051;9014;99,6;36,9;16,4
2021;3521804;Itaí;25145;13052;12093;92,7;36,1;23
2021;3521903;Itajobi;16795;8398;8397;100;38,9;33,5
2021;3522000;Itaju;3582;1793;1789;99,8;37,4;15,5
2021;3522109;Itanhaém;110695;53277;57418;107,8;38,4;184
2021;3522158;Itaoca;3417;1722;1695;98,4;37,6;18,7
2021;3522208;Itapecerica da Serra;158671;77652;81019;104,3;34,3;1052,6
2021;3522307;Itapetininga;157057;78397;78660;100,3;36,1;87,8
2021;3522406;Itapeva;89975;44177;45798;103,7;35,7;49,3
2021;3522505;Itapevi;230176;112271;117905;105;33;2784,7
2021;3522604;Itapira;72007;35306;36701;104;39;138,9
2021;3522653;Itapirapuã Paulista;4268;2209;2059;93,2;33,6;10,5
2021;3522703;Itápolis;39650;19432;20218;104;39,1;39,8
2021;3522802;Itaporanga;14196;6983;7213;103,3;38,1;27,9
2021;3522901;Itapuí;13507;6728;6779;100,8;35,7;96,5
2021;3523008;Itapura;4049;2042;2007;98,3;38,6;13,4
2021;3523107;Itaquaquecetuba;366169;178952;187217;104,6;33,1;4431,9
2021;3523206;Itararé;44967;21906;23061;105,3;36,7;44,8
2021;3523305;Itariri;15569;7738;7831;101,2;35,7;56,9
2021;3523404;Itatiba;120094;58797;61297;104,3;37,4;372,7
2021;3523503;Itatinga;19044;10054;8990;89,4;34,7;19,4
2021;3523602;Itirapina;16086;9471;6615;69,8;36,2;28,5
2021;3523701;Itirapuã;5808;2950;2858;96,9;36,5;36
2021;3523800;Itobi;8019;4076;3943;96,7;37,5;57,7
2021;3523909;Itu;167508;81902;85606;104,5;36,5;261,4
2021;3524006;Itupeva;68372;34292;34080;99,4;34;340,4
2021;3524105;Ituverava;37782;18264;19518;106,9;38,9;53,6
2021;3524204;Jaborandi;6285;3115;3170;101,8;38,2;23
2021;3524303;Jaboticabal;72043;34400;37643;109,4;39;102
2021;3524402;Jacareí;238645;115208;123437;107,1;37,1;514
2021;3524501;Jaci;7473;3777;3696;97,9;35,3;51,5
2021;3524600;Jacupiranga;16274;8087;8187;101,2;36,6;23,1
2021;3524709;Jaguariúna;58124;28267;29857;105,6;36,3;411,1
2021;3524808;Jales;48794;23610;25184;106,7;40,4;132,4
2021;3524907;Jambeiro;6320;3174;3146;99,1;37,4;34,3
2021;3525003;Jandira;117572;56999;60573;106,3;34,5;6738
2021;3525102;Jardinópolis;44704;23081;21623;93,7;35,9;89,1
2021;3525201;Jarinu;36410;18277;18133;99,2;35,4;175,4
2021;3525300;Jaú;133642;64618;69024;106,8;38,5;194,5
2021;3525409;Jeriquara;3808;1957;1851;94,6;34,2;26,8
2021;3525508;Joanópolis;12770;6457;6313;97,8;38,5;34,1
2021;3525607;João Ramalho;4378;2190;2188;99,9;35,8;10,5
2021;3525706;José Bonifácio;36374;17934;18440;102,8;37,3;42,3
2021;3525805;Júlio Mesquita;4288;2087;2201;105,5;37,2;33,5
2021;3525854;Jumirim;3043;1506;1537;102,1;35,6;53,7
2021;3525904;Jundiaí;438044;211399;226645;107,2;38,3;1015,9
2021;3526001;Junqueirópolis;20400;10679;9721;91;39,2;35
2021;3526100;Juquiá;17423;8733;8690;99,5;37,8;21,4
2021;3526209;Juquitiba;27664;13932;13732;98,6;36,1;53
2021;3526308;Lagoinha;5078;2571;2507;97,5;41,4;19,9
2021;3526407;Laranjal Paulista;26241;12811;13430;104,8;37,8;68,3
2021;3526506;Lavínia;9590;7091;2499;35,2;37;17,8
2021;3526605;Lavrinhas;7150;3552;3598;101,3;34,6;42,8
2021;3526704;Leme;97999;48161;49838;103,5;36,5;243,3
2021;3526803;Lençóis Paulista;66148;32615;33533;102,8;36,7;81,7
2021;3526902;Limeira;291308;141930;149378;105,2;37,9;501,6
2021;3527009;Lindóia;7015;3462;3553;102,6;38,9;143,9
2021;3527108;Lins;74804;35932;38872;108,2;38,6;131,2
2021;3527207;Lorena;84914;40678;44236;108,7;37,6;205
2021;3527256;Lourdes;1973;979;994;101,5;40,9;17,3
2021;3527306;Louveira;50585;25183;25402;100,9;33,8;907,5
2021;3527405;Lucélia;20120;11150;8970;80,4;40;63,9
2021;3527504;Lucianópolis;2369;1199;1170;97,6;38,7;12,5
2021;3527603;Luís Antônio;12174;6086;6088;100;34,6;20,3
2021;3527702;Luiziânia;4731;2372;2359;99,5;37,1;28,4
2021;3527801;Lupércio;4029;1966;2063;104,9;37,8;26
2021;3527900;Lutécia;2679;1327;1352;101,9;38,3;5,6
2021;3528007;Macatuba;16856;8342;8514;102,1;36,8;75,1
2021;3528106;Macaubal;7522;3753;3769;100,4;41,6;30,3
2021;3528205;Macedônia;3955;1957;1998;102,1;41,1;12,1
2021;3528304;Magda;3185;1559;1626;104,3;41,7;10,2
2021;3528403;Mairinque;49641;24945;24696;99;36,4;236,2
2021;3528502;Mairiporã;92897;46231;46666;100,9;36,6;289,7
2021;3528601;Manduri;9832;4871;4961;101,8;38,4;42,9
2021;3528700;Marabá Paulista;4597;2869;1728;60,2;37,1;5
2021;3528809;Maracaí;12805;6336;6469;102,1;38;24
2021;3528858;Marapoama;3251;1659;1592;96;38,1;29,2
2021;3528908;Mariápolis;3559;1779;1780;100,1;39,8;19,1
2021;3529005;Marília;236645;113482;123163;108,5;38,1;202,2
2021;3529104;Marinópolis;1882;952;930;97,7;40,7;24,2
2021;3529203;Martinópolis;24906;12813;12093;94,4;38,4;19,9
2021;3529302;Matão;79154;38867;40287;103,7;38,3;150,8
2021;3529401;Mauá;419486;202289;217197;107,4;35,7;6772,8
2021;3529500;Mendonça;6040;3042;2998;98,6;38,4;31
2021;3529609;Meridiano;4536;2218;2318;104,5;39,2;19,9
2021;3529658;Mesópolis;1951;984;967;98,3;38;13,1
2021;3529708;Miguelópolis;19625;9631;9994;103,8;36,6;23,9
2021;3529807;Mineiros do Tietê;11330;5623;5707;101,5;37,9;53,1
2021;3529906;Miracatu;18834;9392;9442;100,5;36,6;18,8
2021;3530003;Mira Estrela;3108;1555;1553;99,9;41,5;14,3
2021;3530102;Mirandópolis;28062;15900;12162;76,5;40,4;30,6
2021;3530201;Mirante do Paranapanema;16069;8019;8050;100,4;39,6;13
2021;3530300;Mirassol;62649;30393;32256;106,1;38,1;257,6
2021;3530409;Mirassolândia;4654;2346;2308;98,4;38;28
2021;3530508;Mococa;67845;33317;34528;103,6;39,1;79,3
2021;3530607;Mogi das Cruzes;447343;215439;231904;107,6;36;627,8
2021;3530706;Mogi Guaçu;152818;74554;78264;105;37,5;188
2021;3530805;Mogi Mirim;92431;44982;47449;105,5;38,7;185,7
2021;3530904;Mombuca;3699;1822;1877;103;34,9;27,7
2021;3531001;Monções;1968;987;981;99,4;42,3;18,9
2021;3531100;Mongaguá;60761;30864;29897;96,9;38,9;425,6
2021;3531209;Monte Alegre do Sul;8525;4209;4316;102,5;40,8;77,3
2021;3531308;Monte Alto;47647;23321;24326;104,3;39,7;137,3
2021;3531407;Monte Aprazível;22305;10909;11396;104,5;39,5;45
2021;3531506;Monte Azul Paulista;18288;9153;9135;99,8;39,5;69,4
2021;3531605;Monte Castelo;4222;2098;2124;101,2;39,7;18,1
2021;3531704;Monteiro Lobato;4136;2070;2066;99,8;38,8;12,4
2021;3531803;Monte Mor;63386;31285;32101;102,6;34,6;263,5
2021;3531902;Morro Agudo;28157;13844;14313;103,4;35,8;20,3
2021;3532009;Morungaba;13582;6654;6928;104,1;36,5;92,6
2021;3532058;Motuca;4079;2064;2015;97,6;37,6;17,8
2021;3532108;Murutinga do Sul;3788;1879;1909;101,6;42,5;15,1
2021;3532157;Nantes;2665;1317;1348;102,4;35,7;9,3
2021;3532207;Narandiba;5589;2775;2814;101,4;34,3;15,6
2021;3532306;Natividade da Serra;6986;3641;3345;91,9;40,3;8,4
2021;3532405;Nazaré Paulista;18101;9190;8911;97;37,9;55,5
2021;3532504;Neves Paulista;9654;4779;4875;102;41,2;44,1
2021;3532603;Nhandeara;9986;4812;5174;107,5;42,4;22,9
2021;3532702;Nipoã;4733;2430;2303;94,8;35,9;34,4
2021;3532801;Nova Aliança;6640;3270;3370;103,1;38;30,5
2021;3532827;Nova Campina;8519;4257;4262;100,1;33,2;22,1
2021;3532843;Nova Canaã Paulista;2045;1019;1026;100,7;44,1;16,4
2021;3532868;Nova Castilho;1073;532;541;101,7;37,8;5,9
2021;3532900;Nova Europa;9330;4669;4661;99,8;36,7;58,2
2021;3533007;Nova Granada;19423;9630;9793;101,7;38;36,5
2021;3533106;Nova Guataporanga;2166;1066;1100;103,2;40,4;63,4
2021;3533205;Nova Independência;4500;2451;2049;83,6;34,8;17
2021;3533254;Novais;4431;2244;2187;97,5;34,2;37,6
2021;3533304;Nova Luzitânia;2907;1464;1443;98,6;39;39,4
2021;3533403;Nova Odessa;61237;29961;31276;104,4;37,3;829,9
2021;3533502;Novo Horizonte;38345;18900;19445;102,9;38,6;41,2
2021;3533601;Nuporanga;7364;3643;3721;102,1;37,7;21,1
2021;3533700;Ocauçu;4315;2197;2118;96,4;38,1;14,3
2021;3533809;Óleo;2544;1289;1255;97,4;40,1;12,8
2021;3533908;Olímpia;54814;26657;28157;105,6;37,9;68,3
2021;3534005;Onda Verde;4704;2371;2333;98,4;36,2;19,4
2021;3534104;Oriente;6122;2943;3179;108;39,9;28
2021;3534203;Orindiúva;6008;2996;3012;100,5;35,4;24,3
2021;3534302;Orlândia;38558;18637;19921;106,9;38,3;132,2
2021;3534401;Osasco;726452;345841;380611;110,1;36,2;11184,1
2021;3534500;Oscar Bressane;2495;1211;1284;106;42,4;11,2
2021;3534609;Osvaldo Cruz;31310;15594;15716;100,8;40,5;126,2
2021;3534708;Ourinhos;104413;49760;54653;109,8;38,1;353
2021;3534757;Ouroeste;10189;5021;5168;102,9;38,1;35,3
2021;3534807;Ouro Verde;7803;3761;4042;107,5;36,9;29,2
2021;3534906;Pacaembu;14778;9671;5107;52,8;39,1;43,5
2021;3535002;Palestina;11451;5717;5734;100,3;39;16,4
2021;3535101;Palmares Paulista;9767;4919;4848;98,6;35;118,9
2021;3535200;Palmeira d'Oeste;8995;4488;4507;100,4;42,6;28,2
2021;3535309;Palmital;19851;9655;10196;105,6;40,3;36,2
2021;3535408;Panorama;15013;7426;7587;102,2;36,4;42,2
2021;3535507;Paraguaçu Paulista;41401;20668;20733;100,3;37,8;41,3
2021;3535606;Paraibuna;17693;8944;8749;97,8;38,3;21,9
2021;3535705;Paraíso;6110;3074;3036;98,8;39,2;39,4
2021;3535804;Paranapanema;19283;9791;9492;96,9;35,4;18,9
2021;3535903;Paranapuã;4030;2009;2021;100,6;38,1;28,7
2021;3536000;Parapuã;10646;5284;5362;101,5;40,7;29
2021;3536109;Pardinho;7052;3572;3480;97,4;36;33,6
2021;3536208;Pariquera-Açu;19252;9532;9720;102;36,9;53,6
2021;3536257;Parisi;2831;1373;1458;106,2;39,4;33,4
2021;3536307;Patrocínio Paulista;14426;7269;7157;98,5;36;23,9
2021;3536406;Paulicéia;7841;3956;3885;98,2;36,3;21
2021;3536505;Paulínia;108131;52558;55573;105,7;35,9;779,2
2021;3536570;Paulistânia;2067;1032;1035;100,3;37,3;8,1
2021;3536604;Paulo de Faria;7548;3791;3757;99,1;39,4;10,2
2021;3536703;Pederneiras;44632;22190;22442;101,1;36,9;61,4
2021;3536802;Pedra Bela;6502;3382;3120;92,3;39,5;41
2021;3536901;Pedranópolis;2782;1393;1389;99,7;42,1;10,7
2021;3537008;Pedregulho;15594;7819;7775;99,4;37;21,9
2021;3537107;Pedreira;43060;21112;21948;104;38,2;395,7
2021;3537156;Pedrinhas Paulista;2829;1382;1447;104,7;40,5;18,6
2021;3537206;Pedro de Toledo;11220;5736;5484;95,6;37,7;16,7
2021;3537305;Penápolis;61680;29716;31964;107,6;38,9;86,7
2021;3537404;Pereira Barreto;24306;11781;12525;106,3;39,5;24,9
2021;3537503;Pereiras;8646;4321;4325;100,1;37,4;38,7
2021;3537602;Peruíbe;67870;32750;35120;107,2;38,7;208,1
2021;3537701;Piacatu;5522;2752;2770;100,7;39,3;23,8
2021;3537800;Piedade;53069;26673;26396;99;37,9;71,1
2021;3537909;Pilar do Sul;27603;13962;13641;97,7;36,9;40,5
2021;3538006;Pindamonhangaba;164230;79674;84556;106,1;36,4;224,6
2021;3538105;Pindorama;14629;7297;7332;100,5;40;79,2
2021;3538204;Pinhalzinho;15114;7525;7589;100,9;39,8;97,8
2021;3538303;Piquerobi;3294;1572;1722;109,5;40;6,8
2021;3538501;Piquete;12721;6090;6631;108,9;40;72,3
2021;3538600;Piracaia;26029;12728;13301;104,5;39,2;67,5
2021;3538709;Piracicaba;419347;203082;216265;106,5;37,5;304,3
2021;3538808;Piraju;29469;14258;15211;106,7;38,9;58,4
2021;3538907;Pirajuí;22570;11862;10708;90,3;38,6;27,4
2021;3539004;Pirangi;10883;5437;5446;100,2;39,6;50,4
2021;3539103;Pirapora do Bom Jesus;18149;9014;9135;101,3;32,9;167,3
2021;3539202;Pirapozinho;25354;12334;13020;105,6;38,1;53,1
2021;3539301;Pirassununga;73505;35483;38022;107,2;38,8;101,1
2021;3539400;Piratininga;14886;7247;7639;105,4;38,1;37
2021;3539509;Pitangueiras;33945;16926;17019;100,5;35,5;78,8
2021;3539608;Planalto;4417;2198;2219;101;37,4;15,2
2021;3539707;Platina;3059;1551;1508;97,2;37,6;9,3
2021;3539806;Poá;104442;50147;54295;108,3;36;6049,8
2021;3539905;Poloni;5589;2741;2848;103,9;39,7;41,4
2021;3540002;Pompéia;20235;9898;10337;104,4;38,8;25,8
2021;3540101;Pongaí;3428;1729;1699;98,3;41,1;18,7
2021;3540200;Pontal;37905;19135;18770;98,1;34,2;106,4
2021;3540259;Pontalinda;4134;2209;1925;87,1;36,7;19,7
2021;3540309;Pontes Gestal;2402;1191;1211;101,7;39,7;11
2021;3540408;Populina;4169;2052;2117;103,2;40,6;13,2
2021;3540507;Porangaba;10302;5258;5044;95,9;40,9;38,8
2021;3540606;Porto Feliz;55995;28442;27553;96,9;37,1;100,6
2021;3540705;Porto Ferreira;52731;25710;27021;105,1;38,1;215,3
2021;3540754;Potim;20313;11439;8874;77,6;34;455
2021;3540804;Potirendaba;18266;9034;9232;102,2;38,1;53,3
2021;3540853;Pracinha;2583;1868;715;38,3;34,8;41
2021;3540903;Pradópolis;17161;8504;8657;101,8;36,6;102,5
2021;3541000;Praia Grande;343044;162939;180105;110,5;37;2292,3
2021;3541059;Pratânia;5092;2543;2549;100,2;33,9;29,1
2021;3541109;Presidente Alves;3856;1912;1944;101,7;39,4;13,5
2021;3541208;Presidente Bernardes;14476;8011;6465;80,7;40,8;19,3
2021;3541307;Presidente Epitácio;39834;19250;20584;106,9;38,3;31,6
2021;3541406;Presidente Prudente;224996;107619;117377;109,1;38,7;401,3
2021;3541505;Presidente Venceslau;35614;17270;18344;106,2;40,8;47,2
2021;3541604;Promissão;35335;17360;17975;103,5;37,8;45,3
2021;3541653;Quadra;3391;1733;1658;95,7;38,3;16,5
2021;3541703;Quatá;13165;6555;6610;100,8;36,9;20,2
2021;3541802;Queiroz;3214;1613;1601;99,3;34,7;13,7
2021;3541901;Queluz;9344;4650;4694;100,9;36,3;37,5
2021;3542008;Quintana;6955;3395;3560;104,9;37;21,8
2021;3542107;Rafard;8951;4421;4530;102,5;37,1;73,6
2021;3542206;Rancharia;28738;13900;14838;106,7;38,5;18,1
2021;3542305;Redenção da Serra;4467;2335;2132;91,3;40,2;14,4
2021;3542404;Regente Feijó;20079;9885;10194;103,1;38,5;76,3
2021;3542503;Reginópolis;7623;4728;2895;61,2;36,2;18,6
2021;3542602;Registro;59739;29625;30114;101,7;36,7;82,7
2021;3542701;Restinga;6447;3200;3247;101,5;35,3;26,2
2021;3542800;Ribeira;3162;1615;1547;95,8;37,8;9,4
2021;3542909;Ribeirão Bonito;11134;5517;5617;101,8;37,6;23,6
2021;3543006;Ribeirão Branco;18665;9508;9157;96,3;33,8;26,8
2021;3543105;Ribeirão Corrente;4600;2303;2297;99,7;35,1;31
2021;3543204;Ribeirão do Sul;4669;2345;2324;99,1;40;23
2021;3543238;Ribeirão dos Índios;2055;996;1059;106,3;41,4;10,5
2021;3543253;Ribeirão Grande;7477;3841;3636;94,7;37,4;22,4
2021;3543303;Ribeirão Pires;115816;55946;59870;107;38,2;1170,2
2021;3543402;Ribeirão Preto;691787;329320;362467;110,1;37,5;1062,8
2021;3543501;Riversul;5689;2873;2816;98;37,6;14,7
2021;3543600;Rifaina;4002;1998;2004;100,3;38,4;24,6
2021;3543709;Rincão;9267;4606;4661;101,2;37,8;29,3
2021;3543808;Rinópolis;9351;4634;4717;101,8;40,4;26,1
2021;3543907;Rio Claro;200594;96788;103806;107,3;38;402,5
2021;3544004;Rio das Pedras;31234;15585;15649;100,4;35,5;137,8
2021;3544103;Rio Grande da Serra;44303;21656;22647;104,6;35;1219,1
2021;3544202;Riolândia;10339;6303;4036;64;36;16,4
2021;3544251;Rosana;17748;8747;9001;102,9;38,6;23,9
2021;3544301;Roseira;10792;5408;5384;99,6;35,9;83,1
2021;3544400;Rubiácea;2717;1359;1358;99,9;36,6;11,5
2021;3544509;Rubinéia;3765;1863;1902;102,1;42,9;15,5
2021;3544608;Sabino;5154;2500;2654;106,2;41;16,9
2021;3544707;Sagres;2479;1189;1290;108,5;38,6;16,8
2021;3544806;Sales;6400;3152;3248;103;40;20,7
2021;3544905;Sales Oliveira;11368;5493;5875;107;38,3;37,2
2021;3545001;Salesópolis;15273;7586;7687;101,3;37,4;35,9
2021;3545100;Salmourão;4838;2430;2408;99,1;38,1;28
2021;3545159;Saltinho;8093;3970;4123;103,9;39,2;81,1
2021;3545209;Salto;132151;64793;67358;104;36,4;993,2
2021;3545308;Salto de Pirapora;43618;21642;21976;101,5;36,8;155,5
2021;3545407;Salto Grande;9061;4413;4648;105,3;38,5;48,1
2021;3545506;Sandovalina;3657;1835;1822;99,3;36,2;8
2021;3545605;Santa Adélia;14079;6949;7130;102,6;38,6;42,6
2021;3545704;Santa Albertina;6366;3175;3191;100,5;40,3;23,3
2021;3545803;Santa Bárbara d'Oeste;183747;90244;93503;103,6;38,1;678
2021;3546009;Santa Branca;14007;6970;7037;101;39;51,5
2021;3546108;Santa Clara d'Oeste;2572;1291;1281;99,2;38,5;14
2021;3546207;Santa Cruz da Conceição;4274;2092;2182;104,3;41,8;28,5
2021;3546256;Santa Cruz da Esperança;2121;1060;1061;100,1;38,3;14,3
2021;3546306;Santa Cruz das Palmeiras;29038;14405;14633;101,6;37;98,3
2021;3546405;Santa Cruz do Rio Pardo;46370;22563;23807;105,5;38;41,6
2021;3546504;Santa Ernestina;6082;3073;3009;97,9;35,7;45,2
2021;3546603;Santa Fé do Sul;34352;16524;17828;107,9;39,3;166,3
2021;3546702;Santa Gertrudes;23485;11845;11640;98,3;34,1;238,9
2021;3546801;Santa Isabel;53112;26271;26841;102,2;36,7;146,2
2021;3546900;Santa Lúcia;7296;3605;3691;102,4;37;47,4
2021;3547007;Santa Maria da Serra;5256;2652;2604;98,2;36;20,8
2021;3547106;Santa Mercedes;2964;1464;1500;102,5;38,3;17,8
2021;3547205;Santana da Ponte Pensa;1678;839;839;100;43,8;12,9
2021;3547304;Santana de Parnaíba;150141;72895;77246;106;34,8;834,4
2021;3547403;Santa Rita d'Oeste;2726;1330;1396;105;43,2;13
2021;3547502;Santa Rita do Passa Quatro;25053;12009;13044;108,6;41,9;33,2
2021;3547601;Santa Rosa de Viterbo;23541;11378;12163;106,9;39;81,6
2021;3547650;Santa Salete;1632;809;823;101,7;41,3;20,6
2021;3547700;Santo Anastácio;18228;8755;9473;108,2;40,5;33
2021;3547809;Santo André;745426;353919;391507;110,6;38,9;4240,6
2021;3547908;Santo Antônio da Alegria;6725;3435;3290;95,8;38,5;21,7
2021;3548005;Santo Antônio de Posse;23056;11528;11528;100;36;149,6
2021;3548054;Santo Antônio do Aracanguá;8364;4191;4173;99,6;38,5;6,4
2021;3548104;Santo Antônio do Jardim;6127;3090;3037;98,3;39,2;55,7
2021;3548203;Santo Antônio do Pinhal;7093;3566;3527;98,9;38,2;53,3
2021;3548302;Santo Expedito;2990;1463;1527;104,4;40,3;31,7
2021;3548401;Santópolis do Aguapeí;3948;1949;1999;102,6;36,5;30,8
2021;3548500;Santos;420524;190765;229759;120,4;42;1496,4
2021;3548609;São Bento do Sapucaí;11626;5768;5858;101,6;39,7;46
2021;3548708;São Bernardo do Campo;810392;385812;424580;110;37,6;1978,8
2021;3548807;São Caetano do Sul;164892;75387;89505;118,7;41,7;10755,7
2021;3548906;São Carlos;252754;123052;129702;105,4;37,8;222,3
2021;3549003;São Francisco;2636;1296;1340;103,4;42,5;34,9
2021;3549102;São João da Boa Vista;91902;44192;47710;108;39,3;178
2021;3549201;São João das Duas Pontes;2596;1278;1318;103,1;39,8;20,1
2021;3549250;São João de Iracema;1837;911;926;101,6;38,4;10,3
2021;3549300;São João do Pau d'Alho;2251;1107;1144;103,3;42,5;19,1
2021;3549409;São Joaquim da Barra;48551;23545;25006;106,2;37,8;118,2
2021;3549508;São José da Bela Vista;7728;3886;3842;98,9;35,4;27,9
2021;3549607;São José do Barreiro;3884;1955;1929;98,7;38;6,8
2021;3549706;São José do Rio Pardo;52395;25299;27096;107,1;39,4;124,8
2021;3549805;São José do Rio Preto;475501;227049;248452;109,4;38,3;1100,8
2021;3549904;São José dos Campos;693247;334138;359109;107,5;36,8;630,6
2021;3549953;São Lourenço da Serra;15921;7996;7925;99,1;36,6;85,4
2021;3550001;São Luiz do Paraitinga;10387;5240;5147;98,2;40,9;16,8
2021;3550100;São Manuel;37513;18372;19141;104,2;37,6;57,6
2021;3550209;São Miguel Arcanjo;32128;16207;15921;98,2;36,5;34,5
2021;3550308;São Paulo;11480900;5404331;6076569;112,4;37,6;7547,3
2021;3550407;São Pedro;37814;18348;19466;106,1;39,5;61,9
2021;3550506;São Pedro do Turvo;7234;3655;3579;97,9;37,1;9,9
2021;3550605;São Roque;79667;38889;40778;104,9;37,9;259,6
2021;3550704;São Sebastião;81029;39691;41338;104,1;34,8;201,4
2021;3550803;São Sebastião da Grama;10622;5312;5310;100;39,1;42,1
2021;3550902;São Simão;13582;6674;6908;103,5;39,4;22
2021;3551009;São Vicente;331651;159588;172063;107,8;36,9;2238,6
2021;3551108;Sarapuí;10276;5195;5081;97,8;36,9;29,1
2021;3551207;Sarutaiá;3709;1848;1861;100,7;37,5;26,2
2021;3551306;Sebastianópolis do Sul;3140;1514;1626;107,4;39,7;18,7
2021;3551405;Serra Azul;12612;8040;4572;56,9;36,2;44,5
2021;3551504;Serrana;43580;21451;22129;103,2;34,3;345,7
2021;3551603;Serra Negra;29703;14339;15364;107,1;40,5;145,8
2021;3551702;Sertãozinho;125798;61174;64624;105,6;36,1;312,1
2021;3551801;Sete Barras;12806;6510;6296;96,7;36,7;12,1
2021;3551900;Severínia;14720;7564;7156;94,6;36,1;104,8
2021;3552007;Silveiras;6169;3071;3098;100,9;37,4;14,9
2021;3552106;Socorro;39942;19629;20313;103,5;40,6;89
2021;3552205;Sorocaba;713538;345125;368413;106,7;36,5;1586,1
2021;3552304;Sud Mennucci;7394;3675;3719;101,2;38,2;12,4
2021;3552403;Sumaré;277017;135573;141444;104,3;35,2;1805,1
2021;3552502;Suzano;304274;147278;156996;106,6;34,8;1475,4
2021;3552551;Suzanápolis;3417;1746;1671;95,7;38,9;10,3
2021;3552601;Tabapuã;11387;5623;5764;102,5;40;32,9
2021;3552700;Tabatinga;14798;7325;7473;102;36,9;40,1
2021;3552809;Taboão da Serra;272170;129194;142976;110,7;35,3;13349,7
2021;3552908;Taciba;6224;3051;3173;104;36,6;10,2
2021;3553005;Taguaí;12558;6215;6343;102,1;34,8;86,4
2021;3553104;Taiaçu;5721;2902;2819;97,1;38,4;53,4
2021;3553203;Taiúva;6481;3625;2856;78,8;38,8;48,9
2021;3553302;Tambaú;21590;10615;10975;103,4;38,3;38,4
2021;3553401;Tanabi;25234;12428;12806;103;39,4;33,8
2021;3553500;Tapiraí;8015;4029;3986;98,9;35,9;10,6
2021;3553609;Tapiratiba;11953;5795;6158;106,3;39,4;53,9
2021;3553658;Taquaral;2655;1315;1340;101,9;38,5;49,3
2021;3553708;Taquaritinga;52594;25603;26991;105,4;38,6;88,5
2021;3553807;Taquarituba;24296;12532;11764;93,9;36,8;54,2
2021;3553856;Taquarivaí;6752;3441;3311;96,2;33,5;29,1
2021;3553906;Tarabai;6583;3236;3347;103,4;36,4;32,7
2021;3553955;Tarumã;14756;7353;7403;100,7;35,4;48,7
2021;3554003;Tatuí;122769;59976;62793;104,7;36,3;234,4
2021;3554102;Taubaté;309008;149024;159984;107,4;37,4;494,4
2021;3554201;Tejupá;4215;2153;2062;95,8;36,3;14,2
2021;3554300;Teodoro Sampaio;22211;10952;11259;102,8;35,9;14,3
2021;3554409;Terra Roxa;7996;3997;3999;100,1;38,3;36,1
2021;3554508;Tietê;37648;18561;19087;102,8;38,1;93,1
2021;3554607;Timburi;2504;1256;1248;99,4;40,7;12,7
2021;3554656;Torre de Pedra;2076;1045;1031;98,7;40;29,1
2021;3554706;Torrinha;9338;4660;4678;100,4;39,7;29,6
2021;3554755;Trabiju;1671;840;831;98,9;35,4;26,3
2021;3554805;Tremembé;50499;26954;23545;87,4;36,5;264,3
2021;3554904;Três Fronteiras;6712;3363;3349;99,6;39,4;44,3
2021;3554953;Tuiuti;6736;3374;3362;99,6;40,9;53,2
2021;3555000;Tupã;64175;30688;33487;109,1;40,2;102,2
2021;3555109;Tupi Paulista;15762;8031;7731;96,3;41,8;64,4
2021;3555208;Turiúba;1833;923;910;98,6;42,1;12
2021;3555307;Turmalina;1713;834;879;105,4;46,3;11,6
2021;3555356;Ubarana;5388;2753;2635;95,7;35,3;25,7
2021;3555406;Ubatuba;91822;45375;46447;102,4;35,8;129,7
2021;3555505;Ubirajara;5077;2623;2454;93,6;35,7;18
2021;3555604;Uchoa;10353;5099;5254;103;39,8;41
2021;3555703;União Paulista;1617;806;811;100,6;35,3;20,5
2021;3555802;Urânia;8866;4349;4517;103,9;40,8;42,4
2021;3555901;Uru;1387;682;705;103,4;40,3;9,4
2021;3556008;Urupês;13680;6727;6953;103,4;40,4;42,2
2021;3556107;Valentim Gentil;13874;6911;6963;100,8;36,9;92,7
2021;3556206;Valinhos;124928;60890;64038;105,2;38,8;841,1
2021;3556305;Valparaíso;24175;13458;10717;79,6;36,3;28,2
2021;3556354;Vargem;10380;5289;5091;96,3;37;72,8
2021;3556404;Vargem Grande do Sul;40181;19775;20406;103,2;37,8;150,4
2021;3556453;Vargem Grande Paulista;49895;24411;25484;104,4;35,8;1174,3
2021;3556503;Várzea Paulista;115393;57196;58197;101,8;35,2;3285,7
2021;3556602;Vera Cruz;10284;5024;5260;104,7;40,1;41,5
2021;3556701;Vinhedo;75540;36787;38753;105,3;37,9;933,2
2021;3556800;Viradouro;17470;8643;8827;102,1;37;80,2
2021;3556909;Vista Alegre do Alto;8017;4060;3957;97,5;35,1;84
2021;3556958;Vitória Brasil;1801;921;880;95,5;39;36,1
2021;3557006;Votorantim;126560;61789;64771;104,8;35,7;687,1
2021;3557105;Votuporanga;95750;46202;49548;107,2;38,9;227,6
2021;3557154;Zacarias;2681;1337;1344;100,5;39;8,4
2021;3557204;Chavantes;12268;5973;6295;105,4;37,6;65
2021;3557303;Estiva Gerbi;11200;5597;5603;100,1;36,5;151,1
2022;3500105;Adamantina;34681;16699;17982;107,7;41,1;84,2
2022;3500204;Adolfo;4345;2147;2198;102,4;39,7;20,6
2022;3500303;Aguaí;32073;15879;16194;102;37;67,6
2022;3500402;Águas da Prata;7370;3537;3833;108,4;42,8;51,7
2022;3500501;Águas de Lindóia;17925;8716;9209;105,7;41,1;298,1
2022;3500550;Águas de Santa Bárbara;7165;3566;3599;100,9;39,6;17,7
2022;3500600;Águas de São Pedro;2779;1288;1491;115,8;45,8;769,3
2022;3500709;Agudos;37657;18452;19205;104,1;37;39
2022;3500758;Alambari;6131;3089;3042;98,5;37;38,4
2022;3500808;Alfredo Marcondes;4441;2206;2235;101,3;41;37,3
2022;3500907;Altair;3453;1754;1699;96,9;37,5;11
2022;3501004;Altinópolis;16809;8279;8530;103;38,4;18,1
2022;3501103;Alto Alegre;3843;1931;1912;99;43;12,1
2022;3501152;Alumínio;17298;8594;8704;101,3;36;206,9
2022;3501202;Álvares Florence;3915;1983;1932;97,4;43,6;10,8
2022;3501301;Álvares Machado;27227;13218;14009;106;37,5;78,3
2022;3501400;Álvaro de Carvalho;4807;3228;1579;48,9;37;31,3
2022;3501509;Alvinlândia;2886;1428;1458;102,1;37,7;34
2022;3501608;Americana;237044;114400;122644;107,2;39;1770,1
2022;3501707;Américo Brasiliense;33029;16320;16709;102,4;35,9;268,6
2022;3501806;Américo de Campos;5869;2852;3017;105,8;41,3;23,2
2022;3501905;Amparo;67993;33043;34950;105,8;39,6;152,7
2022;3502002;Analândia;4587;2303;2284;99,2;37,9;14,1
2022;3502101;Andradina;59751;29681;30070;101,3;39,3;62
2022;3502200;Angatuba;24009;12036;11973;99,5;37;23,4
2022;3502309;Anhembi;5674;2864;2810;98,1;37;7,7
2022;3502408;Anhumas;4021;1969;2052;104,2;38,7;12,5
2022;3502507;Aparecida;32585;15626;16959;108,5;38,7;269,5
2022;3502606;Aparecida d'Oeste;4088;2027;2061;101,7;42,6;22,8
2022;3502705;Apiaí;24589;12296;12293;100;36,5;25,2
2022;3502754;Araçariguama;21487;10773;10714;99,5;34,1;148
2022;3502804;Araçatuba;199989;95126;104863;110,2;39,2;171,4
2022;3502903;Araçoiaba da Serra;32404;16104;16300;101,2;40;126,9
2022;3503000;Aramina;5418;2638;2780;105,4;39,4;26,7
2022;3503109;Arandu;6879;3452;3427;99,3;36,9;24,1
2022;3503158;Arapeí;2331;1149;1182;102,9;40;14,9
2022;3503208;Araraquara;241977;116053;125924;108,5;38,6;241,1
2022;3503307;Araras;130778;63286;67492;106,6;38,4;202,8
2022;3503356;Arco-Íris;2043;1030;1013;98,3;39,2;7,7
2022;3503406;Arealva;8128;4050;4078;100,7;41,4;16,1
2022;3503505;Areias;3578;1799;1779;98,9;37,9;11,7
2022;3503604;Areiópolis;10133;5110;5023;98,3;35,4;118
2022;3503703;Ariranha;7608;3782;3826;101,2;39,9;57,4
2022;3503802;Artur Nogueira;51402;25311;26091;103,1;36,1;288,7
2022;3503901;Arujá;86590;42019;44571;106,1;35,8;900,4
2022;3503950;Aspásia;1842;917;925;100,9;41,2;26,6
2022;3504008;Assis;101364;48805;52559;107,7;38,7;220,1
2022;3504107;Atibaia;158399;76718;81681;106,5;38;331
2022;3504206;Auriflama;13695;6756;6939;102,7;40,4;31,5
2022;3504305;Avaí;4486;2228;2258;101,3;37,6;8,3
2022;3504404;Avanhandava;11263;6205;5058;81,5;35,8;33,3
2022;3504503;Avaré;92733;45913;46820;102;37,4;76,4
2022;3504602;Bady Bassitt;27142;13311;13831;103,9;35,8;245,9
2022;3504701;Balbinos;3886;3171;715;22,5;37,5;42,4
2022;3504800;Bálsamo;9585;4667;4918;105,4;39,8;64
2022;3504909;Bananal;9971;4839;5132;106,1;38,9;16,2
2022;3505005;Barão de Antonina;3528;1760;1768;100,5;37,9;23
2022;3505104;Barbosa;5646;2751;2895;105,2;37,9;27,5
2022;3505203;Bariri;31595;15483;16112;104,1;38,9;71,1
2022;3505302;Barra Bonita;34352;16541;17811;107,7;40,9;228,8
2022;3505351;Barra do Chapéu;5179;2683;2496;93;35,7;12,8
2022;3505401;Barra do Turvo;6882;3491;3391;97,1;37,6;6,8
2022;3505500;Barretos;122410;58732;63678;108,4;38,1;78,2
2022;3505609;Barrinha;32066;15811;16255;102,8;34,2;219,6
2022;3505708;Barueri;315873;150769;165104;109,5;34,7;4807,8
2022;3505807;Bastos;21495;10502;10993;104,7;38,5;125,8
2022;3505906;Batatais;58388;28350;30038;106;38,9;68,7
2022;3506003;Bauru;378889;183195;195694;106,8;37,9;567,5
2022;3506102;Bebedouro;76364;36958;39406;106,6;38,9;111,8
2022;3506201;Bento de Abreu;2606;1304;1302;99,8;37,5;8,6
2022;3506300;Bernardino de Campos;11601;6128;5473;89,3;39;47,5
2022;3506359;Bertioga;64055;31872;32183;101;34,6;130,3
2022;3506409;Bilac;7317;3596;3721;103,5;40,5;46,3
2022;3506508;Birigui;118905;57508;61397;106,8;38,5;224,3
2022;3506607;Biritiba Mirim;29675;14767;14908;101;36,8;93,5
2022;3506706;Boa Esperança do Sul;12983;6394;6589;103;36,3;18,8
2022;3506805;Bocaina;11256;5503;5753;104,5;37,9;30,9
2022;3506904;Bofete;10454;5317;5137;96,6;39,5;16
2022;3507001;Boituva;60982;30026;30956;103,1;36,7;245
2022;3507100;Bom Jesus dos Perdões;21989;10878;11111;102,1;36,3;202,9
2022;3507159;Bom Sucesso de Itararé;3555;1815;1740;95,9;33,3;26,6
2022;3507209;Borá;906;458;448;97,8;38,7;7,6
2022;3507308;Boracéia;4712;2390;2322;97,2;36,1;38,6
2022;3507407;Borborema;14228;7044;7184;102;40,5;25,8
2022;3507456;Borebi;2710;1328;1382;104,1;35,1;7,8
2022;3507506;Botucatu;145023;69758;75265;107,9;37,8;97,8
2022;3507605;Bragança Paulista;176582;85588;90994;106,3;37,9;344,5
2022;3507704;Braúna;5354;2627;2727;103,8;38,6;27,4
2022;3507753;Brejo Alegre;2565;1291;1274;98,7;39,4;24,3
2022;3507803;Brodowski;25170;12340;12830;104;37,4;90,4
2022;3507902;Brotas;23881;11597;12284;105,9;38,4;21,7
2022;3508009;Buri;20238;10149;10089;99,4;34,2;16,9
2022;3508108;Buritama;17197;8341;8856;106,2;40;52,6
2022;3508207;Buritizal;4354;2128;2226;104,6;39,3;16,3
2022;3508306;Cabrália Paulista;4299;2176;2123;97,6;37,5;17,9
2022;3508405;Cabreúva;46971;23255;23716;102;34,7;180,5
2022;3508504;Caçapava;96117;47040;49077;104,3;37,5;260,5
2022;3508603;Cachoeira Paulista;31554;15231;16323;107,2;38;109,6
2022;3508702;Caconde;17111;8504;8607;101,2;39,5;36,5
2022;3508801;Cafelândia;16654;8050;8604;106,9;38,6;18,1
2022;3508900;Caiabu;3714;1856;1858;100,1;40,6;14,7
2022;3509007;Caieiras;94970;45993;48977;106,5;36,2;972,6
2022;3509106;Caiuá;5463;3289;2174;66,1;38,7;9,9
2022;3509205;Cajamar;92452;45303;47149;104,1;33,7;703,7
2022;3509254;Cajati;28514;14334;14180;98,9;35,2;62,7
2022;3509304;Cajobi;9137;4530;4607;101,7;39,9;51,6
2022;3509403;Cajuru;23827;11843;11984;101,2;37,3;36,1
2022;3509452;Campina do Monte Alegre;5951;2999;2952;98,4;37,8;32,3
2022;3509502;Campinas;1138627;542815;595812;109,8;38,4;1433
2022;3509601;Campo Limpo Paulista;77607;37873;39734;104,9;36,6;977,4
2022;3509700;Campos do Jordão;46980;22931;24049;104,9;36,4;162
2022;3509809;Campos Novos Paulista;4885;2462;2423;98,4;37,4;10,1
2022;3509908;Cananéia;12289;6005;6284;104,6;37,8;9,9
2022;3509957;Canas;4927;2461;2466;100,2;34,6;92,5
2022;3510005;Cândido Mota;29452;14312;15140;105,8;39,2;49,4
2022;3510104;Cândido Rodrigues;2887;1434;1453;101,3;42;40,7
2022;3510153;Canitar;6267;3081;3186;103,4;33,1;109,1
2022;3510203;Capão Bonito;46336;22952;23384;101,9;36,4;28,2
2022;3510302;Capela do Alto;22824;12505;10319;82,5;35,5;134,3
2022;3510401;Capivari;50057;24529;25528;104,1;37;155
2022;3510500;Caraguatatuba;134601;65416;69185;105,8;36,7;277,6
2022;3510609;Carapicuíba;386860;185875;200985;108,1;35,3;11198,5
2022;3510708;Cardoso;11348;5546;5802;104,6;41,7;17,8
2022;3510807;Casa Branca;28085;14539;13546;93,2;38,5;32,5
2022;3510906;Cássia dos Coqueiros;2798;1430;1368;95,7;41,5;14,6
2022;3511003;Castilho;19963;9833;10130;103;38,3;18,7
2022;3511102;Catanduva;115770;55456;60314;108,8;39,6;398,4
2022;3511201;Catiguá;7004;3488;3516;100,8;38,5;47,2
2022;3511300;Cedral;12578;6201;6377;102,8;38;63,6
2022;3511409;Cerqueira César;21439;11158;10281;92,1;36,7;41,9
2022;3511508;Cerquilho;44658;21747;22911;105,4;38;349,4
2022;3511607;Cesário Lange;19021;9756;9265;95;36,5;99,9
2022;3511706;Charqueada;15532;7747;7785;100,5;37;88,3
2022;3511904;Clementina;6983;3467;3516;101,4;36,5;41,4
2022;3512001;Colina;18478;8942;9536;106,6;37,9;43,8
2022;3512100;Colômbia;6624;3336;3288;98,6;36,9;9,1
2022;3512209;Conchal;28080;14003;14077;100,5;35,4;153,6
2022;3512308;Conchas;15239;7631;7608;99,7;39,4;32,7
2022;3512407;Cordeirópolis;24488;12079;12409;102,7;36,1;178
2022;3512506;Coroados;5399;2669;2730;102,3;38,8;21,9
2022;3512605;Coronel Macedo;4285;2166;2119;97,8;39,7;14,1
2022;3512704;Corumbataí;4193;2095;2098;100,1;36,9;15
2022;3512803;Cosmópolis;59766;29324;30442;103,8;36,7;386,4
2022;3512902;Cosmorama;8708;4328;4380;101,2;39,4;19,7
2022;3513009;Cotia;273822;132655;141167;106,4;34,9;845,1
2022;3513108;Cravinhos;33270;16364;16906;103,3;37,8;106,8
2022;3513207;Cristais Paulista;9259;4588;4671;101,8;37,2;24
2022;3513306;Cruzália;2109;1031;1078;104,6;41,7;14,1
2022;3513405;Cruzeiro;74975;35993;38982;108,3;38,5;245,3
2022;3513504;Cubatão;112518;54015;58503;108,3;35,4;787,5
2022;3513603;Cunha;22108;11240;10868;96,7;39,5;15,7
2022;3513702;Descalvado;31751;15560;16191;104,1;39,3;42,1
2022;3513801;Diadema;393187;187603;205584;109,6;36,2;12794,1
2022;3513850;Dirce Reis;1620;828;792;95,7;42,2;18,4
2022;3513900;Divinolândia;11158;5524;5634;102;40,9;49,9
2022;3514007;Dobrada;8753;4348;4405;101,3;35;58,5
2022;3514106;Dois Córregos;24512;12082;12430;102,9;37,8;38,7
2022;3514205;Dolcinópolis;2206;1108;1098;99,1;41,1;28,3
2022;3514304;Dourado;8099;4000;4099;102,5;40,5;39,3
2022;3514403;Dracena;45458;22279;23179;104;40,4;93,2
2022;3514502;Duartina;12327;6020;6307;104,8;40,9;46,6
2022;3514601;Dumont;9461;4700;4761;101,3;36,1;84,9
2022;3514700;Echaporã;6206;3056;3150;103,1;38,5;12
2022;3514809;Eldorado;13079;6561;6518;99,3;36;7,9
2022;3514908;Elias Fausto;17685;8871;8814;99,4;36,1;87,4
2022;3514924;Elisiário;3138;1591;1547;97,2;39,2;33,4
2022;3514957;Embaúba;2324;1192;1132;95;40,8;28
2022;3515004;Embu das Artes;250617;120594;130023;107,8;34,4;3560
2022;3515103;Embu-Guaçu;66940;32920;34020;103,3;35,8;430,1
2022;3515129;Emilianópolis;3014;1492;1522;102;41,6;13,4
2022;3515152;Engenheiro Coelho;19536;9798;9738;99,4;33,6;177,7
2022;3515186;Espírito Santo do Pinhal;39830;19302;20528;106,4;40,1;102,3
2022;3515194;Espírito Santo do Turvo;4158;2069;2089;101;34,8;21,5
2022;3515202;Estrela d'Oeste;9408;4783;4625;96,7;39,4;31,8
2022;3515301;Estrela do Norte;2703;1325;1378;104;38,4;10,2
2022;3515350;Euclides da Cunha Paulista;7934;3899;4035;103,5;38,4;13,8
2022;3515400;Fartura;16631;8114;8517;105;39;38,8
2022;3515509;Fernandópolis;71139;34190;36949;108,1;39,7;129,4
2022;3515608;Fernando Prestes;5939;2902;3037;104,7;40,8;34,9
2022;3515657;Fernão;1655;840;815;97;38,6;16,5
2022;3515707;Ferraz de Vasconcelos;179120;86590;92530;106,9;34,6;6062,1
2022;3515806;Flora Rica;1489;732;757;103,4;43,3;6,6
2022;3515905;Floreal;2735;1330;1405;105,6;45,1;13,4
2022;3516002;Flórida Paulista;12957;7088;5869;82,8;38,9;24,7
2022;3516101;Florínea;3843;2477;1366;55,1;38,7;17
2022;3516200;Franca;352289;170770;181519;106,3;37,3;581,6
2022;3516309;Francisco Morato;165062;80715;84347;104,5;33,5;3368,5
2022;3516408;Franco da Rocha;144753;72695;72058;99,1;34,7;1090,2
2022;3516507;Gabriel Monteiro;2763;1384;1379;99,6;41,6;19,9
2022;3516606;Gália;6384;3134;3250;103,7;41,1;17,9
2022;3516705;Garça;42117;20288;21829;107,6;39,3;75,8
2022;3516804;Gastão Vidigal;3258;1584;1674;105,7;40,1;18
2022;3516853;Gavião Peixoto;4700;2333;2367;101,5;36;19,3
2022;3516903;General Salgado;10314;5080;5234;103;40,9;20,9
2022;3517000;Getulina;10236;5617;4619;82,2;39,2;15,1
2022;3517109;Glicério;4141;2033;2108;103,7;40;15,2
2022;3517208;Guaiçara;11235;5553;5682;102,3;36,6;40,5
2022;3517307;Guaimbê;5511;2738;2773;101,3;38,3;25,3
2022;3517406;Guaíra;39266;19135;20131;105,2;38,1;31,2
2022;3517505;Guapiaçu;21682;10744;10938;101,8;36,8;66,7
2022;3517604;Guapiara;17077;8654;8423;97,3;37,6;41,8
2022;3517703;Guará;18614;9094;9520;104,7;37;51,4
2022;3517802;Guaraçaí;7447;3673;3774;102,7;42,7;13,1
2022;3517901;Guaraci;10347;5172;5175;100,1;38,5;16,1
2022;3518008;Guarani d'Oeste;1968;981;987;100,6;41,3;23
2022;3518107;Guarantã;6427;3175;3252;102,4;37,1;13,9
2022;3518206;Guararapes;31040;15102;15938;105,5;39,6;32,5
2022;3518305;Guararema;31195;15375;15820;102,9;37,5;115,2
2022;3518404;Guaratinguetá;118001;56517;61484;108,8;38,8;156,8
2022;3518503;Guareí;15010;9018;5992;66,4;37,2;26,4
2022;3518602;Guariba;37484;18064;19420;107,5;35,9;138,7
2022;3518701;Guarujá;287656;138138;149518;108,2;36;1986,7
2022;3518800;Guarulhos;1291273;620569;670704;108,1;35,5;4052
2022;3518859;Guatapará;7317;3677;3640;99;37,4;17,7
2022;3518909;Guzolândia;4249;2179;2070;95;38,7;16,8
2022;3519006;Herculândia;9122;4475;4647;103,8;37,7;25
2022;3519055;Holambra;15064;7470;7594;101,7;36,6;229,7
2022;3519071;Hortolândia;236304;117153;119151;101,7;35;3786
2022;3519105;Iacanga;10434;5170;5264;101,8;38,3;19,1
2022;3519204;Iacri;6133;3046;3087;101,3;40;19
2022;3519253;Iaras;7997;5409;2588;47,8;38,4;19,9
2022;3519303;Ibaté;32168;16030;16138;100,7;35,3;110,6
2022;3519402;Ibirá;11684;5715;5969;104,4;39,7;43
2022;3519501;Ibirarema;6387;3160;3227;102,1;39;28
2022;3519600;Ibitinga;59982;29424;30558;103,9;37,4;87
2022;3519709;Ibiúna;75574;37896;37678;99,4;36,9;71,4
2022;3519808;Icém;7816;4309;3507;81,4;38;21,6
2022;3519907;Iepê;7619;3695;3924;106,2;39,7;12,8
2022;3520004;Igaraçu do Tietê;23108;11490;11618;101,1;37,7;236,4
2022;3520103;Igarapava;26224;12666;13558;107;38,8;56
2022;3520202;Igaratá;10592;5295;5297;100;37,6;36,2
2022;3520301;Iguape;29113;14602;14511;99,4;39,2;14,7
2022;3520400;Ilhabela;34882;17250;17632;102,2;35,5;100,7
2022;3520426;Ilha Comprida;13382;6591;6791;103;42;68,1
2022;3520442;Ilha Solteira;25546;12351;13195;106,8;40,6;39,1
2022;3520509;Indaiatuba;255326;124693;130633;104,8;37,4;819,5
2022;3520608;Indiana;5088;2567;2521;98,2;39,2;39,3
2022;3520707;Indiaporã;4034;1959;2075;105,9;42,3;14,4
2022;3520806;Inúbia Paulista;3615;1775;1840;103,7;40,1;41,5
2022;3520905;Ipaussu;13712;6724;6988;103,9;37,3;65,4
2022;3521002;Iperó;36395;19539;16856;86,3;35;213,7
2022;3521101;Ipeúna;6825;3416;3409;99,8;36,6;35,9
2022;3521150;Ipiguá;6742;3392;3350;98,8;37,8;49,6
2022;3521200;Iporanga;4048;2046;2002;97,8;36,2;3,5
2022;3521309;Ipuã;14452;7192;7260;100,9;36,3;31
2022;3521408;Iracemápolis;21953;10888;11065;101,6;37;190,7
2022;3521507;Irapuã;6870;3466;3404;98,2;38,4;26,7
2022;3521606;Irapuru;7090;4068;3022;74,3;40,6;33,1
2022;3521705;Itaberá;17982;9005;8977;99,7;37,3;16,3
2022;3521804;Itaí;25172;13049;12123;92,9;36,5;23
2022;3521903;Itajobi;16971;8478;8493;100,2;39;33,8
2022;3522000;Itaju;3615;1811;1804;99,6;38;15,7
2022;3522109;Itanhaém;112276;53995;58281;107,9;38,9;186,6
2022;3522158;Itaoca;3421;1706;1715;100,5;38,1;18,7
2022;3522208;Itapecerica da Serra;158480;77385;81095;104,8;34,8;1051,3
2022;3522307;Itapetininga;157693;78700;78993;100,4;36,4;88,1
2022;3522406;Itapeva;89714;44027;45687;103,8;36,1;49,1
2022;3522505;Itapevi;232062;113085;118977;105,2;33,4;2807,5
2022;3522604;Itapira;71997;35260;36737;104,2;39,3;138,9
2022;3522653;Itapirapuã Paulista;4303;2225;2078;93,4;34,1;10,6
2022;3522703;Itápolis;39497;19330;20167;104,3;39,4;39,6
2022;3522802;Itaporanga;14088;6919;7169;103,6;38,4;27,7
2022;3522901;Itapuí;13648;6789;6859;101;36;97,5
2022;3523008;Itapura;3982;1995;1987;99,6;39;13,2
2022;3523107;Itaquaquecetuba;368922;180109;188813;104,8;33,5;4465,2
2022;3523206;Itararé;44461;21643;22818;105,4;37,1;44,3
2022;3523305;Itariri;15528;7708;7820;101,5;36,2;56,7
2022;3523404;Itatiba;121437;59388;62049;104,5;37,8;376,8
2022;3523503;Itatinga;19063;10095;8968;88,8;35;19,5
2022;3523602;Itirapina;16144;9505;6639;69,8;36,6;28,6
2022;3523701;Itirapuã;5780;2930;2850;97,3;37;35,9
2022;3523800;Itobi;8042;4087;3955;96,8;37,9;57,9
2022;3523909;Itu;168138;82110;86028;104,8;36,9;262,4
2022;3524006;Itupeva;70394;35255;35139;99,7;34,4;350,4
2022;3524105;Ituverava;37579;18152;19427;107;39,3;53,3
2022;3524204;Jaborandi;6224;3086;3138;101,7;38,8;22,8
2022;3524303;Jaboticabal;71820;34235;37585;109,8;39,4;101,6
2022;3524402;Jacareí;240060;115763;124297;107,4;37,5;517,1
2022;3524501;Jaci;7597;3839;3758;97,9;35,7;52,3
2022;3524600;Jacupiranga;16104;7982;8122;101,8;37,1;22,9
2022;3524709;Jaguariúna;59227;28746;30481;106;36,6;418,9
2022;3524808;Jales;48764;23563;25201;107;40,7;132,3
2022;3524907;Jambeiro;6389;3201;3188;99,6;38;34,6
2022;3525003;Jandira;117975;57134;60841;106,5;34,9;6761,1
2022;3525102;Jardinópolis;45224;23410;21814;93,2;36,2;90,1
2022;3525201;Jarinu;37417;18770;18647;99,3;35,6;180,3
2022;3525300;Jaú;133480;64454;69026;107,1;38,9;194,3
2022;3525409;Jeriquara;3858;1988;1870;94,1;34,4;27,2
2022;3525508;Joanópolis;12807;6484;6323;97,5;38,8;34,2
2022;3525607;João Ramalho;4369;2169;2200;101,4;36,5;10,5
2022;3525706;José Bonifácio;36605;18029;18576;103;37,6;42,6
2022;3525805;Júlio Mesquita;4255;2080;2175;104,6;37,7;33,2
2022;3525854;Jumirim;3054;1520;1534;100,9;36,2;53,9
2022;3525904;Jundiaí;442667;213472;229195;107,4;38,5;1026,6
2022;3526001;Junqueirópolis;20436;10686;9750;91,2;39,4;35,1
2022;3526100;Juquiá;17168;8598;8570;99,7;38,2;21,1
2022;3526209;Juquitiba;27413;13791;13622;98,8;36,6;52,5
2022;3526308;Lagoinha;5081;2576;2505;97,2;42;19,9
2022;3526407;Laranjal Paulista;26254;12814;13440;104,9;38,1;68,3
2022;3526506;Lavínia;9682;7176;2506;34,9;37,4;18
2022;3526605;Lavrinhas;7167;3559;3608;101,4;35,2;42,9
2022;3526704;Leme;98115;48122;49993;103,9;36,9;243,5
2022;3526803;Lençóis Paulista;66468;32756;33712;102,9;37,1;82,1
2022;3526902;Limeira;291756;142006;149750;105,5;38,3;502,4
2022;3527009;Lindóia;7012;3454;3558;103;39,3;143,8
2022;3527108;Lins;74755;35873;38882;108,4;38,9;131,1
2022;3527207;Lorena;84839;40611;44228;108,9;38;204,8
2022;3527256;Lourdes;1951;974;977;100,3;41,7;17,1
2022;3527306;Louveira;51727;25722;26005;101,1;34,1;928
2022;3527405;Lucélia;20060;11159;8901;79,8;40,4;63,7
2022;3527504;Lucianópolis;2371;1193;1178;98,7;39,3;12,5
2022;3527603;Luís Antônio;12258;6126;6132;100,1;35,1;20,5
2022;3527702;Luiziânia;4703;2347;2356;100,4;37,5;28,2
2022;3527801;Lupércio;3983;1942;2041;105,1;38,4;25,7
2022;3527900;Lutécia;2661;1316;1345;102,2;39,1;5,6
2022;3528007;Macatuba;16825;8312;8513;102,4;37,1;74,9
2022;3528106;Macaubal;7482;3733;3749;100,4;41,9;30,2
2022;3528205;Macedônia;3961;1948;2013;103,3;41,5;12,1
2022;3528304;Magda;3165;1545;1620;104,9;42,4;10,1
2022;3528403;Mairinque;49976;25124;24852;98,9;36,8;237,8
2022;3528502;Mairiporã;93757;46579;47178;101,3;37;292,4
2022;3528601;Manduri;9865;4885;4980;101,9;38,8;43,1
2022;3528700;Marabá Paulista;4575;2854;1721;60,3;37,6;5
2022;3528809;Maracaí;12677;6261;6416;102,5;38,5;23,8
2022;3528858;Marapoama;3287;1663;1624;97,7;38,6;29,5
2022;3528908;Mariápolis;3516;1755;1761;100,3;40,3;18,8
2022;3529005;Marília;237475;113792;123683;108,7;38,4;202,9
2022;3529104;Marinópolis;1862;934;928;99,4;41,9;23,9
2022;3529203;Martinópolis;24876;12791;12085;94,5;38,7;19,8
2022;3529302;Matão;79017;38763;40254;103,8;38,7;150,5
2022;3529401;Mauá;418253;201340;216913;107,7;36,1;6752,9
2022;3529500;Mendonça;6147;3103;3044;98,1;38,7;31,5
2022;3529609;Meridiano;4567;2240;2327;103,9;39,6;20
2022;3529658;Mesópolis;1952;990;962;97,2;38,6;13,1
2022;3529708;Miguelópolis;19448;9532;9916;104;37,1;23,7
2022;3529807;Mineiros do Tietê;11235;5576;5659;101,5;38,4;52,7
2022;3529906;Miracatu;18566;9246;9320;100,8;37,1;18,5
2022;3530003;Mira Estrela;3124;1557;1567;100,6;42,2;14,4
2022;3530102;Mirandópolis;27979;15901;12078;76;40,8;30,5
2022;3530201;Mirante do Paranapanema;15925;7926;7999;100,9;40,1;12,9
2022;3530300;Mirassol;63265;30668;32597;106,3;38,3;260,1
2022;3530409;Mirassolândia;4666;2345;2321;99;38,6;28,1
2022;3530508;Mococa;67671;33184;34487;103,9;39,5;79,1
2022;3530607;Mogi das Cruzes;451028;216957;234071;107,9;36,3;633
2022;3530706;Mogi Guaçu;153538;74766;78772;105,4;37,8;188,9
2022;3530805;Mogi Mirim;92515;44967;47548;105,7;39,1;185,9
2022;3530904;Mombuca;3719;1825;1894;103,8;35,4;27,8
2022;3531001;Monções;1938;963;975;101,2;43,2;18,6
2022;3531100;Mongaguá;61826;31446;30380;96,6;39,4;433,1
2022;3531209;Monte Alegre do Sul;8616;4267;4349;101,9;41,2;78,1
2022;3531308;Monte Alto;47567;23263;24304;104,5;40,1;137,1
2022;3531407;Monte Aprazível;22276;10881;11395;104,7;39,9;45
2022;3531506;Monte Azul Paulista;18156;9087;9069;99,8;39,9;68,9
2022;3531605;Monte Castelo;4221;2093;2128;101,7;39,9;18,1
2022;3531704;Monteiro Lobato;4138;2067;2071;100,2;39,2;12,4
2022;3531803;Monte Mor;64537;31810;32727;102,9;34,9;268,3
2022;3531902;Morro Agudo;27941;13695;14246;104;36,3;20,1
2022;3532009;Morungaba;13705;6699;7006;104,6;36,8;93,4
2022;3532058;Motuca;4036;2042;1994;97,6;38,3;17,6
2022;3532108;Murutinga do Sul;3740;1856;1884;101,5;43,1;14,9
2022;3532157;Nantes;2660;1305;1355;103,8;36,5;9,3
2022;3532207;Narandiba;5702;2826;2876;101,8;34,8;16
2022;3532306;Natividade da Serra;6997;3638;3359;92,3;40,7;8,4
2022;3532405;Nazaré Paulista;18204;9232;8972;97,2;38,3;55,8
2022;3532504;Neves Paulista;9692;4798;4894;102;41,5;44,2
2022;3532603;Nhandeara;9858;4743;5115;107,8;42,8;22,6
2022;3532702;Nipoã;4747;2431;2316;95,3;36,2;34,5
2022;3532801;Nova Aliança;6687;3284;3403;103,6;38,4;30,7
2022;3532827;Nova Campina;8497;4238;4259;100,5;33,7;22
2022;3532843;Nova Canaã Paulista;2033;1009;1024;101,5;44,8;16,3
2022;3532868;Nova Castilho;1062;521;541;103,8;38,4;5,8
2022;3532900;Nova Europa;9311;4657;4654;99,9;37,1;58,1
2022;3533007;Nova Granada;19417;9612;9805;102;38,3;36,5
2022;3533106;Nova Guataporanga;2156;1058;1098;103,8;40,9;63,1
2022;3533205;Nova Independência;4596;2526;2070;81,9;35,3;17,3
2022;3533254;Novais;4413;2218;2195;99;34,9;37,5
2022;3533304;Nova Luzitânia;2841;1434;1407;98,1;39,8;38,5
2022;3533403;Nova Odessa;61937;30270;31667;104,6;37,7;839,4
2022;3533502;Novo Horizonte;38312;18859;19453;103,1;38,9;41,1
2022;3533601;Nuporanga;7387;3644;3743;102,7;38;21,2
2022;3533700;Ocauçu;4330;2212;2118;95,8;38,6;14,4
2022;3533809;Óleo;2513;1286;1227;95,4;40,6;12,6
2022;3533908;Olímpia;55037;26722;28315;106;38,1;68,6
2022;3534005;Onda Verde;4764;2393;2371;99,1;36,6;19,6
2022;3534104;Oriente;6085;2923;3162;108,2;40,2;27,8
2022;3534203;Orindiúva;6022;3013;3009;99,9;36,1;24,3
2022;3534302;Orlândia;38329;18505;19824;107,1;38,7;131,4
2022;3534401;Osasco;728166;346267;381899;110,3;36,5;11210,5
2022;3534500;Oscar Bressane;2470;1181;1289;109,1;43,2;11,1
2022;3534609;Osvaldo Cruz;31270;15566;15704;100,9;40,9;126,1
2022;3534708;Ourinhos;103963;49464;54499;110,2;38,5;351,4
2022;3534757;Ouroeste;10280;5061;5219;103,1;38,5;35,6
2022;3534807;Ouro Verde;7779;3759;4020;106,9;37,3;29,2
2022;3534906;Pacaembu;14865;9828;5037;51,3;39,3;43,8
2022;3535002;Palestina;11473;5718;5755;100,6;39,3;16,4
2022;3535101;Palmares Paulista;9658;4847;4811;99,3;35,6;117,6
2022;3535200;Palmeira d'Oeste;8908;4436;4472;100,8;43,1;27,9
2022;3535309;Palmital;19605;9518;10087;106;40,6;35,7
2022;3535408;Panorama;14961;7387;7574;102,5;36,7;42
2022;3535507;Paraguaçu Paulista;41128;20512;20616;100,5;38,1;41,1
2022;3535606;Paraibuna;17665;8916;8749;98,1;38,8;21,8
2022;3535705;Paraíso;6098;3079;3019;98,1;39,7;39,3
2022;3535804;Paranapanema;19384;9842;9542;97;35,7;19
2022;3535903;Paranapuã;4029;2012;2017;100,2;38,8;28,7
2022;3536000;Parapuã;10582;5244;5338;101,8;41,1;28,9
2022;3536109;Pardinho;7141;3619;3522;97,3;36,5;34
2022;3536208;Pariquera-Açu;19227;9514;9713;102,1;37,3;53,5
2022;3536257;Parisi;2885;1390;1495;107,6;39,9;34
2022;3536307;Patrocínio Paulista;14501;7306;7195;98,5;36,3;24,1
2022;3536406;Paulicéia;7942;3992;3950;98,9;36,6;21,2
2022;3536505;Paulínia;110309;53518;56791;106,1;36,3;794,9
2022;3536570;Paulistânia;2088;1043;1045;100,2;37,7;8,2
2022;3536604;Paulo de Faria;7408;3721;3687;99,1;40;10
2022;3536703;Pederneiras;44803;22255;22548;101,3;37,2;61,6
2022;3536802;Pedra Bela;6551;3394;3157;93;40;41,3
2022;3536901;Pedranópolis;2785;1391;1394;100,2;42,8;10,7
2022;3537008;Pedregulho;15526;7779;7747;99,6;37,4;21,8
2022;3537107;Pedreira;43101;21101;22000;104,3;38,6;396,1
2022;3537156;Pedrinhas Paulista;2805;1365;1440;105,5;41,1;18,4
2022;3537206;Pedro de Toledo;11273;5767;5506;95,5;38,3;16,8
2022;3537305;Penápolis;61656;29675;31981;107,8;39,2;86,7
2022;3537404;Pereira Barreto;24101;11671;12430;106,5;39,9;24,7
2022;3537503;Pereiras;8727;4370;4357;99,7;37,7;39,1
2022;3537602;Peruíbe;68288;32904;35384;107,5;39,1;209,3
2022;3537701;Piacatu;5517;2732;2785;101,9;39,8;23,7
2022;3537800;Piedade;52964;26591;26373;99,2;38,3;70,9
2022;3537909;Pilar do Sul;27610;13949;13661;97,9;37,3;40,5
2022;3538006;Pindamonhangaba;165292;80073;85219;106,4;36,8;226
2022;3538105;Pindorama;14545;7242;7303;100,8;40,3;78,7
2022;3538204;Pinhalzinho;15208;7563;7645;101,1;40,2;98,4
2022;3538303;Piquerobi;3266;1554;1712;110,2;40,4;6,8
2022;3538501;Piquete;12501;5983;6518;108,9;40,5;71
2022;3538600;Piracaia;26023;12704;13319;104,8;39,7;67,5
2022;3538709;Piracicaba;422884;204581;218303;106,7;37,8;306,9
2022;3538808;Piraju;29429;14238;15191;106,7;39,2;58,3
2022;3538907;Pirajuí;22433;11744;10689;91;38,9;27,2
2022;3539004;Pirangi;10883;5426;5457;100,6;39,9;50,4
2022;3539103;Pirapora do Bom Jesus;18350;9103;9247;101,6;33,3;169,1
2022;3539202;Pirapozinho;25343;12328;13015;105,6;38,4;53,1
2022;3539301;Pirassununga;73520;35447;38073;107,4;39,2;101,1
2022;3539400;Piratininga;15084;7333;7751;105,7;38,3;37,5
2022;3539509;Pitangueiras;33685;16762;16923;101;35,9;78,2
2022;3539608;Planalto;4390;2177;2213;101,7;38;15,1
2022;3539707;Platina;3026;1517;1509;99,5;38,1;9,2
2022;3539806;Poá;103780;49771;54009;108,5;36,5;6011,5
2022;3539905;Poloni;5591;2746;2845;103,6;40,1;41,4
2022;3540002;Pompéia;20194;9872;10322;104,6;39,2;25,7
2022;3540101;Pongaí;3396;1702;1694;99,5;41,5;18,5
2022;3540200;Pontal;37625;18918;18707;98,9;34,6;105,6
2022;3540259;Pontalinda;4127;2190;1937;88,4;37,2;19,7
2022;3540309;Pontes Gestal;2388;1187;1201;101,2;40,4;11
2022;3540408;Populina;4128;2027;2101;103,7;41,1;13,1
2022;3540507;Porangaba;10435;5327;5108;95,9;41,4;39,3
2022;3540606;Porto Feliz;56440;28687;27753;96,7;37,5;101,4
2022;3540705;Porto Ferreira;52640;25618;27022;105,5;38,4;214,9
2022;3540754;Potim;20385;11481;8904;77,6;34,4;456,6
2022;3540804;Potirendaba;18473;9119;9354;102,6;38,3;53,9
2022;3540853;Pracinha;2580;1844;736;39,9;35,2;40,9
2022;3540903;Pradópolis;17080;8442;8638;102,3;37,1;102
2022;3541000;Praia Grande;349233;165664;183569;110,8;37,4;2333,6
2022;3541059;Pratânia;5122;2561;2561;100;34,1;29,3
2022;3541109;Presidente Alves;3806;1880;1926;102,4;40,1;13,3
2022;3541208;Presidente Bernardes;14483;8096;6387;78,9;41,1;19,3
2022;3541307;Presidente Epitácio;39517;19071;20446;107,2;38,8;31,4
2022;3541406;Presidente Prudente;225537;107801;117736;109,2;39;402,3
2022;3541505;Presidente Venceslau;35219;17034;18185;106,8;41,2;46,6
2022;3541604;Promissão;35135;17236;17899;103,8;38,1;45,1
2022;3541653;Quadra;3404;1734;1670;96,3;38,7;16,6
2022;3541703;Quatá;13160;6546;6614;101;37,3;20,2
2022;3541802;Queiroz;3262;1628;1634;100,4;35,4;13,9
2022;3541901;Queluz;9172;4553;4619;101,4;36,8;36,8
2022;3542008;Quintana;7030;3421;3609;105,5;37,2;22
2022;3542107;Rafard;8962;4426;4536;102,5;37,4;73,7
2022;3542206;Rancharia;28589;13808;14781;107;38,8;18
2022;3542305;Redenção da Serra;4489;2350;2139;91;40,9;14,5
2022;3542404;Regente Feijó;20133;9890;10243;103,6;38,9;76,5
2022;3542503;Reginópolis;7660;4739;2921;61,6;36,5;18,7
2022;3542602;Registro;59906;29723;30183;101,5;37,1;82,9
2022;3542701;Restinga;6405;3178;3227;101,5;35,8;26,1
2022;3542800;Ribeira;3134;1591;1543;97;38,4;9,3
2022;3542909;Ribeirão Bonito;10997;5456;5541;101,6;38,2;23,3
2022;3543006;Ribeirão Branco;18624;9476;9148;96,5;34,2;26,7
2022;3543105;Ribeirão Corrente;4606;2304;2302;99,9;35,7;31,1
2022;3543204;Ribeirão do Sul;4675;2339;2336;99,9;40,3;23
2022;3543238;Ribeirão dos Índios;2026;969;1057;109,1;42,4;10,3
2022;3543253;Ribeirão Grande;7450;3826;3624;94,7;38;22,3
2022;3543303;Ribeirão Pires;115542;55733;59809;107,3;38,6;1167,4
2022;3543402;Ribeirão Preto;697942;331987;365955;110,2;37,8;1072,2
2022;3543501;Riversul;5603;2820;2783;98,7;38,1;14,5
2022;3543600;Rifaina;4044;2025;2019;99,7;38,7;24,9
2022;3543709;Rincão;9107;4523;4584;101,3;38,3;28,8
2022;3543808;Rinópolis;9264;4581;4683;102,2;40,8;25,8
2022;3543907;Rio Claro;201309;97063;104246;107,4;38,3;403,9
2022;3544004;Rio das Pedras;31315;15604;15711;100,7;35,9;138,2
2022;3544103;Rio Grande da Serra;44169;21560;22609;104,9;35,5;1215,4
2022;3544202;Riolândia;10311;6324;3987;63;36,4;16,3
2022;3544251;Rosana;17455;8583;8872;103,4;39,3;23,5
2022;3544301;Roseira;10823;5411;5412;100;36,3;83,4
2022;3544400;Rubiácea;2700;1351;1349;99,9;36,9;11,4
2022;3544509;Rubinéia;3825;1889;1936;102,5;43,4;15,7
2022;3544608;Sabino;5113;2487;2626;105,6;41,6;16,7
2022;3544707;Sagres;2473;1198;1275;106,4;39,1;16,7
2022;3544806;Sales;6430;3161;3269;103,4;40,5;20,8
2022;3544905;Sales Oliveira;11405;5506;5899;107,1;38,7;37,3
2022;3545001;Salesópolis;15205;7528;7677;102;37,8;35,8
2022;3545100;Salmourão;4808;2417;2391;98,9;38,5;27,8
2022;3545159;Saltinho;8153;3999;4154;103,9;39,6;81,7
2022;3545209;Salto;134094;65698;68396;104,1;36,7;1007,8
2022;3545308;Salto de Pirapora;43722;21689;22033;101,6;37,2;155,9
2022;3545407;Salto Grande;9048;4402;4646;105,5;39;48
2022;3545506;Sandovalina;3645;1833;1812;98,9;36,8;8
2022;3545605;Santa Adélia;14020;6910;7110;102,9;39;42,5
2022;3545704;Santa Albertina;6388;3172;3216;101,4;40,7;23,4
2022;3545803;Santa Bárbara d'Oeste;183324;89943;93381;103,8;38,5;676,4
2022;3546009;Santa Branca;13974;6952;7022;101;39,5;51,3
2022;3546108;Santa Clara d'Oeste;2594;1301;1293;99,4;38,9;14,1
2022;3546207;Santa Cruz da Conceição;4275;2095;2180;104,1;42,4;28,5
2022;3546256;Santa Cruz da Esperança;2115;1057;1058;100,1;39,2;14,3
2022;3546306;Santa Cruz das Palmeiras;28871;14282;14589;102,1;37,4;97,8
2022;3546405;Santa Cruz do Rio Pardo;46424;22563;23861;105,8;38,3;41,6
2022;3546504;Santa Ernestina;6114;3067;3047;99,3;36,2;45,5
2022;3546603;Santa Fé do Sul;34752;16707;18045;108;39,6;168,3
2022;3546702;Santa Gertrudes;23597;11895;11702;98,4;34,5;240,1
2022;3546801;Santa Isabel;53155;26257;26898;102,4;37,1;146,3
2022;3546900;Santa Lúcia;7156;3533;3623;102,5;37,7;46,5
2022;3547007;Santa Maria da Serra;5244;2642;2602;98,5;36,6;20,8
2022;3547106;Santa Mercedes;2955;1456;1499;103;38,7;17,7
2022;3547205;Santana da Ponte Pensa;1670;832;838;100,7;45,2;12,9
2022;3547304;Santana de Parnaíba;153733;74507;79226;106,3;35,2;854,3
2022;3547403;Santa Rita d'Oeste;2732;1323;1409;106,5;43,5;13
2022;3547502;Santa Rita do Passa Quatro;24844;11901;12943;108,8;42,3;32,9
2022;3547601;Santa Rosa de Viterbo;23414;11299;12115;107,2;39,4;81,1
2022;3547650;Santa Salete;1644;826;818;99;42,2;20,8
2022;3547700;Santo Anastácio;17979;8620;9359;108,6;40,9;32,5
2022;3547809;Santo André;748390;354943;393447;110,8;39,2;4257,5
2022;3547908;Santo Antônio da Alegria;6772;3457;3315;95,9;38,9;21,8
2022;3548005;Santo Antônio de Posse;23225;11599;11626;100,2;36,3;150,7
2022;3548054;Santo Antônio do Aracanguá;8374;4195;4179;99,6;39;6,4
2022;3548104;Santo Antônio do Jardim;6125;3080;3045;98,9;39,8;55,7
2022;3548203;Santo Antônio do Pinhal;7128;3588;3540;98,7;38,7;53,6
2022;3548302;Santo Expedito;2999;1459;1540;105,6;41;31,7
2022;3548401;Santópolis do Aguapeí;3902;1922;1980;103;37,2;30,5
2022;3548500;Santos;418613;189732;228881;120,6;42,3;1489,6
2022;3548609;São Bento do Sapucaí;11665;5780;5885;101,8;40,1;46,2
2022;3548708;São Bernardo do Campo;810406;385197;425209;110,4;38;1978,9
2022;3548807;São Caetano do Sul;165535;75614;89921;118,9;41,9;10797,6
2022;3548906;São Carlos;254612;123850;130762;105,6;38,1;224
2022;3549003;São Francisco;2603;1271;1332;104,8;43,1;34,4
2022;3549102;São João da Boa Vista;92482;44430;48052;108,2;39,6;179,1
2022;3549201;São João das Duas Pontes;2580;1272;1308;102,8;40,2;19,9
2022;3549250;São João de Iracema;1846;917;929;101,3;39,1;10,3
2022;3549300;São João do Pau d'Alho;2241;1111;1130;101,7;43,3;19
2022;3549409;São Joaquim da Barra;48543;23516;25027;106,4;38,2;118,1
2022;3549508;São José da Bela Vista;7631;3831;3800;99,2;35,7;27,6
2022;3549607;São José do Barreiro;3855;1929;1926;99,8;38,6;6,8
2022;3549706;São José do Rio Pardo;52203;25163;27040;107,5;39,7;124,4
2022;3549805;São José do Rio Preto;479851;228964;250887;109,6;38,6;1110,9
2022;3549904;São José dos Campos;696564;335123;361441;107,9;37,3;633,6
2022;3549953;São Lourenço da Serra;16051;8051;8000;99,4;37,1;86,1
2022;3550001;São Luiz do Paraitinga;10337;5216;5121;98,2;41,4;16,7
2022;3550100;São Manuel;37296;18273;19023;104,1;38;57,3
2022;3550209;São Miguel Arcanjo;32035;16134;15901;98,6;36,9;34,4
2022;3550308;São Paulo;11450609;5386041;6064568;112,6;38;7527,3
2022;3550407;São Pedro;38206;18526;19680;106,2;39,8;62,5
2022;3550506;São Pedro do Turvo;7217;3626;3591;99;37,4;9,9
2022;3550605;São Roque;79479;38761;40718;105;38,3;259
2022;3550704;São Sebastião;81539;39858;41681;104,6;35,2;202,6
2022;3550803;São Sebastião da Grama;10452;5214;5238;100,5;39,6;41,4
2022;3550902;São Simão;13448;6598;6850;103,8;39,8;21,8
2022;3551009;São Vicente;329929;158742;171187;107,8;37,3;2227
2022;3551108;Sarapuí;10359;5235;5124;97,9;37,4;29,4
2022;3551207;Sarutaiá;3703;1848;1855;100,4;38,1;26,1
2022;3551306;Sebastianópolis do Sul;3129;1512;1617;106,9;40,2;18,6
2022;3551405;Serra Azul;12735;8159;4576;56,1;36,6;45
2022;3551504;Serrana;43872;21561;22311;103,5;34,7;348,1
2022;3551603;Serra Negra;29868;14405;15463;107,3;40,8;146,6
2022;3551702;Sertãozinho;126762;61529;65233;106;36,4;314,5
2022;3551801;Sete Barras;12732;6469;6263;96,8;37,2;12
2022;3551900;Severínia;14582;7475;7107;95,1;36,5;103,8
2022;3552007;Silveiras;6183;3081;3102;100,7;37,9;14,9
2022;3552106;Socorro;40097;19684;20413;103,7;41;89,3
2022;3552205;Sorocaba;722628;349121;373507;107;36,8;1606,3
2022;3552304;Sud Mennucci;7356;3657;3699;101,1;38,7;12,4
2022;3552403;Sumaré;279260;136457;142803;104,7;35,6;1819,7
2022;3552502;Suzano;307092;148431;158661;106,9;35,2;1489
2022;3552551;Suzanápolis;3408;1718;1690;98,4;39,4;10,3
2022;3552601;Tabapuã;11323;5582;5741;102,8;40,4;32,7
2022;3552700;Tabatinga;14768;7290;7478;102,6;37,3;40,1
2022;3552809;Taboão da Serra;273329;129623;143706;110,9;35,7;13406,5
2022;3552908;Taciba;6256;3078;3178;103,2;37,1;10,3
2022;3553005;Taguaí;12655;6266;6389;102;35,1;87,1
2022;3553104;Taiaçu;5678;2877;2801;97,4;38,8;53
2022;3553203;Taiúva;6540;3676;2864;77,9;39;49,4
2022;3553302;Tambaú;21442;10525;10917;103,7;38,7;38,2
2022;3553401;Tanabi;25256;12418;12838;103,4;39,7;33,8
2022;3553500;Tapiraí;7996;4016;3980;99,1;36,4;10,6
2022;3553609;Tapiratiba;11822;5731;6091;106,3;39,9;53,3
2022;3553658;Taquaral;2620;1303;1317;101,1;39,3;48,6
2022;3553708;Taquaritinga;52272;25411;26861;105,7;39;88
2022;3553807;Taquarituba;24335;12594;11741;93,2;37,1;54,3
2022;3553856;Taquarivaí;6862;3489;3373;96,7;34,1;29,6
2022;3553906;Tarabai;6536;3209;3327;103,7;36,9;32,5
2022;3553955;Tarumã;14867;7393;7474;101,1;35,8;49,1
2022;3554003;Tatuí;123818;60418;63400;104,9;36,7;236,4
2022;3554102;Taubaté;310504;149489;161015;107,7;37,8;496,8
2022;3554201;Tejupá;4131;2109;2022;95,9;37;13,9
2022;3554300;Teodoro Sampaio;22167;10914;11253;103,1;36,3;14,2
2022;3554409;Terra Roxa;7908;3945;3963;100,5;38,7;35,7
2022;3554508;Tietê;37657;18555;19102;102,9;38,4;93,1
2022;3554607;Timburi;2465;1247;1218;97,7;41,4;12,5
2022;3554656;Torre de Pedra;2047;1029;1018;98,9;40,7;28,7
2022;3554706;Torrinha;9335;4656;4679;100,5;40;29,6
2022;3554755;Trabiju;1681;855;826;96,6;36,5;26,5
2022;3554805;Tremembé;51094;27282;23812;87,3;36,9;267,4
2022;3554904;Três Fronteiras;6793;3388;3405;100,5;39,5;44,8
2022;3554953;Tuiuti;6772;3367;3405;101,1;41,3;53,4
2022;3555000;Tupã;63925;30534;33391;109,4;40,5;101,8
2022;3555109;Tupi Paulista;15842;8037;7805;97,1;42;64,7
2022;3555208;Turiúba;1819;923;896;97,1;43,2;11,9
2022;3555307;Turmalina;1671;813;858;105,5;46,8;11,3
2022;3555356;Ubarana;5364;2747;2617;95,3;36;25,6
2022;3555406;Ubatuba;92874;45863;47011;102,5;36,2;131,2
2022;3555505;Ubirajara;5127;2658;2469;92,9;35,9;18,2
2022;3555604;Uchoa;10387;5114;5273;103,1;40,2;41,1
2022;3555703;União Paulista;1603;787;816;103,7;35,9;20,3
2022;3555802;Urânia;8833;4332;4501;103,9;41,2;42,2
2022;3555901;Uru;1386;693;693;100;40,9;9,4
2022;3556008;Urupês;13737;6752;6985;103,5;40,6;42,4
2022;3556107;Valentim Gentil;14074;7015;7059;100,6;37,2;94
2022;3556206;Valinhos;126225;61443;64782;105,4;39,2;849,8
2022;3556305;Valparaíso;24229;13508;10721;79,4;36,7;28,3
2022;3556354;Vargem;10499;5353;5146;96,1;37,2;73,6
2022;3556404;Vargem Grande do Sul;40127;19728;20399;103,4;38,1;150,2
2022;3556453;Vargem Grande Paulista;50359;24598;25761;104,7;36,3;1185,2
2022;3556503;Várzea Paulista;115708;57303;58405;101,9;35,6;3294,7
2022;3556602;Vera Cruz;10180;4974;5206;104,7;40,6;41,1
2022;3556701;Vinhedo;76442;37168;39274;105,7;38,2;944,3
2022;3556800;Viradouro;17413;8595;8818;102,6;37,3;80
2022;3556909;Vista Alegre do Alto;8100;4099;4001;97,6;35,3;84,9
2022;3556958;Vitória Brasil;1794;919;875;95,2;39,6;36
2022;3557006;Votorantim;127779;62270;65509;105,2;36;693,7
2022;3557105;Votuporanga;96546;46535;50011;107,5;39,1;229,5
2022;3557154;Zacarias;2689;1337;1352;101,1;39,8;8,4
2022;3557204;Chavantes;12210;5937;6273;105,7;38;64,7
2022;3557303;Estiva Gerbi;11286;5638;5648;100,2;36,9;152,2
2023;3500105;Adamantina;34706;16701;18005;107,8;41,4;84,2
2023;3500204;Adolfo;4410;2177;2233;102,6;40;20,9
2023;3500303;Aguaí;32025;15833;16192;102,3;37,4;67,5
2023;3500402;Águas da Prata;7355;3519;3836;109;43,3;51,6
2023;3500501;Águas de Lindóia;17937;8714;9223;105,8;41,5;298,3
2023;3500550;Águas de Santa Bárbara;7275;3621;3654;100,9;40;18
2023;3500600;Águas de São Pedro;2774;1285;1489;115,9;46,2;768
2023;3500709;Agudos;37839;18523;19316;104,3;37,3;39,1
2023;3500758;Alambari;6227;3137;3090;98,5;37,5;39
2023;3500808;Alfredo Marcondes;4479;2225;2254;101,3;41,3;37,7
2023;3500907;Altair;3412;1725;1687;97,8;38;10,9
2023;3501004;Altinópolis;16878;8298;8580;103,4;38,7;18,2
2023;3501103;Alto Alegre;3799;1905;1894;99,4;43,4;11,9
2023;3501152;Alumínio;17277;8572;8705;101,6;36,4;206,6
2023;3501202;Álvares Florence;3909;1976;1933;97,8;44;10,8
2023;3501301;Álvares Machado;27495;13326;14169;106,3;37,8;79,1
2023;3501400;Álvaro de Carvalho;4819;3257;1562;48;37,4;31,4
2023;3501509;Alvinlândia;2862;1420;1442;101,5;38,2;33,7
2023;3501608;Americana;238829;115113;123716;107,5;39,4;1783,5
2023;3501707;Américo Brasiliense;32753;16157;16596;102,7;36,4;266,4
2023;3501806;Américo de Campos;5874;2848;3026;106,3;41,6;23,2
2023;3501905;Amparo;68015;33012;35003;106;39,9;152,7
2023;3502002;Analândia;4613;2310;2303;99,7;38,2;14,2
2023;3502101;Andradina;60012;29829;30183;101,2;39,6;62,2
2023;3502200;Angatuba;24113;12077;12036;99,7;37,4;23,5
2023;3502309;Anhembi;5660;2850;2810;98,6;37,4;7,7
2023;3502408;Anhumas;4031;1971;2060;104,5;39,1;12,6
2023;3502507;Aparecida;32272;15462;16810;108,7;39,1;267
2023;3502606;Aparecida d'Oeste;4038;2001;2037;101,8;43;22,6
2023;3502705;Apiaí;24477;12239;12238;100;36,9;25,1
2023;3502754;Araçariguama;21856;10939;10917;99,8;34,5;150,5
2023;3502804;Araçatuba;201053;95546;105507;110,4;39,5;172,3
2023;3502903;Araçoiaba da Serra;32826;16309;16517;101,3;40,5;128,6
2023;3503000;Aramina;5450;2641;2809;106,4;39,8;26,9
2023;3503109;Arandu;6935;3481;3454;99,2;37,2;24,3
2023;3503158;Arapeí;2306;1135;1171;103,2;40,5;14,7
2023;3503208;Araraquara;244361;117143;127218;108,6;38,9;243,5
2023;3503307;Araras;131466;63504;67962;107;38,8;203,9
2023;3503356;Arco-Íris;2055;1032;1023;99,1;39,4;7,8
2023;3503406;Arealva;8150;4056;4094;100,9;41,8;16,1
2023;3503505;Areias;3556;1792;1764;98,4;38,4;11,7
2023;3503604;Areiópolis;10086;5081;5005;98,5;35,9;117,4
2023;3503703;Ariranha;7504;3720;3784;101,7;40,4;56,6
2023;3503802;Artur Nogueira;51964;25551;26413;103,4;36,5;291,9
2023;3503901;Arujá;87470;42372;45098;106,4;36,2;909,6
2023;3503950;Aspásia;1839;912;927;101,6;41,5;26,5
2023;3504008;Assis;101665;48900;52765;107,9;39;220,7
2023;3504107;Atibaia;160959;77865;83094;106,7;38,3;336,4
2023;3504206;Auriflama;13634;6718;6916;102,9;40,8;31,4
2023;3504305;Avaí;4441;2205;2236;101,4;38;8,2
2023;3504404;Avanhandava;11222;6177;5045;81,7;36,1;33,2
2023;3504503;Avaré;93319;46182;47137;102,1;37,7;76,9
2023;3504602;Bady Bassitt;28264;13849;14415;104,1;35,9;256,1
2023;3504701;Balbinos;3904;3191;713;22,3;37,9;42,6
2023;3504800;Bálsamo;9716;4725;4991;105,6;40;64,8
2023;3504909;Bananal;9929;4810;5119;106,4;39,3;16,1
2023;3505005;Barão de Antonina;3567;1775;1792;101;38,2;23,3
2023;3505104;Barbosa;5544;2695;2849;105,7;38,3;27
2023;3505203;Bariri;31570;15443;16127;104,4;39,2;71
2023;3505302;Barra Bonita;34183;16438;17745;108;41,3;227,7
2023;3505351;Barra do Chapéu;5162;2671;2491;93,3;36,1;12,7
2023;3505401;Barra do Turvo;6784;3429;3355;97,8;38,1;6,7
2023;3505500;Barretos;123162;59063;64099;108,5;38,3;78,6
2023;3505609;Barrinha;32270;15883;16387;103,2;34,6;221
2023;3505708;Barueri;321672;153273;168399;109,9;35,1;4896
2023;3505807;Bastos;21539;10520;11019;104,7;38,9;126
2023;3505906;Batatais;58450;28349;30101;106,2;39,2;68,8
2023;3506003;Bauru;381196;184255;196941;106,9;38,2;570,9
2023;3506102;Bebedouro;76339;36918;39421;106,8;39,3;111,7
2023;3506201;Bento de Abreu;2598;1292;1306;101,1;37,8;8,6
2023;3506300;Bernardino de Campos;11650;6202;5448;87,8;39,2;47,7
2023;3506359;Bertioga;65374;32497;32877;101,2;35,1;133
2023;3506409;Bilac;7307;3591;3716;103,5;40,8;46,2
2023;3506508;Birigui;119496;57737;61759;107;38,9;225,5
2023;3506607;Biritiba Mirim;29689;14751;14938;101,3;37,3;93,5
2023;3506706;Boa Esperança do Sul;12895;6337;6558;103,5;36,7;18,7
2023;3506805;Bocaina;11261;5499;5762;104,8;38,2;30,9
2023;3506904;Bofete;10501;5336;5165;96,8;39,9;16,1
2023;3507001;Boituva;62054;30494;31560;103,5;37,1;249,3
2023;3507100;Bom Jesus dos Perdões;22168;10949;11219;102,5;36,6;204,6
2023;3507159;Bom Sucesso de Itararé;3549;1811;1738;96;33,8;26,6
2023;3507209;Borá;902;457;445;97,4;39,3;7,6
2023;3507308;Boracéia;4773;2422;2351;97,1;36,3;39,1
2023;3507407;Borborema;14174;7005;7169;102,3;40,9;25,7
2023;3507456;Borebi;2741;1343;1398;104,1;35,4;7,9
2023;3507506;Botucatu;146232;70283;75949;108,1;38,1;98,6
2023;3507605;Bragança Paulista;178980;86646;92334;106,6;38,2;349,2
2023;3507704;Braúna;5361;2621;2740;104,5;38,9;27,5
2023;3507753;Brejo Alegre;2563;1289;1274;98,8;40;24,3
2023;3507803;Brodowski;25458;12470;12988;104,2;37,7;91,4
2023;3507902;Brotas;24033;11647;12386;106,3;38,8;21,8
2023;3508009;Buri;20336;10180;10156;99,8;34,5;17
2023;3508108;Buritama;17311;8371;8940;106,8;40,4;53
2023;3508207;Buritizal;4359;2120;2239;105,6;39,7;16,4
2023;3508306;Cabrália Paulista;4282;2167;2115;97,6;37,9;17,8
2023;3508405;Cabreúva;47414;23428;23986;102,4;35,1;182,2
2023;3508504;Caçapava;96808;47326;49482;104,6;37,8;262,4
2023;3508603;Cachoeira Paulista;31604;15234;16370;107,5;38,3;109,7
2023;3508702;Caconde;16953;8418;8535;101,4;40;36,2
2023;3508801;Cafelândia;16614;8015;8599;107,3;38,9;18,1
2023;3508900;Caiabu;3675;1835;1840;100,3;41,1;14,5
2023;3509007;Caieiras;95414;46161;49253;106,7;36,6;977,2
2023;3509106;Caiuá;5492;3344;2148;64,2;38,9;10
2023;3509205;Cajamar;94792;46364;48428;104,5;34;721,5
2023;3509254;Cajati;28495;14319;14176;99;35,6;62,7
2023;3509304;Cajobi;9056;4475;4581;102,4;40,3;51,2
2023;3509403;Cajuru;23795;11819;11976;101,3;37,7;36
2023;3509452;Campina do Monte Alegre;5989;3014;2975;98,7;38,2;32,5
2023;3509502;Campinas;1140133;542889;597244;110;38,7;1434,9
2023;3509601;Campo Limpo Paulista;77665;37862;39803;105,1;37;978,1
2023;3509700;Campos do Jordão;46787;22823;23964;105;36,9;161,3
2023;3509809;Campos Novos Paulista;4890;2456;2434;99,1;37,7;10,1
2023;3509908;Cananéia;12240;5966;6274;105,2;38,3;9,9
2023;3509957;Canas;4964;2477;2487;100,4;35;93,2
2023;3510005;Cândido Mota;29339;14244;15095;106;39,5;49,2
2023;3510104;Cândido Rodrigues;2916;1446;1470;101,7;42,3;41,1
2023;3510153;Canitar;6444;3160;3284;103,9;33,3;112,2
2023;3510203;Capão Bonito;46264;22899;23365;102;36,8;28,2
2023;3510302;Capela do Alto;23248;12802;10446;81,6;35,8;136,8
2023;3510401;Capivari;50100;24503;25597;104,5;37,4;155,2
2023;3510500;Caraguatatuba;137297;66596;70701;106,2;37;283,1
2023;3510609;Carapicuíba;386618;185552;201066;108,4;35,7;11191,5
2023;3510708;Cardoso;11297;5517;5780;104,8;42,2;17,7
2023;3510807;Casa Branca;28028;14476;13552;93,6;38,8;32,4
2023;3510906;Cássia dos Coqueiros;2797;1430;1367;95,6;42,1;14,6
2023;3511003;Castilho;20080;9877;10203;103,3;38,7;18,8
2023;3511102;Catanduva;115807;55416;60391;109;39,8;398,5
2023;3511201;Catiguá;6959;3460;3499;101,1;38,9;46,9
2023;3511300;Cedral;12977;6393;6584;103;38;65,6
2023;3511409;Cerqueira César;21732;11362;10370;91,3;36,9;42,5
2023;3511508;Cerquilho;44954;21852;23102;105,7;38,4;351,7
2023;3511607;Cesário Lange;19306;9893;9413;95,1;36,8;101,4
2023;3511706;Charqueada;15535;7736;7799;100,8;37,3;88,3
2023;3511904;Clementina;6951;3439;3512;102,1;36,9;41,2
2023;3512001;Colina;18553;8961;9592;107;38,2;43,9
2023;3512100;Colômbia;6660;3351;3309;98,7;37,3;9,1
2023;3512209;Conchal;28242;14067;14175;100,8;35,7;154,5
2023;3512308;Conchas;15105;7560;7545;99,8;39,8;32,4
2023;3512407;Cordeirópolis;24768;12196;12572;103,1;36,4;180
2023;3512506;Coroados;5395;2658;2737;103;39,2;21,9
2023;3512605;Coronel Macedo;4202;2122;2080;98;40,2;13,8
2023;3512704;Corumbataí;4206;2100;2106;100,3;37,2;15,1
2023;3512803;Cosmópolis;59707;29240;30467;104,2;37,2;386
2023;3512902;Cosmorama;8827;4385;4442;101,3;39,5;20
2023;3513009;Cotia;279346;135171;144175;106,7;35,3;862,2
2023;3513108;Cravinhos;33273;16340;16933;103,6;38,2;106,8
2023;3513207;Cristais Paulista;9365;4626;4739;102,4;37,6;24,3
2023;3513306;Cruzália;2093;1020;1073;105,2;42,2;14
2023;3513405;Cruzeiro;74529;35744;38785;108,5;39;243,8
2023;3513504;Cubatão;111549;53363;58186;109;35,8;780,7
2023;3513603;Cunha;22110;11231;10879;96,9;40;15,7
2023;3513702;Descalvado;31782;15563;16219;104,2;39,7;42,2
2023;3513801;Diadema;392224;186840;205384;109,9;36,7;12762,7
2023;3513850;Dirce Reis;1610;818;792;96,8;42,5;18,3
2023;3513900;Divinolândia;11120;5504;5616;102;41,3;49,7
2023;3514007;Dobrada;8823;4368;4455;102;35,4;58,9
2023;3514106;Dois Córregos;24434;12027;12407;103,2;38,2;38,6
2023;3514205;Dolcinópolis;2215;1104;1111;100,6;41,3;28,4
2023;3514304;Dourado;8054;3970;4084;102,9;40,9;39,1
2023;3514403;Dracena;45569;22312;23257;104,2;40,7;93,4
2023;3514502;Duartina;12332;6027;6305;104,6;41,3;46,6
2023;3514601;Dumont;9561;4740;4821;101,7;36,5;85,8
2023;3514700;Echaporã;6181;3043;3138;103,1;38,8;12
2023;3514809;Eldorado;12887;6453;6434;99,7;36,4;7,8
2023;3514908;Elias Fausto;17817;8916;8901;99,8;36,5;88
2023;3514924;Elisiário;3130;1584;1546;97,6;39,6;33,3
2023;3514957;Embaúba;2312;1184;1128;95,3;41,2;27,8
2023;3515004;Embu das Artes;250540;120390;130150;108,1;34,9;3558,9
2023;3515103;Embu-Guaçu;66979;32894;34085;103,6;36,2;430,3
2023;3515129;Emilianópolis;3010;1484;1526;102,8;42;13,4
2023;3515152;Engenheiro Coelho;19858;9922;9936;100,1;34;180,6
2023;3515186;Espírito Santo do Pinhal;39582;19163;20419;106,6;40,5;101,7
2023;3515194;Espírito Santo do Turvo;4159;2064;2095;101,5;35,1;21,5
2023;3515202;Estrela d'Oeste;9499;4831;4668;96,6;39,6;32,1
2023;3515301;Estrela do Norte;2693;1315;1378;104,8;38,9;10,2
2023;3515350;Euclides da Cunha Paulista;7760;3801;3959;104,2;39;13,5
2023;3515400;Fartura;16682;8141;8541;104,9;39,3;38,9
2023;3515509;Fernandópolis;71620;34381;37239;108,3;40;130,3
2023;3515608;Fernando Prestes;5973;2911;3062;105,2;41,1;35,1
2023;3515657;Fernão;1663;841;822;97,7;38,9;16,5
2023;3515707;Ferraz de Vasconcelos;179442;86650;92792;107,1;35;6073
2023;3515806;Flora Rica;1463;717;746;104;43,7;6,5
2023;3515905;Floreal;2707;1312;1395;106,3;45,5;13,3
2023;3516002;Flórida Paulista;12926;7065;5861;83;39,3;24,7
2023;3516101;Florínea;3918;2580;1338;51,9;38,9;17,3
2023;3516200;Franca;354489;171727;182762;106,4;37,7;585,3
2023;3516309;Francisco Morato;165435;80769;84666;104,8;33,9;3376,2
2023;3516408;Franco da Rocha;145574;72970;72604;99,5;35;1096,4
2023;3516507;Gabriel Monteiro;2764;1379;1385;100,4;41,8;19,9
2023;3516606;Gália;6305;3088;3217;104,2;41,5;17,7
2023;3516705;Garça;41973;20197;21776;107,8;39,7;75,5
2023;3516804;Gastão Vidigal;3152;1520;1632;107,4;40,6;17,5
2023;3516853;Gavião Peixoto;4721;2339;2382;101,8;36,3;19,4
2023;3516903;General Salgado;10285;5051;5234;103,6;41,3;20,8
2023;3517000;Getulina;10157;5578;4579;82,1;39,6;15
2023;3517109;Glicério;4084;1999;2085;104,3;40,6;15
2023;3517208;Guaiçara;11262;5555;5707;102,7;36,9;40,6
2023;3517307;Guaimbê;5495;2727;2768;101,5;38,7;25,2
2023;3517406;Guaíra;39380;19170;20210;105,4;38,4;31,3
2023;3517505;Guapiaçu;21976;10872;11104;102,1;37;67,6
2023;3517604;Guapiara;16927;8574;8353;97,4;38;41,5
2023;3517703;Guará;18441;8998;9443;104,9;37,4;50,9
2023;3517802;Guaraçaí;7320;3603;3717;103,2;43,2;12,9
2023;3517901;Guaraci;10382;5177;5205;100,5;38,9;16,2
2023;3518008;Guarani d'Oeste;1963;977;986;100,9;41,7;22,9
2023;3518107;Guarantã;6421;3170;3251;102,6;37,5;13,9
2023;3518206;Guararapes;30926;15029;15897;105,8;40;32,4
2023;3518305;Guararema;31576;15529;16047;103,3;37,9;116,6
2023;3518404;Guaratinguetá;118349;56651;61698;108,9;39,2;157,2
2023;3518503;Guareí;15024;9014;6010;66,7;37,6;26,5
2023;3518602;Guariba;37516;18012;19504;108,3;36,3;138,8
2023;3518701;Guarujá;286515;137380;149135;108,6;36,4;1978,8
2023;3518800;Guarulhos;1293335;620712;672623;108,4;35,9;4058,5
2023;3518859;Guatapará;7327;3676;3651;99,3;37,9;17,7
2023;3518909;Guzolândia;4189;2146;2043;95,2;39,2;16,6
2023;3519006;Herculândia;9145;4475;4670;104,4;38,1;25,1
2023;3519055;Holambra;15389;7611;7778;102,2;37;234,7
2023;3519071;Hortolândia;239765;118636;121129;102,1;35,4;3841,4
2023;3519105;Iacanga;10463;5169;5294;102,4;38,6;19,1
2023;3519204;Iacri;6101;3028;3073;101,5;40,4;19
2023;3519253;Iaras;8109;5501;2608;47,4;38,9;20,2
2023;3519303;Ibaté;32205;16005;16200;101,2;35,7;110,7
2023;3519402;Ibirá;11746;5740;6006;104,6;40;43,2
2023;3519501;Ibirarema;6314;3116;3198;102,6;39,4;27,7
2023;3519600;Ibitinga;60442;29637;30805;103,9;37,7;87,7
2023;3519709;Ibiúna;75753;37923;37830;99,8;37,3;71,6
2023;3519808;Icém;7834;4342;3492;80,4;38,4;21,6
2023;3519907;Iepê;7594;3674;3920;106,7;40;12,8
2023;3520004;Igaraçu do Tietê;23025;11443;11582;101,2;38,1;235,6
2023;3520103;Igarapava;26019;12546;13473;107,4;39,2;55,6
2023;3520202;Igaratá;10721;5346;5375;100,5;38;36,6
2023;3520301;Iguape;29043;14565;14478;99,4;39,6;14,7
2023;3520400;Ilhabela;35371;17448;17923;102,7;35,9;102,1
2023;3520426;Ilha Comprida;13733;6751;6982;103,4;42,6;69,9
2023;3520442;Ilha Solteira;25498;12311;13187;107,1;41,1;39,1
2023;3520509;Indaiatuba;259661;126610;133051;105,1;37,8;833,5
2023;3520608;Indiana;5085;2564;2521;98,3;39,5;39,3
2023;3520707;Indiaporã;4047;1960;2087;106,5;42,6;14,5
2023;3520806;Inúbia Paulista;3592;1760;1832;104,1;40,6;41,2
2023;3520905;Ipaussu;13698;6701;6997;104,4;37,7;65,4
2023;3521002;Iperó;37032;19880;17152;86,3;35,4;217,5
2023;3521101;Ipeúna;6888;3437;3451;100,4;37;36,3
2023;3521150;Ipiguá;6938;3485;3453;99,1;38;51
2023;3521200;Iporanga;4028;2033;1995;98,1;36,7;3,5
2023;3521309;Ipuã;14445;7172;7273;101,4;36,7;31
2023;3521408;Iracemápolis;22070;10934;11136;101,8;37,3;191,7
2023;3521507;Irapuã;6830;3437;3393;98,7;38,8;26,5
2023;3521606;Irapuru;7011;4015;2996;74,6;40,9;32,7
2023;3521705;Itaberá;17966;8989;8977;99,9;37,6;16,3
2023;3521804;Itaí;25226;13055;12171;93,2;36,8;23,1
2023;3521903;Itajobi;17204;8585;8619;100,4;39,2;34,3
2023;3522000;Itaju;3650;1816;1834;101;38,4;15,8
2023;3522109;Itanhaém;114186;54857;59329;108,2;39,3;189,8
2023;3522158;Itaoca;3437;1705;1732;101,6;38,3;18,8
2023;3522208;Itapecerica da Serra;158321;77128;81193;105,3;35,3;1050,3
2023;3522307;Itapetininga;158556;79113;79443;100,4;36,8;88,6
2023;3522406;Itapeva;89670;43983;45687;103,9;36,5;49,1
2023;3522505;Itapevi;234026;113940;120086;105,4;33,8;2831,3
2023;3522604;Itapira;72187;35312;36875;104,4;39,6;139,2
2023;3522653;Itapirapuã Paulista;4338;2247;2091;93,1;34,4;10,7
2023;3522703;Itápolis;39355;19240;20115;104,5;39,8;39,5
2023;3522802;Itaporanga;13998;6865;7133;103,9;38,8;27,6
2023;3522901;Itapuí;13786;6844;6942;101,4;36,2;98,5
2023;3523008;Itapura;3939;1966;1973;100,4;39,5;13,1
2023;3523107;Itaquaquecetuba;372001;181414;190587;105,1;33,9;4502,5
2023;3523206;Itararé;44076;21433;22643;105,6;37,5;43,9
2023;3523305;Itariri;15501;7684;7817;101,7;36,7;56,6
2023;3523404;Itatiba;122969;60066;62903;104,7;38,1;381,6
2023;3523503;Itatinga;19093;10140;8953;88,3;35,4;19,5
2023;3523602;Itirapina;16187;9530;6657;69,9;36,9;28,7
2023;3523701;Itirapuã;5745;2911;2834;97,4;37,4;35,7
2023;3523800;Itobi;8072;4094;3978;97,2;38,3;58,1
2023;3523909;Itu;168918;82394;86524;105;37,3;263,6
2023;3524006;Itupeva;72596;36307;36289;100;34,7;361,4
2023;3524105;Ituverava;37426;18059;19367;107,2;39,6;53,1
2023;3524204;Jaborandi;6174;3054;3120;102,2;39,2;22,6
2023;3524303;Jaboticabal;71689;34117;37572;110,1;39,7;101,5
2023;3524402;Jacareí;241952;116536;125416;107,6;37,8;521,1
2023;3524501;Jaci;7736;3905;3831;98,1;36;53,3
2023;3524600;Jacupiranga;15944;7882;8062;102,3;37,6;22,6
2023;3524709;Jaguariúna;60420;29263;31157;106,5;36,9;427,3
2023;3524808;Jales;48835;23570;25265;107,2;41;132,5
2023;3524907;Jambeiro;6480;3237;3243;100,2;38,5;35,1
2023;3525003;Jandira;118391;57259;61132;106,8;35,4;6784,9
2023;3525102;Jardinópolis;45773;23745;22028;92,8;36,5;91,2
2023;3525201;Jarinu;38541;19322;19219;99,5;35,9;185,7
2023;3525300;Jaú;133548;64398;69150;107,4;39,3;194,4
2023;3525409;Jeriquara;3909;2016;1893;93,9;34,7;27,5
2023;3525508;Joanópolis;12836;6497;6339;97,6;39,1;34,3
2023;3525607;João Ramalho;4365;2159;2206;102,2;36,9;10,5
2023;3525706;José Bonifácio;36889;18147;18742;103,3;37,9;42,9
2023;3525805;Júlio Mesquita;4245;2068;2177;105,3;38;33,1
2023;3525854;Jumirim;3072;1526;1546;101,3;36,6;54,2
2023;3525904;Jundiaí;448074;215914;232160;107,5;38,8;1039,1
2023;3526001;Junqueirópolis;20518;10720;9798;91,4;39,7;35,2
2023;3526100;Juquiá;16954;8478;8476;100;38,7;20,9
2023;3526209;Juquitiba;27189;13669;13520;98,9;37,1;52,1
2023;3526308;Lagoinha;5092;2577;2515;97,6;42,4;19,9
2023;3526407;Laranjal Paulista;26310;12827;13483;105,1;38,3;68,5
2023;3526506;Lavínia;9747;7255;2492;34,3;37,7;18,1
2023;3526605;Lavrinhas;7206;3572;3634;101,7;35,6;43,1
2023;3526704;Leme;98373;48154;50219;104,3;37,3;244,2
2023;3526803;Lençóis Paulista;66829;32914;33915;103;37,4;82,6
2023;3526902;Limeira;292634;142280;150354;105,7;38,6;503,9
2023;3527009;Lindóia;7023;3454;3569;103,3;39,7;144
2023;3527108;Lins;74858;35888;38970;108,6;39,2;131,3
2023;3527207;Lorena;84830;40579;44251;109;38,4;204,8
2023;3527256;Lourdes;1916;953;963;101;42,2;16,8
2023;3527306;Louveira;52901;26267;26634;101,4;34,5;949,1
2023;3527405;Lucélia;20003;11179;8824;78,9;40,8;63,5
2023;3527504;Lucianópolis;2387;1198;1189;99,2;39,7;12,6
2023;3527603;Luís Antônio;12312;6139;6173;100,6;35,6;20,6
2023;3527702;Luiziânia;4667;2322;2345;101;37,8;28
2023;3527801;Lupércio;3935;1917;2018;105,3;38,9;25,4
2023;3527900;Lutécia;2655;1309;1346;102,8;39,4;5,6
2023;3528007;Macatuba;16808;8290;8518;102,8;37,5;74,9
2023;3528106;Macaubal;7444;3710;3734;100,6;42,3;30
2023;3528205;Macedônia;3987;1953;2034;104,1;41,9;12,2
2023;3528304;Magda;3154;1534;1620;105,6;42,8;10,1
2023;3528403;Mairinque;50394;25341;25053;98,9;37,2;239,8
2023;3528502;Mairiporã;94534;46884;47650;101,6;37,4;294,8
2023;3528601;Manduri;9925;4906;5019;102,3;39,1;43,3
2023;3528700;Marabá Paulista;4549;2834;1715;60,5;38;4,9
2023;3528809;Maracaí;12551;6191;6360;102,7;38,8;23,5
2023;3528858;Marapoama;3334;1687;1647;97,6;38,9;30
2023;3528908;Mariápolis;3483;1737;1746;100,5;40,8;18,7
2023;3529005;Marília;238602;114246;124356;108,8;38,6;203,8
2023;3529104;Marinópolis;1834;919;915;99,6;42,5;23,6
2023;3529203;Martinópolis;24870;12774;12096;94,7;39,1;19,8
2023;3529302;Matão;79018;38720;40298;104,1;39,1;150,5
2023;3529401;Mauá;417046;200395;216651;108,1;36,6;6733,4
2023;3529500;Mendonça;6278;3168;3110;98,2;38,9;32,2
2023;3529609;Meridiano;4625;2270;2355;103,7;39,9;20,3
2023;3529658;Mesópolis;1947;987;960;97,3;38,9;13,1
2023;3529708;Miguelópolis;19292;9442;9850;104,3;37,5;23,5
2023;3529807;Mineiros do Tietê;11152;5530;5622;101,7;38,8;52,3
2023;3529906;Miracatu;18330;9112;9218;101,2;37,6;18,3
2023;3530003;Mira Estrela;3138;1565;1573;100,5;42,6;14,5
2023;3530102;Mirandópolis;27927;15920;12007;75,4;41,2;30,4
2023;3530201;Mirante do Paranapanema;15781;7841;7940;101,3;40,5;12,7
2023;3530300;Mirassol;64011;30997;33014;106,5;38,6;263,2
2023;3530409;Mirassolândia;4687;2355;2332;99;38,9;28,2
2023;3530508;Mococa;67609;33109;34500;104,2;39,9;79,1
2023;3530607;Mogi das Cruzes;455116;218662;236454;108,1;36,7;638,7
2023;3530706;Mogi Guaçu;154517;75102;79415;105,7;38,2;190,1
2023;3530805;Mogi Mirim;92791;45043;47748;106;39,4;186,4
2023;3530904;Mombuca;3741;1829;1912;104,5;35,7;28
2023;3531001;Monções;1908;949;959;101,1;43,7;18,3
2023;3531100;Mongaguá;63016;32097;30919;96,3;39,8;441,4
2023;3531209;Monte Alegre do Sul;8739;4324;4415;102,1;41,6;79,2
2023;3531308;Monte Alto;47528;23225;24303;104,6;40,4;137
2023;3531407;Monte Aprazível;22328;10886;11442;105,1;40,2;45,1
2023;3531506;Monte Azul Paulista;18050;9031;9019;99,9;40,3;68,5
2023;3531605;Monte Castelo;4224;2099;2125;101,2;40,1;18,1
2023;3531704;Monteiro Lobato;4143;2055;2088;101,6;39,6;12,5
2023;3531803;Monte Mor;65713;32345;33368;103,2;35,2;273,2
2023;3531902;Morro Agudo;27796;13580;14216;104,7;36,7;20
2023;3532009;Morungaba;13897;6779;7118;105;37,1;94,7
2023;3532058;Motuca;3980;2014;1966;97,6;38,8;17,4
2023;3532108;Murutinga do Sul;3695;1831;1864;101,8;43,5;14,7
2023;3532157;Nantes;2646;1299;1347;103,7;37;9,2
2023;3532207;Narandiba;5830;2884;2946;102,1;35;16,3
2023;3532306;Natividade da Serra;6998;3638;3360;92,4;41,1;8,4
2023;3532405;Nazaré Paulista;18305;9268;9037;97,5;38,6;56,1
2023;3532504;Neves Paulista;9740;4819;4921;102,1;41,8;44,5
2023;3532603;Nhandeara;9766;4687;5079;108,4;43,2;22,4
2023;3532702;Nipoã;4761;2430;2331;95,9;36,5;34,6
2023;3532801;Nova Aliança;6748;3314;3434;103,6;38,6;31
2023;3532827;Nova Campina;8484;4222;4262;100,9;34,2;22
2023;3532843;Nova Canaã Paulista;2019;998;1021;102,3;45,2;16,2
2023;3532868;Nova Castilho;1052;513;539;105,1;38,6;5,7
2023;3532900;Nova Europa;9269;4633;4636;100,1;37,5;57,8
2023;3533007;Nova Granada;19401;9589;9812;102,3;38,6;36,5
2023;3533106;Nova Guataporanga;2151;1050;1101;104,9;41,2;63
2023;3533205;Nova Independência;4718;2616;2102;80,4;35,5;17,8
2023;3533254;Novais;4388;2191;2197;100,3;35,3;37,3
2023;3533304;Nova Luzitânia;2771;1394;1377;98,8;40,3;37,5
2023;3533403;Nova Odessa;62711;30609;32102;104,9;38;849,9
2023;3533502;Novo Horizonte;38391;18874;19517;103,4;39,2;41,2
2023;3533601;Nuporanga;7434;3662;3772;103;38,3;21,3
2023;3533700;Ocauçu;4340;2219;2121;95,6;39;14,4
2023;3533809;Óleo;2490;1274;1216;95,4;40,9;12,5
2023;3533908;Olímpia;55405;26862;28543;106,3;38,4;69
2023;3534005;Onda Verde;4813;2410;2403;99,7;36,9;19,8
2023;3534104;Oriente;6069;2911;3158;108,5;40,6;27,8
2023;3534203;Orindiúva;6035;3012;3023;100,4;36,5;24,4
2023;3534302;Orlândia;38076;18355;19721;107,4;39,2;130,5
2023;3534401;Osasco;731127;347265;383862;110,5;36,9;11256,1
2023;3534500;Oscar Bressane;2447;1172;1275;108,8;43,6;11
2023;3534609;Osvaldo Cruz;31243;15537;15706;101,1;41,2;126
2023;3534708;Ourinhos;103680;49240;54440;110,6;38,9;350,5
2023;3534757;Ouroeste;10404;5114;5290;103,4;38,8;36
2023;3534807;Ouro Verde;7762;3743;4019;107,4;37,6;29,1
2023;3534906;Pacaembu;14981;9997;4984;49,9;39,5;44,1
2023;3535002;Palestina;11481;5714;5767;100,9;39,5;16,5
2023;3535101;Palmares Paulista;9516;4753;4763;100,2;36,2;115,9
2023;3535200;Palmeira d'Oeste;8841;4400;4441;100,9;43,5;27,7
2023;3535309;Palmital;19438;9429;10009;106,2;41;35,4
2023;3535408;Panorama;14918;7357;7561;102,8;37,1;41,9
2023;3535507;Paraguaçu Paulista;40894;20378;20516;100,7;38,5;40,8
2023;3535606;Paraibuna;17666;8907;8759;98,3;39,3;21,8
2023;3535705;Paraíso;6111;3082;3029;98,3;40,1;39,4
2023;3535804;Paranapanema;19518;9904;9614;97,1;36,1;19,2
2023;3535903;Paranapuã;4044;2010;2034;101,2;39,1;28,8
2023;3536000;Parapuã;10537;5208;5329;102,3;41,5;28,7
2023;3536109;Pardinho;7248;3668;3580;97,6;36,8;34,5
2023;3536208;Pariquera-Açu;19252;9524;9728;102,1;37,7;53,6
2023;3536257;Parisi;2953;1414;1539;108,8;40,2;34,8
2023;3536307;Patrocínio Paulista;14584;7343;7241;98,6;36,6;24,2
2023;3536406;Paulicéia;8040;4031;4009;99,5;37;21,5
2023;3536505;Paulínia;112548;54496;58052;106,5;36,7;811
2023;3536570;Paulistânia;2118;1056;1062;100,6;37,9;8,3
2023;3536604;Paulo de Faria;7311;3668;3643;99,3;40,5;9,9
2023;3536703;Pederneiras;45053;22357;22696;101,5;37,6;61,9
2023;3536802;Pedra Bela;6619;3428;3191;93,1;40,4;41,7
2023;3536901;Pedranópolis;2803;1393;1410;101,2;43,2;10,8
2023;3537008;Pedregulho;15499;7753;7746;99,9;37,9;21,7
2023;3537107;Pedreira;43194;21123;22071;104,5;39;396,9
2023;3537156;Pedrinhas Paulista;2791;1357;1434;105,7;41,6;18,3
2023;3537206;Pedro de Toledo;11340;5798;5542;95,6;38,7;16,9
2023;3537305;Penápolis;61805;29708;32097;108;39,5;86,9
2023;3537404;Pereira Barreto;23953;11583;12370;106,8;40,3;24,6
2023;3537503;Pereiras;8791;4397;4394;99,9;38,1;39,4
2023;3537602;Peruíbe;68851;33132;35719;107,8;39,5;211,1
2023;3537701;Piacatu;5530;2736;2794;102,1;40,2;23,8
2023;3537800;Piedade;52905;26519;26386;99,5;38,7;70,8
2023;3537909;Pilar do Sul;27616;13940;13676;98,1;37,7;40,5
2023;3538006;Pindamonhangaba;166656;80618;86038;106,7;37,2;227,9
2023;3538105;Pindorama;14464;7184;7280;101,3;40,7;78,3
2023;3538204;Pinhalzinho;15357;7628;7729;101,3;40,6;99,4
2023;3538303;Piquerobi;3247;1534;1713;111,7;40,8;6,7
2023;3538501;Piquete;12334;5896;6438;109,2;40,9;70,1
2023;3538600;Piracaia;26070;12708;13362;105,1;40,2;67,6
2023;3538709;Piracicaba;427094;206404;220690;106,9;38,1;309,9
2023;3538808;Piraju;29383;14215;15168;106,7;39,6;58,2
2023;3538907;Pirajuí;22333;11642;10691;91,8;39,3;27,1
2023;3539004;Pirangi;10914;5428;5486;101,1;40,2;50,6
2023;3539103;Pirapora do Bom Jesus;18549;9197;9352;101,7;33,7;171
2023;3539202;Pirapozinho;25302;12302;13000;105,7;38,8;53
2023;3539301;Pirassununga;73665;35467;38198;107,7;39,5;101,3
2023;3539400;Piratininga;15328;7438;7890;106,1;38,6;38,1
2023;3539509;Pitangueiras;33478;16627;16851;101,3;36,3;77,7
2023;3539608;Planalto;4361;2156;2205;102,3;38,5;15
2023;3539707;Platina;3009;1498;1511;100,9;38,5;9,2
2023;3539806;Poá;103206;49445;53761;108,7;37;5978,2
2023;3539905;Poloni;5575;2741;2834;103,4;40,4;41,3
2023;3540002;Pompéia;20154;9843;10311;104,8;39,5;25,7
2023;3540101;Pongaí;3381;1693;1688;99,7;41,8;18,4
2023;3540200;Pontal;37323;18691;18632;99,7;35,1;104,7
2023;3540259;Pontalinda;4104;2176;1928;88,6;37,6;19,6
2023;3540309;Pontes Gestal;2375;1180;1195;101,3;40,9;10,9
2023;3540408;Populina;4116;2011;2105;104,7;41,4;13
2023;3540507;Porangaba;10588;5399;5189;96,1;41,9;39,9
2023;3540606;Porto Feliz;56952;28971;27981;96,6;37,8;102,3
2023;3540705;Porto Ferreira;52584;25545;27039;105,8;38,8;214,7
2023;3540754;Potim;20443;11510;8933;77,6;34,9;457,9
2023;3540804;Potirendaba;18720;9218;9502;103,1;38,5;54,7
2023;3540853;Pracinha;2565;1830;735;40,2;35,5;40,7
2023;3540903;Pradópolis;16992;8375;8617;102,9;37,6;101,5
2023;3541000;Praia Grande;356054;168678;187376;111,1;37,8;2379,2
2023;3541059;Pratânia;5158;2573;2585;100,5;34,4;29,5
2023;3541109;Presidente Alves;3770;1861;1909;102,6;40,5;13,2
2023;3541208;Presidente Bernardes;14510;8198;6312;77;41,4;19,4
2023;3541307;Presidente Epitácio;39223;18903;20320;107,5;39,3;31,1
2023;3541406;Presidente Prudente;226422;108129;118293;109,4;39,4;403,9
2023;3541505;Presidente Venceslau;34834;16804;18030;107,3;41,7;46,1
2023;3541604;Promissão;34971;17131;17840;104,1;38,5;44,9
2023;3541653;Quadra;3416;1738;1678;96,5;39,1;16,6
2023;3541703;Quatá;13166;6543;6623;101,2;37,7;20,2
2023;3541802;Queiroz;3305;1643;1662;101,2;35,7;14,1
2023;3541901;Queluz;8964;4440;4524;101,9;37,3;35,9
2023;3542008;Quintana;7127;3459;3668;106;37,4;22,3
2023;3542107;Rafard;8964;4424;4540;102,6;37,8;73,7
2023;3542206;Rancharia;28496;13740;14756;107,4;39,2;18
2023;3542305;Redenção da Serra;4536;2375;2161;91;41,5;14,7
2023;3542404;Regente Feijó;20225;9923;10302;103,8;39,2;76,8
2023;3542503;Reginópolis;7701;4761;2940;61,8;36,8;18,8
2023;3542602;Registro;60211;29889;30322;101,4;37,5;83,4
2023;3542701;Restinga;6355;3146;3209;102;36,2;25,9
2023;3542800;Ribeira;3103;1575;1528;97;38,9;9,2
2023;3542909;Ribeirão Bonito;10852;5379;5473;101,7;38,6;23
2023;3543006;Ribeirão Branco;18620;9459;9161;96,8;34,6;26,7
2023;3543105;Ribeirão Corrente;4618;2302;2316;100,6;36,1;31,1
2023;3543204;Ribeirão do Sul;4670;2332;2338;100,3;40,7;23
2023;3543238;Ribeirão dos Índios;2004;955;1049;109,8;42,8;10,2
2023;3543253;Ribeirão Grande;7422;3807;3615;95;38,5;22,3
2023;3543303;Ribeirão Pires;115392;55576;59816;107,6;39,1;1165,9
2023;3543402;Ribeirão Preto;704874;335017;369857;110,4;38,1;1082,9
2023;3543501;Riversul;5546;2796;2750;98,4;38,4;14,4
2023;3543600;Rifaina;4100;2048;2052;100,2;39;25,2
2023;3543709;Rincão;8946;4436;4510;101,7;38,8;28,3
2023;3543808;Rinópolis;9197;4537;4660;102,7;41,1;25,7
2023;3543907;Rio Claro;202177;97399;104778;107,6;38,6;405,6
2023;3544004;Rio das Pedras;31419;15635;15784;101;36,3;138,6
2023;3544103;Rio Grande da Serra;44032;21452;22580;105,3;36;1211,6
2023;3544202;Riolândia;10259;6326;3933;62,2;36,7;16,2
2023;3544251;Rosana;17204;8438;8766;103,9;39,9;23,1
2023;3544301;Roseira;10900;5441;5459;100,3;36,7;83,9
2023;3544400;Rubiácea;2686;1344;1342;99,9;37,3;11,4
2023;3544509;Rubinéia;3887;1919;1968;102,6;43,8;16
2023;3544608;Sabino;5091;2469;2622;106,2;42,1;16,7
2023;3544707;Sagres;2473;1196;1277;106,8;39,6;16,7
2023;3544806;Sales;6504;3184;3320;104,3;40,9;21,1
2023;3544905;Sales Oliveira;11460;5523;5937;107,5;39;37,5
2023;3545001;Salesópolis;15146;7482;7664;102,4;38,3;35,6
2023;3545100;Salmourão;4791;2404;2387;99,3;38,9;27,7
2023;3545159;Saltinho;8218;4026;4192;104,1;40;82,4
2023;3545209;Salto;136375;66766;69609;104,3;37;1024,9
2023;3545308;Salto de Pirapora;43969;21804;22165;101,7;37,6;156,8
2023;3545407;Salto Grande;9049;4394;4655;105,9;39,4;48
2023;3545506;Sandovalina;3627;1822;1805;99,1;37,2;8
2023;3545605;Santa Adélia;13972;6879;7093;103,1;39,4;42,3
2023;3545704;Santa Albertina;6426;3184;3242;101,8;40,9;23,6
2023;3545803;Santa Bárbara d'Oeste;183284;89822;93462;104,1;38,9;676,3
2023;3546009;Santa Branca;13956;6939;7017;101,1;40;51,3
2023;3546108;Santa Clara d'Oeste;2617;1311;1306;99,6;39;14,3
2023;3546207;Santa Cruz da Conceição;4288;2098;2190;104,4;43;28,6
2023;3546256;Santa Cruz da Esperança;2122;1062;1060;99,8;39,7;14,3
2023;3546306;Santa Cruz das Palmeiras;28738;14182;14556;102,6;37,9;97,3
2023;3546405;Santa Cruz do Rio Pardo;46539;22604;23935;105,9;38,6;41,7
2023;3546504;Santa Ernestina;6158;3084;3074;99,7;36,6;45,8
2023;3546603;Santa Fé do Sul;35146;16891;18255;108,1;39,8;170,2
2023;3546702;Santa Gertrudes;23696;11935;11761;98,5;34,8;241,1
2023;3546801;Santa Isabel;53232;26259;26973;102,7;37,6;146,5
2023;3546900;Santa Lúcia;7049;3473;3576;103;38,2;45,8
2023;3547007;Santa Maria da Serra;5205;2623;2582;98,4;37;20,6
2023;3547106;Santa Mercedes;2960;1457;1503;103,2;39,1;17,8
2023;3547205;Santana da Ponte Pensa;1671;824;847;102,8;45,5;12,9
2023;3547304;Santana de Parnaíba;157395;76138;81257;106,7;35,7;874,7
2023;3547403;Santa Rita d'Oeste;2743;1324;1419;107,2;43,7;13,1
2023;3547502;Santa Rita do Passa Quatro;24668;11811;12857;108,9;42,7;32,7
2023;3547601;Santa Rosa de Viterbo;23310;11224;12086;107,7;39,8;80,8
2023;3547650;Santa Salete;1651;826;825;99,9;42,4;20,8
2023;3547700;Santo Anastácio;17738;8491;9247;108,9;41,3;32,1
2023;3547809;Santo André;752784;356640;396144;111,1;39,5;4282,5
2023;3547908;Santo Antônio da Alegria;6805;3471;3334;96,1;39,2;21,9
2023;3548005;Santo Antônio de Posse;23408;11682;11726;100,4;36,6;151,9
2023;3548054;Santo Antônio do Aracanguá;8395;4203;4192;99,7;39,5;6,4
2023;3548104;Santo Antônio do Jardim;6132;3081;3051;99;40,1;55,8
2023;3548203;Santo Antônio do Pinhal;7177;3611;3566;98,8;39,2;54
2023;3548302;Santo Expedito;3004;1462;1542;105,5;41,4;31,8
2023;3548401;Santópolis do Aguapeí;3868;1904;1964;103,2;37,6;30,2
2023;3548500;Santos;417795;189191;228604;120,8;42,7;1486,6
2023;3548609;São Bento do Sapucaí;11737;5805;5932;102,2;40,5;46,5
2023;3548708;São Bernardo do Campo;811198;384936;426262;110,7;38,5;1980,8
2023;3548807;São Caetano do Sul;166398;75940;90458;119,1;42,1;10853,9
2023;3548906;São Carlos;256743;124772;131971;105,8;38,4;225,8
2023;3549003;São Francisco;2582;1255;1327;105,7;43,5;34,2
2023;3549102;São João da Boa Vista;93161;44715;48446;108,3;40;180,4
2023;3549201;São João das Duas Pontes;2574;1267;1307;103,2;40,6;19,9
2023;3549250;São João de Iracema;1849;914;935;102,3;39,5;10,4
2023;3549300;São João do Pau d'Alho;2248;1108;1140;102,9;43,6;19,1
2023;3549409;São Joaquim da Barra;48674;23558;25116;106,6;38,5;118,5
2023;3549508;São José da Bela Vista;7554;3780;3774;99,8;36,1;27,3
2023;3549607;São José do Barreiro;3836;1920;1916;99,8;39;6,7
2023;3549706;São José do Rio Pardo;52104;25072;27032;107,8;40,1;124,2
2023;3549805;São José do Rio Preto;485356;231435;253921;109,7;38,8;1123,7
2023;3549904;São José dos Campos;700311;336303;364008;108,2;37,7;637
2023;3549953;São Lourenço da Serra;16185;8110;8075;99,6;37,6;86,8
2023;3550001;São Luiz do Paraitinga;10340;5209;5131;98,5;41,9;16,7
2023;3550100;São Manuel;37153;18202;18951;104,1;38,4;57,1
2023;3550209;São Miguel Arcanjo;32031;16116;15915;98,8;37,3;34,4
2023;3550308;São Paulo;11429865;5372073;6057792;112,8;38,4;7513,7
2023;3550407;São Pedro;38684;18743;19941;106,4;40,2;63,3
2023;3550506;São Pedro do Turvo;7213;3623;3590;99,1;37,7;9,9
2023;3550605;São Roque;79332;38645;40687;105,3;38,6;258,5
2023;3550704;São Sebastião;81958;39980;41978;105;35,6;203,7
2023;3550803;São Sebastião da Grama;10296;5124;5172;100,9;40,1;40,8
2023;3550902;São Simão;13313;6527;6786;104;40,3;21,6
2023;3551009;São Vicente;328574;158064;170510;107,9;37,7;2217,8
2023;3551108;Sarapuí;10463;5286;5177;97,9;37,8;29,7
2023;3551207;Sarutaiá;3711;1847;1864;100,9;38,4;26,2
2023;3551306;Sebastianópolis do Sul;3130;1509;1621;107,4;40,5;18,6
2023;3551405;Serra Azul;12858;8270;4588;55,5;37;45,4
2023;3551504;Serrana;44258;21713;22545;103,8;35,1;351,1
2023;3551603;Serra Negra;30031;14469;15562;107,6;41,1;147,4
2023;3551702;Sertãozinho;127904;61964;65940;106,4;36,8;317,3
2023;3551801;Sete Barras;12661;6424;6237;97,1;37,6;11,9
2023;3551900;Severínia;14425;7384;7041;95,4;37;102,7
2023;3552007;Silveiras;6213;3093;3120;100,9;38,3;15
2023;3552106;Socorro;40254;19740;20514;103,9;41,3;89,6
2023;3552205;Sorocaba;733301;353859;379442;107,2;37,1;1630
2023;3552304;Sud Mennucci;7321;3637;3684;101,3;39,1;12,3
2023;3552403;Sumaré;281703;137429;144274;105;36;1835,6
2023;3552502;Suzano;310255;149740;160515;107,2;35,5;1504,4
2023;3552551;Suzanápolis;3402;1712;1690;98,7;39,8;10,3
2023;3552601;Tabapuã;11302;5561;5741;103,2;40,8;32,7
2023;3552700;Tabatinga;14735;7248;7487;103,3;37,7;40
2023;3552809;Taboão da Serra;274537;130067;144470;111,1;36,2;13465,8
2023;3552908;Taciba;6317;3104;3213;103,5;37,3;10,4
2023;3553005;Taguaí;12774;6321;6453;102,1;35,5;87,9
2023;3553104;Taiaçu;5642;2858;2784;97,4;39,2;52,7
2023;3553203;Taiúva;6626;3761;2865;76,2;39,2;50
2023;3553302;Tambaú;21331;10456;10875;104;39;38
2023;3553401;Tanabi;25349;12444;12905;103,7;40;33,9
2023;3553500;Tapiraí;8001;4020;3981;99;36,8;10,6
2023;3553609;Tapiratiba;11709;5663;6046;106,8;40,4;52,8
2023;3553658;Taquaral;2607;1294;1313;101,5;39,8;48,4
2023;3553708;Taquaritinga;51984;25238;26746;106;39,4;87,5
2023;3553807;Taquarituba;24452;12694;11758;92,6;37,5;54,5
2023;3553856;Taquarivaí;6988;3557;3431;96,5;34,5;30,1
2023;3553906;Tarabai;6490;3179;3311;104,2;37,3;32,2
2023;3553955;Tarumã;15012;7449;7563;101,5;36,2;49,6
2023;3554003;Tatuí;125110;60974;64136;105,2;37;238,9
2023;3554102;Taubaté;312416;150148;162268;108,1;38,2;499,9
2023;3554201;Tejupá;4047;2065;1982;96;37,5;13,7
2023;3554300;Teodoro Sampaio;22114;10872;11242;103,4;36,7;14,2
2023;3554409;Terra Roxa;7862;3919;3943;100,6;39,2;35,5
2023;3554508;Tietê;37682;18557;19125;103,1;38,8;93,2
2023;3554607;Timburi;2450;1232;1218;98,9;41,8;12,4
2023;3554656;Torre de Pedra;2005;1001;1004;100,3;41,2;28,1
2023;3554706;Torrinha;9321;4641;4680;100,8;40,4;29,6
2023;3554755;Trabiju;1693;857;836;97,5;36,8;26,7
2023;3554805;Tremembé;51803;27677;24126;87,2;37,3;271,1
2023;3554904;Três Fronteiras;6909;3449;3460;100,3;39,7;45,6
2023;3554953;Tuiuti;6819;3383;3436;101,6;41,7;53,8
2023;3555000;Tupã;63841;30457;33384;109,6;40,8;101,7
2023;3555109;Tupi Paulista;15943;8056;7887;97,9;42,2;65,1
2023;3555208;Turiúba;1806;912;894;98;43,6;11,8
2023;3555307;Turmalina;1640;800;840;105;47,4;11,1
2023;3555356;Ubarana;5326;2722;2604;95,7;36,4;25,4
2023;3555406;Ubatuba;94009;46381;47628;102,7;36,6;132,8
2023;3555505;Ubirajara;5177;2686;2491;92,7;36,1;18,3
2023;3555604;Uchoa;10458;5146;5312;103,2;40,5;41,4
2023;3555703;União Paulista;1601;779;822;105,5;36;20,3
2023;3555802;Urânia;8822;4320;4502;104,2;41,5;42,2
2023;3555901;Uru;1394;690;704;102;41,3;9,5
2023;3556008;Urupês;13803;6781;7022;103,6;40,9;42,6
2023;3556107;Valentim Gentil;14307;7129;7178;100,7;37,5;95,5
2023;3556206;Valinhos;127691;62068;65623;105,7;39,6;859,7
2023;3556305;Valparaíso;24284;13565;10719;79;37;28,3
2023;3556354;Vargem;10621;5409;5212;96,4;37,4;74,5
2023;3556404;Vargem Grande do Sul;40129;19709;20420;103,6;38,5;150,2
2023;3556453;Vargem Grande Paulista;50875;24811;26064;105,1;36,7;1197,4
2023;3556503;Várzea Paulista;116105;57446;58659;102,1;36;3306
2023;3556602;Vera Cruz;10125;4944;5181;104,8;41;40,9
2023;3556701;Vinhedo;77402;37565;39837;106;38,6;956,2
2023;3556800;Viradouro;17395;8570;8825;103;37,6;79,9
2023;3556909;Vista Alegre do Alto;8194;4141;4053;97,9;35,5;85,9
2023;3556958;Vitória Brasil;1802;921;881;95,7;39,9;36,2
2023;3557006;Votorantim;129255;62872;66383;105,6;36,4;701,8
2023;3557105;Votuporanga;97487;46935;50552;107,7;39,4;231,7
2023;3557154;Zacarias;2714;1349;1365;101,2;40,2;8,5
2023;3557204;Chavantes;12163;5903;6260;106;38,3;64,4
2023;3557303;Estiva Gerbi;11359;5667;5692;100,4;37,3;153,2
;;;;;;;;
